id,date,price,bedrooms,bathrooms,sqft_living,sqft_lot,sqft_above,sqft_basement
7129300520,20141013T000000,221900,3,1,1180,5650,1180,0
6414100192,20141209T000000,538000,3,2.25,2570,7242,2170,400
5631500400,20150225T000000,180000,2,1,770,10000,770,0
2487200875,20141209T000000,604000,4,3,1960,5000,1050,910
1954400510,20150218T000000,510000,3,2,1680,8080,1680,0
7237550310,20140512T000000,1.23E+06,4,4.5,5420,101930,3890,1530
1321400060,20140627T000000,257500,3,2.25,1715,6819,1715,0
2008000270,20150115T000000,291850,3,1.5,1060,9711,1060,0
2414600126,20150415T000000,229500,3,1,1780,7470,1050,730
3793500160,20150312T000000,323000,3,2.5,1890,6560,1890,0
1736800520,20150403T000000,662500,3,2.5,3560,9796,1860,1700
9212900260,20140527T000000,468000,2,1,1160,6000,860,300
114101516,20140528T000000,310000,3,1,1430,19901,1430,0
6054650070,20141007T000000,400000,3,1.75,1370,9680,1370,0
1175000570,20150312T000000,530000,5,2,1810,4850,1810,0
9297300055,20150124T000000,650000,4,3,2950,5000,1980,970
1875500060,20140731T000000,395000,3,2,1890,14040,1890,0
6865200140,20140529T000000,485000,4,1,1600,4300,1600,0
16000397,20141205T000000,189000,2,1,1200,9850,1200,0
7983200060,20150424T000000,230000,3,1,1250,9774,1250,0
6300500875,20140514T000000,385000,4,1.75,1620,4980,860,760
2524049179,20140826T000000,2.00E+06,3,2.75,3050,44867,2330,720
7137970340,20140703T000000,285000,5,2.5,2270,6300,2270,0
8091400200,20140516T000000,252700,2,1.5,1070,9643,1070,0
3814700200,20141120T000000,329000,3,2.25,2450,6500,2450,0
1202000200,20141103T000000,233000,3,2,1710,4697,1710,0
1794500383,20140626T000000,937000,3,1.75,2450,2691,1750,700
3303700376,20141201T000000,667000,3,1,1400,1581,1400,0
5101402488,20140624T000000,438000,3,1.75,1520,6380,790,730
1873100390,20150302T000000,719000,4,2.5,2570,7173,2570,0
8562750320,20141110T000000,580500,3,2.5,2320,3980,2320,0
2426039314,20141201T000000,280000,2,1.5,1190,1265,1190,0
461000390,20140624T000000,687500,4,1.75,2330,5000,1510,820
7589200193,20141110T000000,535000,3,1,1090,3000,1090,0
7955080270,20141203T000000,322500,4,2.75,2060,6659,1280,780
9547205180,20140613T000000,696000,3,2.5,2300,3060,1510,790
9435300030,20140528T000000,550000,4,1,1660,34848,930,730
2768000400,20141230T000000,640000,4,2,2360,6000,2360,0
7895500070,20150213T000000,240000,4,1,1220,8075,890,330
2078500320,20140620T000000,605000,4,2.5,2620,7553,2620,0
5547700270,20140715T000000,625000,4,2.5,2570,5520,2570,0
7766200013,20140811T000000,775000,4,2.25,4220,24186,2600,1620
7203220400,20140707T000000,861990,5,2.75,3595,5639,3595,0
9270200160,20141028T000000,685000,3,1,1570,2280,1570,0
1432701230,20140729T000000,309000,3,1,1280,9656,920,360
8035350320,20140718T000000,488000,3,2.5,3160,13603,3160,0
8945200830,20150325T000000,210490,3,1,990,8528,990,0
4178300310,20140716T000000,785000,4,2.5,2290,13416,2290,0
9215400105,20150428T000000,450000,3,1.75,1250,5963,1250,0
822039084,20150311T000000,1.35E+06,3,2.5,2753,65005,2165,588
5245600105,20140916T000000,228000,3,1,1190,9199,1190,0
7231300125,20150217T000000,345000,5,2.5,3150,9134,1640,1510
7518505990,20141231T000000,600000,3,1.75,1410,4080,1000,410
3626039271,20150205T000000,585000,2,1.75,1980,8550,990,990
4217401195,20150303T000000,920000,5,2.25,2730,6000,2130,600
9822700295,20140512T000000,885000,4,2.5,2830,5000,2830,0
9478500640,20140819T000000,292500,4,2.5,2250,4495,2250,0
2799800710,20150407T000000,301000,3,2.5,2420,4750,2420,0
7922800400,20140827T000000,951000,5,3.25,3250,14342,3250,0
8079040320,20150223T000000,430000,4,3,1850,9976,1850,0
1516000055,20141210T000000,650000,3,2.25,2150,21235,1590,560
9558200045,20140828T000000,289000,3,1.75,1260,8400,1260,0
5072410070,20141021T000000,505000,3,1.75,2519,8690,2519,0
9528102996,20141207T000000,549000,3,1.75,1540,1044,1540,0
1189001180,20140603T000000,425000,3,2.25,1660,6000,1110,550
3253500160,20141120T000000,317625,3,2.75,2770,3809,1770,1000
3394100030,20140909T000000,975000,4,2.5,2720,11049,2720,0
3717000160,20141009T000000,287000,4,2.5,2240,4648,2240,0
1274500060,20140825T000000,204000,3,1,1000,12070,1000,0
1802000060,20140612T000000,1.33E+06,5,2.25,3200,20158,1600,1600
1525059190,20140912T000000,1.04E+06,5,3.25,4770,50094,3070,1700
1049000060,20150105T000000,325000,3,2,1260,5612,1260,0
8820901275,20140610T000000,571000,4,2,2750,7807,2250,500
5416510140,20140710T000000,360000,4,2.5,2380,5000,2380,0
3444100400,20150316T000000,349000,3,1.75,1790,50529,1090,700
3276920270,20141105T000000,832500,4,4,3430,35102,2390,1040
4036801170,20141013T000000,380000,4,1.75,1760,7300,880,880
2391600320,20150420T000000,480000,3,1,1040,5060,1040,0
6300000287,20140609T000000,410000,3,1,1410,5060,910,500
1531000030,20150323T000000,720000,4,2.5,3450,39683,3450,0
5104520400,20141202T000000,390000,3,2.5,2350,5100,2350,0
7437100340,20141222T000000,360000,4,2.5,1900,5889,1900,0
9418400240,20141028T000000,355000,2,1,2020,6720,1010,1010
1523059105,20150128T000000,356000,3,1.5,1680,8712,1680,0
1133000671,20140602T000000,315000,3,1,960,6634,960,0
4232902595,20141114T000000,940000,3,1.5,2140,3600,1900,240
2599001200,20141103T000000,305000,5,2.25,2660,8400,2660,0
3342103156,20140618T000000,461000,3,3.25,2770,6278,1980,790
1332700270,20140519T000000,215000,2,2.25,1610,2040,1610,0
3869900162,20140904T000000,335000,2,1.75,1030,1066,765,265
2791500270,20140522T000000,243500,4,2.5,1980,7403,1980,0
5036300431,20150311T000000,1.10E+06,5,2.75,3520,6353,3520,0
4168000060,20150226T000000,153000,3,1,1200,10500,1200,0
6021501535,20140725T000000,430000,3,1.5,1580,5000,1290,290
6021501535,20141223T000000,700000,3,1.5,1580,5000,1290,290
1483300570,20140908T000000,905000,4,2.5,3300,10250,2390,910
3422049190,20150330T000000,247500,3,1.75,1960,15681,1960,0
1099611230,20140912T000000,199000,4,1.5,1160,6400,1160,0
722079104,20140711T000000,314000,3,1.75,1810,41800,1210,600
7338200240,20140516T000000,437500,3,2.5,2320,36847,2320,0
1952200240,20140611T000000,850830,3,2.5,2070,13241,1270,800
5200100125,20141027T000000,555000,3,2,1980,3478,1440,540
7214720075,20141212T000000,699950,3,2.25,2190,107593,2190,0
2450000295,20141007T000000,1.09E+06,3,2.5,2920,8113,2920,0
6197800045,20140924T000000,290000,3,1,1210,33919,1210,0
1328310370,20150402T000000,375000,3,2.5,2340,10005,1460,880
546000875,20140523T000000,460000,3,1,1670,4005,1170,500
3530510041,20140723T000000,188500,2,1.75,1240,2493,1240,0
1853000400,20150305T000000,680000,4,2.5,3140,28037,3140,0
3134100116,20140827T000000,470000,5,1.75,2030,12342,2030,0
9545230140,20140725T000000,597750,4,2.5,2310,9624,2310,0
3362400511,20150304T000000,570000,3,1.75,1260,3328,700,560
2525310310,20140916T000000,272500,3,1.75,1540,12600,1160,380
6126500060,20141124T000000,329950,3,1.75,2080,5969,1080,1000
8961960160,20141028T000000,480000,4,2.5,3230,16171,2520,710
3626039325,20141121T000000,740500,3,3.5,4380,6350,2780,1600
3362400431,20140626T000000,518500,3,3.5,1590,1102,1590,0
4060000240,20140623T000000,205425,2,1,880,6780,880,0
3454800060,20150108T000000,171800,4,2,1570,9600,1570,0
1695900060,20150511T000000,535000,4,1,1610,2982,1610,0
7278700070,20150102T000000,660000,3,2.5,2400,6474,1560,840
6675500070,20141119T000000,391500,3,2,1450,9132,1450,0
3626039187,20150406T000000,395000,2,1,770,6000,770,0
3524049083,20141104T000000,445000,4,1.75,2100,4400,1720,380
3275860240,20140618T000000,770000,3,2.25,2910,10204,2910,0
4389200955,20150302T000000,1.45E+06,4,2.75,2750,17789,1980,770
4058801670,20140717T000000,445000,3,2.25,2100,8201,1620,480
8732020310,20140717T000000,260000,4,2.25,2160,8811,1360,800
2331300505,20140613T000000,822500,5,3.5,2320,4960,1720,600
7853210060,20150406T000000,430000,4,2.5,2070,4310,2070,0
3668000070,20150105T000000,212000,3,1.75,1060,7875,1060,0
9545240070,20150428T000000,660500,4,2.25,2010,9603,1440,570
1243100136,20140612T000000,784000,3,3.5,3950,111078,2460,1490
8929000270,20140512T000000,453246,3,2.5,2010,2287,1390,620
2767602356,20150126T000000,675000,4,3.5,2140,2278,2140,0
921049315,20140813T000000,199000,3,1.75,1320,17390,1320,0
3655000070,20140805T000000,220000,4,1.75,2020,7840,1010,1010
4027700812,20140529T000000,452000,4,2.25,2590,10002,1340,1250
3992700335,20140707T000000,382500,2,1,1190,4440,1190,0
2767603505,20140507T000000,519950,3,2.25,1170,1249,1170,0
4232901525,20140627T000000,665000,2,1,1110,3200,1110,0
1777500060,20140708T000000,527700,5,2.5,2820,9375,1550,1270
1432900240,20150508T000000,205000,3,1,1610,8579,1010,600
6140100875,20150415T000000,420000,3,1,1060,8097,940,120
6071600370,20150227T000000,500000,4,2.25,2030,8517,1380,650
1526069017,20141203T000000,921500,4,2.5,3670,315374,3670,0
809001525,20140625T000000,890000,4,1,2550,4000,2370,180
3224079105,20140806T000000,430000,2,2.5,2420,60984,2420,0
8075400570,20141030T000000,258000,5,2,2260,12500,1130,1130
1994200024,20141104T000000,511000,3,1,1430,3455,980,450
3362900810,20140820T000000,532170,3,2,1360,3090,1360,0
1324300398,20150409T000000,560000,3,1,1110,5000,1110,0
537000445,20150331T000000,282950,3,1,1250,8200,1250,0
7855801670,20150401T000000,2.25E+06,4,3.25,5180,19850,3540,1640
7920100045,20140516T000000,350000,1,1,700,5100,700,0
8960000030,20140728T000000,215000,3,1,1180,7669,1180,0
6388930390,20141120T000000,650000,5,3.5,3960,25245,2500,1460
8731900200,20140807T000000,320000,4,2.75,2640,7500,1620,1020
8029200135,20141113T000000,247000,3,2,1270,7198,1270,0
1081200350,20141003T000000,320000,4,1.75,1760,11180,1760,0
84000105,20140507T000000,255000,5,2.25,2060,8632,1030,1030
3756500060,20150309T000000,438000,3,1.75,1780,9660,1780,0
7215720160,20150304T000000,900000,3,2.5,3400,16603,3400,0
3574800520,20140620T000000,441000,3,2.75,1910,7280,1160,750
2617300160,20140812T000000,420000,3,2,2020,38332,1010,1010
2558660270,20141208T000000,370000,3,1.75,1580,7000,1180,400
2009000370,20150219T000000,269950,2,1.75,1340,7250,700,640
1836980160,20150324T000000,807100,4,2.5,2680,4499,2680,0
3261020370,20140605T000000,653000,3,2.5,2680,9750,1610,1070
1755700060,20140611T000000,371500,3,2,1370,8336,1370,0
4330600435,20150316T000000,284000,3,1.75,1560,21000,1560,0
9542800700,20150102T000000,272000,3,1.75,2160,7140,1670,490
1999700045,20140502T000000,313000,3,1.5,1340,7912,1340,0
1762600070,20150116T000000,917500,4,2.5,3880,35003,2570,1310
1687900520,20140929T000000,673000,4,2.25,2590,8190,2590,0
7234600798,20150210T000000,425000,3,2.5,1120,1100,820,300
3881900445,20140709T000000,399950,5,2.75,1970,5400,1320,650
2254502445,20140530T000000,385000,3,1,1220,4800,1220,0
5437810320,20141117T000000,269950,3,1.5,1950,7560,1320,630
9158100075,20150107T000000,330000,2,1,1350,8220,1060,290
3830630310,20140725T000000,260000,3,2.5,1670,5797,1670,0
8123100045,20150414T000000,470000,4,3,2380,5125,1680,700
3127200041,20140613T000000,589000,4,3,2440,9600,2440,0
6661200320,20140723T000000,163500,2,1.5,1050,3419,1050,0
11510310,20140905T000000,835000,4,2.75,3130,13412,2140,990
825059270,20141121T000000,1.10E+06,5,3,4090,12850,2090,2000
8731951370,20150415T000000,269000,4,1.75,1490,10000,1100,390
1954440060,20140505T000000,560000,3,2.5,1900,8744,1900,0
2264500350,20150418T000000,615000,4,1,1330,2400,1330,0
1115810060,20141205T000000,585188,3,2.25,2230,10026,1430,800
9477200200,20140818T000000,305000,3,1.75,1650,9480,1220,430
1432600560,20141105T000000,166950,3,1,1190,8820,1190,0
2287000060,20140912T000000,799000,3,2.5,2140,9897,2140,0
3663500060,20140625T000000,400000,3,2.5,2180,7508,1420,760
3996900125,20141201T000000,230000,3,1,1060,10228,1060,0
7796450200,20140515T000000,256883,3,2.5,1690,5025,1690,0
7549802535,20141111T000000,423000,4,2,1970,6480,1130,840
3278600320,20140723T000000,465000,3,2.5,2150,4084,2150,0
2824079053,20150113T000000,440000,3,2.5,1910,66211,1910,0
1222069094,20141014T000000,385000,3,1.75,1350,155073,1350,0
3542300060,20150311T000000,210000,3,1,860,11725,860,0
2222059065,20141112T000000,297000,3,2.5,1940,14952,1940,0
7551300060,20140716T000000,470000,3,1,1010,5000,1010,0
100600550,20140804T000000,226500,3,1.5,1300,7370,900,400
3211100860,20150303T000000,274250,3,1,910,8450,910,0
3456000310,20140804T000000,840000,4,1.75,2480,11010,1630,850
9526600140,20140919T000000,677900,3,2.5,2440,4587,2440,0
7465900060,20150205T000000,425000,3,1,1010,5864,1010,0
1222000055,20141123T000000,180250,2,0.75,900,9600,900,0
6300000550,20140717T000000,464000,6,3,2300,3404,1600,700
2310030510,20150422T000000,320000,4,2.25,1550,7579,1550,0
1025049114,20140717T000000,625504,3,2.25,1270,1566,1060,210
8677300550,20140515T000000,592500,4,2.5,2240,12032,2240,0
4014400292,20150114T000000,465000,3,2.5,2714,17936,2714,0
1102000196,20140527T000000,477000,4,2.75,1720,6270,1720,0
257000138,20150115T000000,280000,2,1,850,16400,850,0
46100204,20150221T000000,1.51E+06,5,3,3300,33474,1870,1430
1909600046,20140703T000000,445838,3,2.5,2250,5692,2250,0
1250202145,20140828T000000,1.07E+06,2,2.25,3900,14864,1950,1950
7611200125,20141023T000000,467000,2,1.5,1320,10800,1320,0
5611500140,20140822T000000,686000,4,2.5,2760,6440,2760,0
7138000260,20140605T000000,279950,3,2,1750,9750,1350,400
626059335,20140904T000000,527000,4,2.25,2330,19436,2330,0
1922059282,20140918T000000,325000,3,2.25,2220,16020,1780,440
705700390,20140903T000000,328000,3,2.25,2020,8379,2020,0
7454001200,20140604T000000,390000,3,2.25,1250,7500,1250,0
8682281200,20150309T000000,479950,2,2,1510,6516,1510,0
7972000200,20140529T000000,264950,4,2.25,1720,9753,1120,600
722059070,20150115T000000,235000,3,1,1430,15246,980,450
7202340400,20150303T000000,516500,3,2.5,1480,4729,1480,0
8096000060,20150413T000000,655000,2,1.75,1450,15798,1230,220
2424000060,20140616T000000,500000,4,2.75,2280,15347,2280,0
9264902050,20141121T000000,315000,6,2.75,2940,7350,1780,1160
943100260,20141120T000000,213000,2,1,1000,10200,1000,0
3677400445,20140902T000000,475000,3,1.5,2480,5280,1620,860
1762600320,20140610T000000,1.03E+06,5,4,3760,28040,3760,0
4058000060,20150409T000000,416000,3,2,2220,94300,1640,580
7228500560,20150320T000000,410000,4,1,1970,4740,1670,300
326069104,20140701T000000,800000,3,3.5,3830,221284,3530,300
5152100060,20140529T000000,472000,6,2.5,4410,14034,2350,2060
3584000310,20141208T000000,225000,3,1.75,1430,8505,1430,0
8150100045,20141001T000000,210000,2,1,830,6000,830,0
1868901275,20150127T000000,455000,2,1,1430,5000,1430,0
6131600075,20150427T000000,225000,3,1,1300,8316,1300,0
9468200125,20140826T000000,480000,2,1,1030,3060,790,240
8029510030,20150212T000000,363000,3,2.5,2740,11872,2740,0
2025069065,20140929T000000,2.40E+06,4,2.5,3650,8354,1830,1820
7899800890,20150226T000000,181000,2,1.5,720,5120,720,0
3021059276,20150314T000000,250000,4,2,2010,7312,2010,0
3797001895,20150422T000000,481000,3,1.75,1560,3000,770,790
3832710960,20140923T000000,260000,3,2,1810,7209,1240,570
1310430400,20140513T000000,455000,4,2.5,3360,7685,3360,0
1422300030,20150401T000000,415000,3,2.25,1510,36224,1510,0
1105000588,20150421T000000,349500,3,1,1400,3538,800,600
3830630060,20140929T000000,245000,3,2.5,1730,7442,1730,0
5101404898,20140519T000000,592500,2,2,1420,9191,1420,0
7972601890,20141020T000000,385000,4,1.75,2360,7620,1180,1180
5127001620,20150211T000000,315000,3,1.75,1580,11455,1200,380
9407100800,20141124T000000,255000,3,1,1230,10170,1230,0
1873100060,20140829T000000,693000,4,2.5,2460,4425,2460,0
8722101360,20141202T000000,780000,3,1,1660,4400,1460,200
8644000060,20141024T000000,237000,3,1.75,1270,8470,1270,0
3325069129,20141216T000000,525000,3,2.25,2100,40510,1320,780
1400300055,20150428T000000,425000,2,1,770,5040,770,0
2123039032,20141027T000000,369900,1,0.75,760,10079,760,0
8078560140,20140519T000000,290000,4,2.5,1700,7280,1700,0
3438500192,20140929T000000,285000,3,1,1120,10701,1120,0
7974200510,20140814T000000,415000,2,1,1070,4500,1070,0
2557000400,20150409T000000,272500,3,2.5,2070,9900,1420,650
7960900060,20150504T000000,2.90E+06,4,3.25,5050,20100,4750,300
4054500390,20141007T000000,1.37E+06,4,4.75,5310,57346,5310,0
6378500125,20150501T000000,436000,2,1,1040,7538,1040,0
1745100140,20141017T000000,210000,3,1,1700,11390,1700,0
2976800796,20140925T000000,236000,3,1,1300,5898,1300,0
4235400186,20141124T000000,331000,3,1.75,1080,1306,580,500
4215100060,20150320T000000,365000,3,2.5,2653,4510,2653,0
9189700045,20150127T000000,450000,3,2,2290,16258,2290,0
1126049053,20141113T000000,770000,4,2.75,3820,26300,2850,970
2022069200,20150505T000000,455000,4,2.5,2210,49375,2210,0
9412900055,20150505T000000,405000,3,1.75,2390,6000,1240,1150
1722059235,20140703T000000,304900,4,1.75,2600,11325,1610,990
6874200960,20150227T000000,170000,2,1,860,5265,860,0
7424700045,20150513T000000,2.05E+06,5,3,3830,8480,2630,1200
7202360350,20140630T000000,780000,4,2.5,3500,7048,3500,0
5634500392,20150410T000000,330000,3,3,2420,13959,1740,680
1509500060,20140905T000000,370000,4,2.5,2720,8666,2720,0
7214810350,20141017T000000,467000,5,2.25,2500,13500,1850,650
6647200060,20150209T000000,405000,3,1.75,1670,6720,1140,530
9552700140,20140702T000000,675000,5,2.25,2900,10300,1450,1450
2200500350,20140812T000000,500000,2,1,1640,14100,1140,500
6113400046,20140723T000000,389999,4,2.5,1890,15770,1890,0
6619910140,20150224T000000,630000,4,1.75,2950,9025,1780,1170
1115450240,20141022T000000,360000,4,2.5,2160,9528,2160,0
6073240060,20141002T000000,580000,4,3,3280,11060,2270,1010
9297300045,20140709T000000,550000,3,2,1970,4166,1270,700
9510920070,20140710T000000,879000,4,2.5,3360,22111,3360,0
5468730030,20140822T000000,265000,3,2,1320,8959,1320,0
8079030390,20150304T000000,446500,3,2.5,2650,7286,2650,0
600000152,20140602T000000,404000,3,1.5,2030,8880,1330,700
1840000030,20140529T000000,267500,3,1.75,1590,11914,1090,500
3225069065,20140624T000000,3.08E+06,4,5,4550,18641,2600,1950
3260800030,20140811T000000,335000,3,2.5,2440,7632,2440,0
2747100024,20140619T000000,576000,3,2.5,1940,9000,970,970
5104530560,20150401T000000,208633,3,2.5,2040,3810,2040,0
4330600350,20150115T000000,315000,3,2.25,2200,8750,1120,1080
5016001535,20150217T000000,725000,3,1.75,1920,3300,960,960
7280300196,20150403T000000,550000,4,2.75,1800,7750,1400,400
8651520400,20140612T000000,610750,4,2.25,2180,7297,2180,0
7171200445,20150228T000000,550700,2,1,1010,5000,1010,0
3204800200,20150108T000000,665000,4,2.75,3320,10574,2220,1100
3416600800,20150209T000000,834000,4,2.5,2370,4000,1980,390
7994700030,20141023T000000,201000,5,1.75,1660,78408,1660,0
1860600135,20140502T000000,2.38E+06,5,2.5,3650,9050,3370,280
4139480200,20140618T000000,1.38E+06,4,3.25,4290,12103,2690,1600
4139480200,20141209T000000,1.40E+06,4,3.25,4290,12103,2690,1600
1328320800,20141105T000000,305000,4,2.25,1950,7700,1350,600
7771300125,20150408T000000,487000,3,2,2590,14052,1720,870
3422059208,20150511T000000,390000,3,2.5,1930,64904,1930,0
9521101455,20140723T000000,548000,2,1,1470,3864,1170,300
4337000335,20141122T000000,268750,4,1,800,8775,800,0
325059286,20140513T000000,819900,5,2.75,3150,7119,3150,0
2597650240,20141023T000000,520000,3,2.25,2030,16200,2030,0
3353400435,20140721T000000,230000,3,2,1450,11204,1450,0
7972000240,20150202T000000,240000,3,1.75,1510,10248,1510,0
7520000520,20140905T000000,232000,2,1,1240,12092,960,280
7520000520,20150311T000000,240500,2,1,1240,12092,960,280
3530210260,20141027T000000,274975,3,2.5,3030,45004,3030,0
1959700550,20140905T000000,740000,4,2,2050,4400,2050,0
1665400045,20150428T000000,186375,3,1,1000,7636,1000,0
9542850320,20140725T000000,790000,3,2.25,2370,10289,1590,780
3179100060,20140916T000000,880000,4,3.5,2800,6750,1890,910
2946001550,20150416T000000,279000,6,1.75,2240,11180,2240,0
8078490390,20140729T000000,295000,3,2,1810,10530,1810,0
9550201550,20150408T000000,640000,2,1,1070,5000,1070,0
191100045,20140703T000000,940000,4,2,2490,9525,2490,0
5009600070,20141007T000000,260000,4,2.5,1960,5238,1960,0
200350070,20140602T000000,559900,3,2.75,2930,5569,1860,1070
2877103726,20140722T000000,791500,4,2,1510,3500,1510,0
405100295,20140826T000000,265000,3,1.75,1420,8250,1420,0
4268200055,20150501T000000,245000,3,1.75,1740,11547,1740,0
3126069068,20150424T000000,485000,4,1.75,2560,43995,2560,0
1115300070,20141106T000000,684000,4,3.5,3040,8414,2420,620
6414100671,20140909T000000,425000,3,1.75,2500,6840,1300,1200
7004200060,20141017T000000,309600,4,1.75,1275,20000,1275,0
7852110140,20140718T000000,552250,4,2.5,2580,5823,2580,0
3969300030,20140723T000000,165000,4,1,1000,7134,1000,0
3969300030,20141229T000000,239900,4,1,1000,7134,1000,0
4048400070,20141205T000000,320000,2,1,1070,32633,1070,0
808000070,20141021T000000,206600,3,2,1390,13464,1390,0
7374200030,20150416T000000,387000,4,1.75,2500,7690,1250,1250
7325600160,20140604T000000,299000,1,0.75,560,12120,560,0
2757000030,20140922T000000,855000,4,2.75,2270,10460,2270,0
616000140,20150126T000000,315000,3,1,1900,14400,1300,600
3363900111,20141203T000000,437500,2,1,990,3120,790,200
9262800171,20150324T000000,252000,4,1.5,1550,19800,1050,500
6607000126,20140604T000000,375000,4,1.75,2200,7475,1100,1100
5416510830,20140806T000000,300000,4,2.5,1910,4862,1910,0
2201500030,20141006T000000,420000,4,1,1750,9600,1750,0
325059171,20140505T000000,900000,3,1,1330,77972,1330,0
952003285,20140805T000000,679900,3,2.5,2440,5750,1980,460
3211290370,20140605T000000,463000,3,2.5,1640,29970,1640,0
1072010350,20140828T000000,380000,5,2.5,2760,11340,2760,0
8856950070,20141210T000000,329500,4,2.5,1820,7912,1820,0
925059078,20140819T000000,604950,3,2.5,2110,5608,1340,770
7855801090,20140917T000000,795000,5,2.5,3040,9570,1640,1400
723099065,20150130T000000,465000,3,2,1840,40438,1840,0
6116500075,20150326T000000,673000,4,2.5,2990,10400,2990,0
1118500030,20141001T000000,810000,4,2.5,3520,15420,3520,0
424069250,20150423T000000,785000,4,2.75,2440,69415,1910,530
3291800710,20141120T000000,338000,4,3,2090,7500,1370,720
6838700060,20141204T000000,280000,3,2.25,1430,7222,1430,0
2231500030,20141001T000000,315000,4,2.25,2180,10754,1100,1080
2231500030,20150324T000000,530000,4,2.25,2180,10754,1100,1080
7683900200,20141223T000000,380000,5,3,3450,9914,3450,0
8155830060,20140811T000000,297000,3,2.25,1450,7562,1450,0
98020310,20140520T000000,730000,4,2.5,3230,7331,3230,0
9423400140,20140609T000000,450000,3,1.75,1640,13500,1110,530
1545804860,20141027T000000,275000,3,3,1590,7750,1060,530
2883200160,20150429T000000,595000,4,2,2020,2849,2020,0
7132300695,20150421T000000,435000,3,1.5,1300,3348,1300,0
1726059053,20140916T000000,270000,2,1.5,1380,209959,1380,0
624111000,20140805T000000,950000,3,3,4040,14338,3030,1010
808300310,20150313T000000,389000,4,2.25,2130,5337,2130,0
8563040160,20150121T000000,560000,4,2.25,2550,7800,1580,970
713500030,20140728T000000,1.35E+06,5,3.5,4800,14984,3480,1320
8651600160,20141111T000000,799000,4,2.25,2510,11585,2510,0
9517200030,20140625T000000,365500,3,2,1410,9600,1410,0
2460700700,20140515T000000,252350,3,2,1650,7352,1160,490
1223039290,20140905T000000,403950,4,2.5,2120,13780,2120,0
2890100060,20140801T000000,385000,4,1.5,2040,10726,1380,660
7972600860,20141210T000000,345000,4,1,1550,7620,1550,0
8857320070,20140917T000000,490000,3,2.75,1980,3128,1980,0
4047200695,20140618T000000,330000,3,2.5,1600,26977,1600,0
1653500070,20140512T000000,927000,4,2.75,3300,12090,3300,0
1923000030,20140728T000000,1.12E+06,4,2.5,3840,16619,3840,0
3649100320,20150430T000000,330000,2,1,1220,10000,1220,0
7375300160,20150309T000000,530000,5,2.25,2720,8800,1500,1220
5175800060,20140623T000000,365000,4,2,1940,25600,1940,0
1604601375,20140619T000000,378750,3,2.5,2160,3000,1260,900
2473251090,20140619T000000,269900,4,1.75,1530,8750,1530,0
9126100861,20150306T000000,557000,3,3.5,1710,2096,1290,420
3420069065,20140825T000000,360000,4,1.75,3730,16980,2150,1580
6021501685,20150422T000000,352000,2,1,940,5000,940,0
1151100070,20150224T000000,437000,3,2.5,1750,22357,1750,0
8856950240,20140618T000000,322500,4,2.5,1820,6753,1820,0
9385200055,20140912T000000,650000,3,3.25,1510,2000,1330,180
7821200390,20140806T000000,450000,3,2,1290,1213,1290,0
8078520310,20150417T000000,278500,3,2,1570,5250,1570,0
1565950030,20150427T000000,364950,4,2.5,1930,6957,1930,0
1560930070,20140911T000000,840000,4,3.5,2840,40139,2840,0
6700400140,20150318T000000,268000,3,2.5,1550,8134,1550,0
2422029094,20140716T000000,517534,2,1,833,143947,833,0
1774220160,20141104T000000,632925,3,2.5,2990,32239,2990,0
1525200060,20140723T000000,577500,3,2.5,2000,7251,2000,0
1678400105,20150212T000000,339000,4,1.5,2390,7480,2390,0
3426059070,20140909T000000,570000,3,1.75,2910,37461,1530,1380
824079032,20140626T000000,563500,4,1.75,2085,174240,1610,475
2697100140,20150105T000000,423000,4,2.25,2200,9351,1290,910
8724300030,20141223T000000,355000,3,2.25,1860,5028,1860,0
8678500060,20140710T000000,1.55E+06,5,4.25,6070,171626,6070,0
625049299,20141203T000000,482000,2,1,950,3960,950,0
6073200075,20140730T000000,625000,3,1.75,1600,9135,1600,0
6388900710,20141219T000000,538000,3,2.5,2250,11632,2250,0
1442860160,20150107T000000,380000,3,2.5,2280,10255,2280,0
7942600310,20140717T000000,375000,2,1,940,5120,940,0
1545808560,20150403T000000,245000,3,2.5,1530,8500,1030,500
936000060,20141114T000000,310000,5,1.75,2190,27260,2190,0
9808650060,20150225T000000,1.30E+06,3,2,2350,15021,1770,580
3754700160,20140506T000000,397000,4,2,1440,7680,1200,240
305500140,20150512T000000,365000,3,2.5,2200,4052,2200,0
5468750060,20141028T000000,328500,4,3,2290,8250,2290,0
2944010240,20140908T000000,988000,4,3,4040,19700,4040,0
3454000060,20140722T000000,1.00E+06,4,2.5,2610,3277,1920,690
646910160,20140903T000000,237000,3,2.5,1490,2138,1490,0
8564950390,20140919T000000,525000,4,2.5,2450,5280,2450,0
2268400350,20140916T000000,749000,4,2.5,1710,9627,1440,270
7504101040,20140821T000000,722500,5,2.5,4870,11800,3470,1400
11500890,20150312T000000,843000,3,2.5,3130,8750,3130,0
9528102772,20140708T000000,438000,2,2,1270,1372,1270,0
284000223,20140916T000000,578000,3,1.75,2120,10875,1540,580
3353401710,20140923T000000,227950,3,1.5,1670,8230,1670,0
8159610030,20140722T000000,196000,3,2.25,2070,11576,2070,0
3179100435,20140715T000000,641000,2,1,1420,5332,1070,350
822079033,20150422T000000,350000,3,1.5,1250,219978,1250,0
8857600960,20140819T000000,205000,3,1,940,7980,940,0
1774000200,20141202T000000,400000,3,1.75,1920,9102,1920,0
2024069128,20141110T000000,1.03E+06,3,2.5,3545,9816,2610,935
1049010390,20150319T000000,505000,3,2,1260,5460,1260,0
7905370390,20141009T000000,475000,5,2.5,2340,7200,1300,1040
4140090240,20141105T000000,520000,3,2.25,2590,9263,1440,1150
4055700030,20150502T000000,1.45E+06,3,4.5,3970,24920,3260,710
3775300030,20141231T000000,333500,3,1.75,1220,9732,1220,0
2525300030,20150222T000000,232000,3,1,1400,10403,1400,0
1324059104,20150421T000000,691100,3,2.75,2360,16117,1710,650
2287000030,20141014T000000,811000,3,1.75,1870,9897,1870,0
7702010030,20140520T000000,551000,3,2.5,2830,5802,2830,0
1529200340,20150108T000000,496500,3,2.5,2260,3640,2260,0
2122039094,20141126T000000,705000,3,3,1970,20978,1770,200
1742800030,20140612T000000,578000,4,2.5,3140,9225,1770,1370
1796360350,20150128T000000,255000,3,1.75,1240,8659,1240,0
6154500070,20140626T000000,1.05E+06,4,3.5,3450,7832,3450,0
1843100340,20150305T000000,348000,3,2.25,2570,8491,2570,0
8944290160,20141104T000000,230000,3,2,1510,3413,1510,0
4166600473,20141209T000000,359500,4,2.25,2390,11250,2390,0
7282300125,20141112T000000,330000,3,1,980,7000,980,0
8658300340,20140523T000000,80000,1,0.75,430,5050,430,0
2419600075,20141201T000000,465000,3,1.75,1480,6360,1480,0
2621760350,20141015T000000,325000,4,2.5,1850,7324,1850,0
1723049270,20150107T000000,340500,3,2,2270,28025,1920,350
4123840310,20150106T000000,342500,3,2.5,1810,5192,1810,0
2172000075,20140623T000000,290900,2,2,1610,17600,1610,0
8651611170,20150213T000000,868700,3,4.25,3840,6161,3840,0
8820902200,20141113T000000,1.20E+06,4,2.75,4110,8400,3130,980
8651610890,20141014T000000,1.15E+06,4,3.25,4190,10259,3150,1040
1853080570,20140811T000000,859900,4,2.75,3390,6298,3390,0
3629920030,20140808T000000,520000,4,2.25,1890,3006,1890,0
1604602050,20140711T000000,460000,3,2.5,1610,2527,1080,530
6844700810,20140901T000000,438924,3,1.5,1050,4590,850,200
66000070,20150406T000000,315000,2,1,630,6550,630,0
6665800030,20140718T000000,590000,4,2.75,2910,10650,1780,1130
2205700350,20141104T000000,378500,4,1.75,1700,8640,850,850
5466000030,20140603T000000,328500,3,2.5,1950,8130,1950,0
6189200125,20150325T000000,849950,3,3,2990,9773,2990,0
9169600135,20141027T000000,525000,3,1.5,1350,6000,900,450
2625069070,20150410T000000,1.39E+06,4,3.25,4860,181319,4860,0
8732131090,20150428T000000,295000,4,2.5,2160,7725,1460,700
9286000240,20140711T000000,1.07E+06,6,3.5,4860,11793,3860,1000
1895000260,20140721T000000,207950,2,2,890,5000,890,0
8691370400,20141216T000000,699900,4,2.75,2810,7302,2810,0
5423010350,20150210T000000,1.28E+06,5,2.5,3400,9500,3400,0
8562501040,20141120T000000,452000,4,1.5,1580,7350,960,620
2475200140,20150205T000000,370000,3,2,1680,5036,1680,0
7942100310,20150127T000000,232000,3,1.75,1300,11230,1300,0
3760000030,20141030T000000,669950,5,2.5,2820,14062,2380,440
1727500340,20140614T000000,397500,3,2,1510,6710,1070,440
9828702519,20140512T000000,490000,2,2.5,1230,1391,870,360
4432600075,20150128T000000,725000,4,2,2110,4140,1710,400
7806300030,20140917T000000,299000,3,2.75,3080,19635,1610,1470
9274202270,20140818T000000,625000,2,1.5,1490,5750,1190,300
7852030960,20141106T000000,437500,3,2.5,2120,4500,2120,0
7852170140,20150510T000000,650000,4,2.5,3180,5438,3180,0
7518503335,20140519T000000,475000,2,1,1490,3825,860,630
5467900070,20140502T000000,342000,3,2,1930,11947,1930,0
1245002952,20141015T000000,1.20E+06,4,2.5,2770,7800,2770,0
8906200070,20150210T000000,280000,3,1.5,1670,11610,1670,0
5379805885,20140521T000000,240000,2,1.75,1330,7200,1330,0
2769600560,20140527T000000,529000,3,1,1210,3328,1210,0
9238901420,20150202T000000,442000,3,1,1190,5100,1030,160
5113400431,20140508T000000,615000,2,1,1540,6872,820,720
3885805665,20140612T000000,1.49E+06,4,3.75,4030,10800,4030,0
8121200810,20150505T000000,585000,4,1.75,2430,7559,1580,850
5126310400,20150305T000000,480000,4,2.5,2600,7787,2600,0
7322910030,20140721T000000,1.10E+06,5,3.5,4410,57063,4410,0
2827100070,20141105T000000,290000,4,1,1330,8184,1330,0
9276201895,20140820T000000,615000,3,1.75,1900,5000,950,950
4402700070,20150311T000000,300000,2,1,1100,7680,1100,0
1922059046,20141029T000000,308000,3,1,1980,39150,1580,400
925059288,20150507T000000,750000,3,2.5,2400,7745,2400,0
4386700135,20141114T000000,2.25E+06,4,2.25,4760,8036,3390,1370
1923069078,20140805T000000,890000,4,3.25,3180,194278,3180,0
1432400335,20150325T000000,288000,3,1,1190,7560,1190,0
1180003090,20140906T000000,190000,2,1,630,6000,630,0
726049331,20150326T000000,515000,5,3,2530,5105,1520,1010
3340401555,20141105T000000,235000,4,1.5,1690,11054,1690,0
7453000070,20140818T000000,275000,2,1,940,5000,940,0
4348800030,20141121T000000,727500,2,2,1240,9119,1240,0
7202331420,20140620T000000,650000,4,2.5,3040,6587,3040,0
3225079035,20140618T000000,1.60E+06,6,5,6050,230652,6050,0
6381500700,20141105T000000,365000,4,1,1590,7085,1590,0
339500160,20141008T000000,662000,3,1.75,2500,36947,2500,0
1545807610,20150429T000000,270500,3,2.5,1780,7848,1320,460
1843200240,20150505T000000,200000,2,1.5,1360,1898,1360,0
4403600270,20150224T000000,970000,4,3.25,4740,76230,4740,0
2008200060,20140624T000000,160000,3,1.5,1010,9600,1010,0
1521069070,20150218T000000,204000,3,1,1040,7405,1040,0
2459500310,20150218T000000,358000,3,2.25,1610,6655,1610,0
6204420070,20150501T000000,452000,4,1.75,1570,8268,1570,0
5694500105,20141204T000000,595000,2,2,1510,4000,1010,500
5466410030,20150410T000000,249000,3,2,1360,6082,1360,0
9485740340,20150310T000000,346900,4,2.5,1970,5106,1970,0
622049114,20150218T000000,2.13E+06,3,2.5,5403,24069,5403,0
2270000070,20141030T000000,280000,4,2.5,1560,4350,1560,0
1310900260,20141013T000000,318888,4,1.75,2320,12000,2270,50
224069094,20140911T000000,530000,3,2.25,2120,40518,2120,0
7800800160,20141121T000000,375000,3,2.25,2120,18500,2120,0
2944000240,20150422T000000,910000,4,2.5,3350,29242,3350,0
4139400710,20140523T000000,782000,4,2.5,2380,9614,2380,0
7899800860,20150319T000000,259950,2,2,1070,649,720,350
2473420140,20140923T000000,315000,4,2.75,2300,18360,1560,740
5000500055,20140528T000000,215000,2,1,1320,8865,1320,0
4099500935,20140723T000000,705000,3,1.75,2180,10221,1140,1040
1373800295,20141013T000000,1.45E+06,3,3,4380,6320,3580,800
4025300135,20150508T000000,451000,3,1.75,1790,9813,1790,0
3294700310,20140902T000000,261000,2,1,750,8125,750,0
8718500075,20141117T000000,396000,3,1.5,1300,8280,1300,0
4309710240,20140722T000000,725000,4,2.5,2990,29170,2990,0
5486800070,20140620T000000,1.95E+06,7,3.5,4640,15235,2860,1780
236400320,20140715T000000,238000,4,1,1400,7242,1400,0
4376700570,20150427T000000,750000,6,1.75,2750,9563,2750,0
8648100200,20141027T000000,331500,4,2.5,2050,10271,2050,0
3624079046,20141028T000000,460000,4,3,2230,108900,1410,820
1921069084,20140707T000000,404950,4,2.25,2340,217014,2340,0
6431500140,20141217T000000,880000,3,2.5,2870,5163,2870,0
2725069050,20140613T000000,863000,4,2.5,4120,22370,4120,0
5307100060,20141216T000000,638700,3,1.75,2080,9162,1370,710
7203102050,20140728T000000,435000,3,2.5,1840,5680,1840,0
561000075,20141231T000000,260000,3,1,1180,5350,1180,0
2436701180,20140814T000000,671500,5,2.75,2160,4000,1530,630
809002765,20141022T000000,610000,3,1,1180,3400,1180,0
4045500710,20141218T000000,405000,2,0.75,1160,15029,870,290
5104510270,20140718T000000,338900,4,2.5,1830,5612,1830,0
98020350,20150123T000000,720000,4,4,3200,7708,3200,0
1714900060,20150424T000000,442000,5,3,2560,5445,1760,800
1189000030,20140603T000000,650000,5,2.75,2550,5040,2550,0
2473360060,20150102T000000,263500,3,1.75,1330,9917,1040,290
222069082,20141217T000000,300000,2,1,1220,75794,1220,0
8669160310,20141209T000000,266000,3,2.5,1805,3402,1805,0
1526069135,20141211T000000,930000,4,4,6050,84942,4150,1900
1088650310,20150127T000000,530000,4,2.5,2320,5493,2320,0
8945200860,20141211T000000,180000,3,1,1384,8960,1384,0
7853240200,20140516T000000,619000,3,2.5,2720,6439,2720,0
7511800070,20140821T000000,264000,3,1.5,1820,10608,1820,0
2998800125,20140701T000000,730000,2,2.25,2130,4920,1530,600
3876300310,20141022T000000,439000,4,2.25,2060,10070,2060,0
5419800510,20141117T000000,268500,4,1.75,1420,7500,1080,340
192460060,20140715T000000,330000,3,1.75,1510,15744,1510,0
7942601895,20140819T000000,640000,3,2.5,2160,4000,1960,200
7504010570,20140708T000000,900000,3,2.5,3180,12600,3180,0
1442740140,20140930T000000,370000,3,2.25,2110,13300,2110,0
6909200575,20150314T000000,685000,3,2,2060,2900,1330,730
2525069041,20140904T000000,505000,3,1.5,1830,217800,1010,820
3620069036,20141021T000000,265000,3,1.75,1820,32666,1820,0
2781280390,20150324T000000,290000,3,2.5,1610,2937,1610,0
9542830350,20140902T000000,296000,4,2.5,1780,3600,1780,0
1123049053,20150213T000000,360000,4,2.5,1840,9611,1840,0
8018600765,20140604T000000,240500,3,1.75,1460,10584,990,470
3278600240,20140722T000000,372500,2,2.5,1400,2958,1400,0
7846200070,20141002T000000,595000,3,2.5,3370,14402,3370,0
662310400,20141017T000000,515000,4,3,3590,8249,3590,0
8651100140,20140805T000000,1.22E+06,4,2.25,3200,15367,3200,0
8682250350,20141009T000000,507000,2,1.75,1670,6460,1670,0
3211230260,20150204T000000,399950,4,2,2420,31465,2420,0
4233400340,20140820T000000,185000,3,1.75,1430,10816,1430,0
7199350340,20140825T000000,460000,3,1.75,1440,7070,1440,0
3904901710,20150224T000000,435500,3,2.25,1450,4789,1450,0
240000058,20150408T000000,469000,4,2.75,3550,13938,2100,1450
6865200444,20140505T000000,531000,2,3,1270,1175,1110,160
9498200046,20150206T000000,443500,2,1,940,6804,940,0
1796380960,20141126T000000,223000,3,2,1670,6824,1300,370
5631500868,20150417T000000,590000,4,3.5,3100,15842,2400,700
3126049411,20141209T000000,340000,2,2.5,1100,1760,1100,0
2321300390,20141105T000000,650000,3,2,1870,3388,1230,640
3905040800,20140925T000000,533600,3,2.5,1930,5080,1930,0
4379400260,20140610T000000,695000,3,2.75,2540,4694,2540,0
5115000160,20140617T000000,242000,3,1.75,1280,7524,1280,0
2826049234,20150114T000000,425000,3,2.25,1820,8814,1280,540
6600700030,20150506T000000,525000,3,2.25,1490,9414,1490,0
3904930240,20140922T000000,485000,3,2.5,1880,5502,1880,0
9407110700,20150113T000000,175000,3,1,1250,9775,1250,0
1682500160,20140619T000000,210000,3,2,1440,7210,1440,0
8078570390,20150415T000000,260000,3,2.5,1920,7415,1920,0
3010300240,20140623T000000,577000,3,2.5,2060,5750,1330,730
9500900135,20141021T000000,200000,3,1.5,1210,10588,1210,0
461001615,20150225T000000,605000,2,1.75,1760,5000,940,820
6411600069,20140521T000000,325000,3,1,990,6750,990,0
7812800565,20140814T000000,289500,3,1,960,6400,820,140
7548300731,20140808T000000,559950,3,2.5,1660,1458,1660,0
8925100390,20150406T000000,1.04E+06,3,1.75,1900,9375,1330,570
7010700292,20141009T000000,543500,3,2.25,1270,2790,990,280
9485951170,20140522T000000,480000,4,2.25,3250,34293,3250,0
5437820310,20140523T000000,218000,3,1,960,9633,960,0
582000135,20140622T000000,565000,2,1.75,1330,6000,960,370
3204800370,20141212T000000,426700,3,1.75,2080,7700,1600,480
8832900550,20140912T000000,650000,3,2.5,2690,11575,2130,560
9550204515,20140924T000000,542000,2,1,890,3060,770,120
7199330390,20140624T000000,415000,3,1.75,1070,8000,1070,0
6131600060,20140815T000000,214000,3,1,1200,8316,1200,0
5379805460,20150121T000000,245000,3,1.5,1360,8910,1360,0
7212652180,20140701T000000,314500,3,2,2050,13303,2050,0
6379500640,20150409T000000,1.12E+06,3,1.5,3000,5750,2000,1000
4315700060,20150303T000000,378000,2,2,1300,3850,800,500
3329500060,20140728T000000,305000,4,2.5,2250,9091,1340,910
4140090320,20150320T000000,595000,5,2.75,3740,6750,1980,1760
9385200045,20150512T000000,729500,3,2.5,1660,1091,1530,130
7852180340,20140930T000000,430000,3,2.5,2360,6699,2360,0
1545804340,20150409T000000,240000,3,1.75,1760,6500,1150,610
2490200320,20150320T000000,545000,3,1.75,1680,6200,1680,0
2218000335,20140707T000000,530000,3,1.75,1320,2500,870,450
922049078,20141118T000000,157000,1,1,870,26326,870,0
2586800270,20150407T000000,425000,4,1,1260,7645,1260,0
4338800370,20141117T000000,220000,3,1,1000,6020,1000,0
7214700350,20141124T000000,521000,4,1.75,2020,36400,1550,470
3226200105,20140523T000000,325000,3,1,1920,6862,1120,800
2324039036,20150403T000000,597500,3,2,2150,5400,1380,770
7849202231,20140723T000000,337000,3,2.5,1470,3976,1470,0
5196410260,20150422T000000,1.00E+06,3,2.5,3180,10492,3180,0
3760500116,20141120T000000,3.07E+06,3,2.5,3930,55867,2330,1600
2985800030,20140507T000000,495000,3,1,990,6000,990,0
259900160,20150102T000000,748000,4,3.5,2770,3330,1970,800
708000030,20140902T000000,888000,3,1.5,1250,8710,1250,0
192460310,20150324T000000,269900,3,1.75,1140,22267,1140,0
9412200260,20141113T000000,496500,4,2.5,2250,14440,1550,700
1062100116,20150121T000000,475000,3,2.5,1640,5097,1640,0
6798100662,20140527T000000,312000,3,1.5,1255,1374,1255,0
1775920350,20141124T000000,323000,3,1,1290,12231,1290,0
2525500260,20141124T000000,331000,3,1.75,1300,9079,1300,0
6145600041,20140514T000000,306000,3,1.5,1220,1086,1220,0
3300701615,20140930T000000,655000,4,2.5,2630,4000,2630,0
5151600340,20140709T000000,290000,3,1.5,1950,15954,1950,0
7613700521,20140802T000000,1.25E+06,4,3.25,3160,5000,2360,800
2710600045,20140616T000000,460000,3,1.75,1550,4708,860,690
5101405124,20140912T000000,435000,4,2.5,1700,6380,850,850
6067910030,20150316T000000,664000,4,2.75,2510,11880,1630,880
1959701890,20140729T000000,865000,4,1.75,1800,4180,1800,0
1402200340,20140813T000000,385000,3,1.75,1800,18000,1200,600
3558900070,20140718T000000,497000,3,2.25,1870,9315,1350,520
7846700310,20140623T000000,280000,2,1,1010,3000,1010,0
3348401740,20150127T000000,188000,2,1.5,1120,17487,1120,0
3013300288,20140930T000000,478500,3,1,2090,4755,1200,890
7852070060,20140731T000000,1.15E+06,4,3.5,4370,18361,4370,0
5029450160,20140815T000000,222000,3,2,1440,7187,970,470
3526069070,20140528T000000,799000,4,3,2580,209523,2580,0
5104540240,20140609T000000,609900,4,2.5,3190,7399,3190,0
3438500486,20141016T000000,413000,4,3.5,2380,5809,1750,630
5102400105,20141013T000000,400000,4,1,1420,4875,1420,0
2346200030,20150105T000000,802541,5,2.75,2990,6768,2990,0
1321710030,20140519T000000,320000,3,2.5,2680,7757,2680,0
7853290030,20150311T000000,507000,4,2.5,2730,7649,2730,0
1566100400,20140924T000000,387500,3,1,1220,8329,1220,0
1775800800,20150224T000000,396000,3,1,1500,12616,1500,0
9133600075,20140821T000000,373000,3,1.75,1830,11788,1430,400
5450900060,20140923T000000,1.48E+06,5,2.5,4570,19252,4570,0
1402600700,20140721T000000,359900,4,2.25,2470,7698,2470,0
8024200350,20150304T000000,410000,2,1,800,4342,670,130
3121500340,20140712T000000,690000,4,2.5,2900,23488,2900,0
7697870860,20140625T000000,245000,3,2,1410,5760,1410,0
7527200030,20141229T000000,700000,5,2.5,2830,25958,1610,1220
2013200390,20140922T000000,268000,4,1.75,1680,9966,1100,580
766500030,20140610T000000,225000,3,1.75,1760,26055,920,840
6664000030,20141009T000000,980000,4,2.25,2240,11034,2240,0
9349900105,20150407T000000,795000,2,1,1380,5000,1380,0
1895000045,20150504T000000,195000,2,1,820,5100,820,0
6205500030,20141103T000000,480000,4,2,2180,10575,1730,450
7011200260,20141219T000000,485000,4,2,1400,3600,1100,300
41000454,20140815T000000,130000,2,1,880,9000,880,0
7203600550,20140804T000000,325000,2,1,1060,5703,1060,0
9477200560,20150413T000000,440000,3,1.75,1530,7245,1530,0
4022907770,20141014T000000,550000,4,1.75,2480,14782,1460,1020
5231000060,20140805T000000,310000,3,1.75,1490,7150,1490,0
6055000310,20140701T000000,530000,3,2.5,3660,39478,3260,400
3216900060,20140625T000000,390000,4,2.5,2340,8548,2340,0
7967200060,20140908T000000,243000,3,1.75,1450,12125,1450,0
8077210350,20140722T000000,639000,4,2.5,2210,9875,2210,0
7203000640,20140918T000000,215000,4,1,1130,7400,1130,0
2988000070,20150304T000000,405000,5,1.75,1550,10500,1100,450
3832200070,20141222T000000,250000,4,1.75,1710,7140,1010,700
3670500710,20140715T000000,405500,3,1.5,1010,8108,1010,0
8820903380,20140728T000000,452000,6,2.25,2660,13579,2660,0
8820903380,20150102T000000,730000,6,2.25,2660,13579,2660,0
4233400400,20150414T000000,267000,3,2,1300,9644,1300,0
3793500550,20140808T000000,289950,3,2.5,1670,6186,1670,0
6431000270,20140728T000000,565000,2,1,960,4080,960,0
2225059214,20140808T000000,1.58E+06,4,3.25,4670,51836,4670,0
7694800270,20150420T000000,636000,3,2.5,2140,2770,1770,370
2171400197,20140918T000000,350000,5,3,2520,5500,1550,970
2473400340,20140604T000000,320000,3,1.5,1650,9380,1130,520
3530490070,20140613T000000,210000,2,1.75,1440,5680,1440,0
1932300075,20140910T000000,245000,2,1,1050,5900,1050,0
2525000510,20141106T000000,328000,3,1.75,1470,7650,1130,340
1853000510,20140509T000000,985000,4,2.25,4230,37769,4230,0
1742800060,20140612T000000,501000,3,1.75,1970,7972,1370,600
2723089104,20140917T000000,315000,3,2.25,1540,17424,1540,0
2619950350,20140508T000000,403000,3,2.75,2090,8354,2090,0
4021100045,20140715T000000,550000,3,2,2380,17950,2110,270
731500200,20150113T000000,347500,4,2.5,2156,3562,2156,0
2591820310,20141006T000000,365000,4,2.25,2070,8893,2070,0
3626039299,20150224T000000,588000,3,1,1910,8167,1270,640
9346980140,20140820T000000,605000,3,1.75,1920,7400,1260,660
6613000140,20141113T000000,1.30E+06,3,3.25,3400,5979,2290,1110
8159610060,20141119T000000,233000,3,2,1400,9177,1400,0
7830800339,20140728T000000,360000,4,2.5,2210,17715,2210,0
1588600045,20141215T000000,459000,2,1.75,1170,4887,1020,150
826069046,20141107T000000,740000,3,2,2100,72745,2100,0
1771000890,20140917T000000,305000,3,1,1160,9750,1160,0
3300701170,20140620T000000,395000,3,1,1500,4000,900,600
7340500270,20150123T000000,560000,4,2.5,2940,6000,2940,0
9277200111,20140714T000000,650000,4,1.75,2010,5070,1300,710
293720140,20140605T000000,449950,3,2.5,2170,4912,2170,0
579003610,20150224T000000,517500,3,1.5,1430,5200,1250,180
1138020200,20140903T000000,435000,4,1.5,1510,6460,1070,440
3432500200,20150409T000000,329999,3,1,1150,6908,800,350
1563102435,20141210T000000,950000,3,1.75,2150,4200,1140,1010
3959400710,20140730T000000,447000,3,1,1370,6001,1230,140
8682300890,20140828T000000,699800,2,2.5,2380,6600,2380,0
4385700765,20140603T000000,850000,3,1.75,1370,3850,770,600
5149300200,20140902T000000,316500,3,1.75,1600,14250,1070,530
9323600060,20140715T000000,942500,5,3.5,3750,9612,2030,1720
9273200140,20150121T000000,1.31E+06,2,2.25,3950,3938,2910,1040
9542300320,20150202T000000,856600,4,2.25,2400,13430,2400,0
770000045,20141024T000000,405600,5,1.5,2830,4000,2830,0
6979900390,20140529T000000,565000,4,2.5,2440,22594,2440,0
6379500159,20140911T000000,400000,3,2.25,1190,1149,1050,140
826079094,20150324T000000,330000,3,2,1400,218252,1400,0
8856940060,20150227T000000,374950,4,2.75,2730,4683,2730,0
2972300060,20141217T000000,405300,3,2.75,2390,7939,1610,780
3575200070,20141104T000000,560000,3,2.25,2060,31400,2060,0
8146100270,20150324T000000,824000,4,2.25,2490,9864,1290,1200
8648200030,20140716T000000,260000,3,1.75,1100,10968,1100,0
208500160,20150107T000000,760000,4,2.5,2430,6099,1470,960
1196003428,20140624T000000,405000,3,2.5,3170,12750,2360,810
5104450990,20140619T000000,429900,4,2.5,2640,8625,2640,0
3343901234,20141113T000000,341500,3,1.5,1130,7223,1130,0
226039214,20140612T000000,465250,5,2,1940,7642,1940,0
1623300160,20140506T000000,450000,2,2,1100,3000,1100,0
2205500575,20150209T000000,390000,3,1,1200,10800,1200,0
4040800810,20140502T000000,420000,3,2.25,2000,8030,1000,1000
2612000390,20140615T000000,269950,3,2.5,1890,4838,1730,160
3814400125,20141016T000000,493000,4,2,1910,2874,1060,850
7300400060,20140515T000000,370000,4,2.5,2710,5880,2710,0
1954700695,20140612T000000,2.25E+06,5,4.25,4860,9453,3100,1760
7230200340,20150225T000000,305000,3,1,1250,23680,1250,0
3191000240,20140612T000000,400000,3,1.75,1590,8219,970,620
1139000069,20141118T000000,320000,3,1.5,1240,1221,1050,190
5693500270,20150121T000000,715000,4,1,2000,4800,2000,0
686500030,20141202T000000,650000,6,2.75,3610,10003,3610,0
8731901940,20150304T000000,218000,5,1.75,1930,8040,1930,0
2688100071,20150415T000000,500000,2,1,1280,5400,1280,0
2423069155,20141120T000000,460000,4,2,2090,40419,2090,0
2329500260,20140709T000000,232500,3,1.5,1940,9887,1140,800
2608300030,20140516T000000,408200,3,2.5,1800,5761,1800,0
1494300060,20140611T000000,522000,3,1.75,1730,8400,1400,330
7504101230,20140623T000000,675000,4,2.5,2810,11120,2810,0
8081020370,20140709T000000,1.36E+06,4,3.5,3550,11000,2260,1290
1446800511,20141009T000000,249950,4,1,1330,7980,1330,0
1623049062,20150304T000000,210000,2,1,750,34133,750,0
6145601000,20140711T000000,429950,4,1,1760,7216,1090,670
205000520,20141006T000000,737500,4,2.5,3200,36276,3200,0
3885805935,20140926T000000,710000,4,2,1740,9000,1740,0
7852020640,20141020T000000,470000,3,2.5,2100,4700,2100,0
6838800140,20150224T000000,1.10E+06,4,3.5,4270,40097,4270,0
4083305445,20140815T000000,650000,3,2,1340,2720,1340,0
7855801610,20140519T000000,1.22E+06,4,2.5,3190,8684,1680,1510
7940700260,20150115T000000,422120,3,2.5,1630,4534,1630,0
8854100350,20150107T000000,625000,5,2.5,2990,15085,2990,0
4365200860,20140606T000000,385200,4,1,1550,7740,1550,0
3904980030,20150414T000000,500000,3,2.25,1690,4964,1690,0
7843500070,20141118T000000,308000,4,2.25,1960,12243,1960,0
6067900060,20140605T000000,565000,3,2.75,2390,9966,1360,1030
7202340960,20140908T000000,581000,3,2.5,2600,4438,2600,0
1786640070,20140806T000000,361000,3,2,1950,8698,1950,0
259600260,20150122T000000,345000,3,1,1250,7210,1250,0
7234600903,20141016T000000,419000,2,2.25,1180,1253,840,340
4307350200,20150512T000000,347000,3,2.5,1680,4308,1680,0
3276930400,20141022T000000,625000,4,2.25,2220,36085,2220,0
4045100075,20150325T000000,2.40E+06,4,4.25,4890,15188,3090,1800
1421069208,20141223T000000,379000,3,3.25,2660,17852,2660,0
4057300200,20141222T000000,310000,3,1.5,1150,3323,1150,0
1922059135,20150513T000000,250000,2,2,1130,5500,1130,0
5014600240,20140814T000000,682000,5,2.75,2760,5000,2760,0
1565900070,20140721T000000,246500,3,2,1430,8919,1430,0
3121059033,20141029T000000,325000,3,1,1490,57381,1490,0
6799300270,20140806T000000,310950,4,2.5,2030,4997,2030,0
2021200370,20140901T000000,1.10E+06,3,2,3010,5000,1890,1120
726049190,20141002T000000,287500,3,1,1810,7200,1130,680
726049190,20150218T000000,431000,3,1,1810,7200,1130,680
4006000251,20140822T000000,226000,3,1,970,5000,970,0
3362400640,20150512T000000,825000,3,1.75,2010,3090,1510,500
1610000016,20140911T000000,175000,4,1,1300,6030,1300,0
7376300060,20140515T000000,465750,3,1.5,1260,10350,1260,0
7300200550,20150319T000000,659000,4,2.25,2610,24931,2610,0
2061100570,20150210T000000,595000,3,1.75,1910,5753,1110,800
8856890200,20140626T000000,350000,3,2.25,1780,16290,1780,0
8731951670,20140606T000000,270000,4,2.25,1900,8600,1900,0
4037200075,20140911T000000,662500,6,2.25,2450,25600,1340,1110
5066400483,20141120T000000,249900,3,1.75,1380,14000,1380,0
4167300310,20150317T000000,324500,3,1.75,1920,11340,1230,690
8682262400,20140718T000000,430000,2,1.75,1350,4003,1350,0
8682262400,20150513T000000,419950,2,1.75,1350,4003,1350,0
6777800160,20140728T000000,285000,4,1.75,2510,7440,1290,1220
1402950550,20150107T000000,332000,4,2.5,2470,7780,2470,0
2843200070,20141215T000000,282000,4,1.75,1660,10725,960,700
6450303785,20141118T000000,320000,3,1,1340,5175,940,400
9429500045,20140509T000000,428750,3,1,1620,30736,1620,0
1443300140,20150114T000000,330000,3,2.25,2300,35287,2300,0
108000127,20141209T000000,456500,4,3.5,2000,2309,2000,0
1081300200,20140509T000000,352000,3,2.25,1640,11050,1640,0
8818900060,20141125T000000,664000,4,2,1530,4080,1530,0
3395050060,20140722T000000,628000,3,1.75,4000,11894,2190,1810
7197350070,20150304T000000,512000,3,1.75,1610,12555,1080,530
9510900270,20141211T000000,254000,3,2,2070,9000,1450,620
3905081070,20140521T000000,535800,4,2.5,1900,5790,1900,0
2322069114,20141010T000000,287653,3,1,1050,16050,1050,0
5637500070,20140731T000000,438000,3,2.5,1520,1304,1180,340
4164100160,20140716T000000,450000,4,1.75,2390,23899,1750,640
4136890260,20140627T000000,327000,5,2.75,2400,8050,2400,0
3056800160,20140812T000000,370500,4,2.5,1790,6120,1790,0
3654800200,20141022T000000,265000,3,2.5,1720,6271,1720,0
2296500036,20150310T000000,450000,4,2.75,2980,13260,1800,1180
623069068,20140627T000000,425000,3,1,1520,213444,1520,0
1865820370,20141113T000000,166600,3,1.75,1150,8690,1150,0
1723049033,20140620T000000,245000,1,0.75,380,15000,380,0
2359300030,20150508T000000,565000,3,1,910,5212,910,0
6403310060,20140811T000000,539900,3,1.75,1650,10150,1230,420
1937300270,20150303T000000,910000,3,3.5,2480,3200,2480,0
4137050060,20141104T000000,280000,4,2.5,2050,7416,2050,0
2310000240,20150313T000000,275000,3,2.25,1420,8549,1420,0
3955900830,20150427T000000,467000,3,2.5,3460,6590,3460,0
8665050060,20140731T000000,457500,3,2.5,1500,4445,1500,0
3330500875,20141226T000000,381156,2,1,1320,3090,1320,0
3327020400,20150423T000000,289999,5,2.5,2180,8240,1220,960
1250700060,20150422T000000,642450,3,1.75,1830,4160,1230,600
4039300400,20140919T000000,469950,3,2.25,1620,8701,1220,400
6665800060,20150305T000000,795000,3,2,2920,13650,1460,1460
7504110030,20150211T000000,785000,4,2.5,3300,10514,3300,0
7805450810,20140530T000000,860000,3,2.25,3060,12095,3060,0
6306400140,20140612T000000,1.10E+06,0,0,3064,4764,3064,0
8802400416,20150213T000000,147500,3,1,1530,8498,1530,0
6204400270,20141125T000000,390000,3,2,1910,11576,1410,500
9536602080,20141219T000000,229000,3,1,1020,8100,1020,0
3826000070,20140515T000000,185000,3,1,1150,8100,1150,0
5101405335,20140826T000000,414900,3,1.5,1260,9570,870,390
2349300060,20150212T000000,200000,4,2,1920,4822,920,1000
7749500370,20141021T000000,225000,4,2.25,1800,9350,1800,0
2436701200,20140912T000000,720000,3,1.75,2040,4000,1360,680
7871500070,20140603T000000,930000,4,2.5,2200,4000,1430,770
3323500030,20140604T000000,1.27E+06,5,2.5,3200,17204,2160,1040
2110200036,20141111T000000,700000,5,3.25,2400,3118,1780,620
510002519,20140715T000000,466000,2,1.5,1140,1058,1140,0
1387300070,20140825T000000,374000,3,1.5,1330,10640,1330,0
9465910070,20140716T000000,480000,3,2.5,1940,10035,1940,0
2324800070,20140610T000000,740000,3,2.5,3000,25341,3000,0
1962200435,20141110T000000,1.01E+06,4,1,1820,5400,1820,0
8562890700,20140530T000000,395000,4,2.5,2910,5000,2910,0
3298700946,20140725T000000,340000,2,1,1090,6771,1090,0
880000189,20140811T000000,209000,3,2,1230,1340,1020,210
643500030,20141114T000000,431650,5,2.5,1710,7700,1710,0
8566100200,20140508T000000,980000,5,2.5,3160,11470,1780,1380
4298100240,20140805T000000,660000,3,2.5,2680,28243,2680,0
3275780030,20150311T000000,730000,4,2.25,2190,9009,1840,350
8648220270,20150414T000000,291500,3,1.75,1260,9600,1260,0
1923000160,20140620T000000,905000,4,3.5,2970,14486,2340,630
7574910860,20140811T000000,800000,4,2.5,2570,50308,2570,0
2296500136,20140509T000000,839900,4,3.5,3810,13592,2560,1250
3278600710,20140714T000000,200000,1,1.5,1010,1157,950,60
2460700260,20150218T000000,300000,3,2,1480,6698,1080,400
3188100400,20140603T000000,530000,3,1.75,1250,6041,1250,0
9406520830,20150326T000000,314950,3,2.25,1654,8479,1654,0
3387900390,20141007T000000,255000,3,1.75,1410,9315,1410,0
1596600024,20141016T000000,550000,5,2.75,2160,5720,1500,660
7625701891,20140806T000000,435000,3,1,1400,4800,700,700
3224800075,20141124T000000,234000,3,1.75,1420,8738,1420,0
7526800200,20141010T000000,615000,4,2.25,2500,10062,1600,900
3329530200,20140910T000000,205000,3,2,1410,8384,1410,0
2115200125,20140919T000000,384000,4,1.75,2100,7135,1050,1050
6623400135,20140522T000000,324000,3,2.5,1750,7208,1750,0
103000116,20140722T000000,645000,3,1.75,2070,5500,1130,940
2768301525,20141023T000000,570000,3,3.25,1570,1777,1260,310
739980260,20141210T000000,324000,3,2.5,1920,5322,1920,0
4302200695,20140828T000000,270000,2,1,1000,10320,1000,0
1431700370,20140519T000000,290000,5,1.5,2120,7700,2120,0
7524000030,20140630T000000,250000,3,2,1440,9220,1440,0
4046500320,20150120T000000,342000,3,1.75,1660,16275,1660,0
4325000125,20150318T000000,255000,3,1.5,1340,8450,1340,0
3456000160,20140623T000000,800000,3,2.25,2380,11824,1450,930
9297301580,20140516T000000,451000,3,1.75,1560,4049,1000,560
2465400036,20141203T000000,990000,4,2.5,2780,10480,1390,1390
5412200270,20140520T000000,288400,4,2.5,1860,6687,1220,640
1109000390,20150310T000000,420000,3,1.5,2390,4600,1750,640
8730000270,20150514T000000,359000,2,2.75,1370,1140,1080,290
7937600830,20140808T000000,390000,4,3,2570,262018,1420,1150
3395070640,20140902T000000,300000,3,2.5,1320,2614,1320,0
8663280160,20150305T000000,545000,5,2.5,2520,7863,1500,1020
6151800624,20150408T000000,288349,3,1,1250,18616,1250,0
8594400370,20150205T000000,299900,3,2.25,1560,35026,1290,270
2301400640,20140717T000000,891000,4,2,2330,5000,1720,610
4441300240,20150331T000000,1.20E+06,3,2,3660,22410,1830,1830
7714000070,20150205T000000,378000,4,2.5,2790,4650,2790,0
3432500486,20140623T000000,299995,2,1,1060,7200,1060,0
5466420030,20141007T000000,253000,3,2.5,2020,6564,1310,710
1324079046,20150120T000000,350000,3,2.25,1580,47916,1580,0
2768301715,20150311T000000,565000,4,3,2020,4300,2020,0
3332000135,20140612T000000,315000,2,1,970,5665,970,0
65000400,20141022T000000,570000,4,3,1490,6766,1490,0
8820901670,20140811T000000,971000,5,3.5,4390,10140,3350,1040
8712100575,20140828T000000,915000,5,2.5,2750,5589,1840,910
6116500341,20150112T000000,419000,4,1.5,2150,23568,2150,0
4167300030,20150209T000000,260000,4,1.75,1810,7480,1230,580
2925059135,20150408T000000,1.32E+06,3,3,2230,12968,2230,0
7708300140,20150306T000000,369950,3,1,2430,10720,2430,0
4139430340,20141015T000000,1.03E+06,3,2.5,3680,13384,3680,0
3812400070,20150506T000000,435000,5,1,1410,6750,1410,0
9455200445,20150325T000000,601000,3,1.75,1330,6743,1330,0
6203000160,20140716T000000,460500,3,1,1490,10650,1150,340
7517500611,20140521T000000,720000,3,2.5,2020,1159,2020,0
8691300860,20150421T000000,851000,4,2.5,3130,13202,3130,0
5489200435,20140904T000000,550000,4,3,2670,5000,2670,0
510002065,20150323T000000,700000,4,1,1980,4560,1980,0
252000400,20140908T000000,323000,3,1.75,2100,14850,2100,0
7279300070,20140922T000000,345500,3,1,1350,8581,1350,0
8113101670,20141203T000000,378000,4,1.5,2140,7920,1190,950
7578200310,20141112T000000,650000,4,2,2208,5000,2208,0
7715800570,20150413T000000,385000,3,2,1010,7380,1010,0
6852700478,20140916T000000,425000,2,1,970,2970,970,0
1917300260,20141202T000000,210000,4,2,1520,6174,1520,0
4298100070,20140528T000000,630000,4,2.5,2740,43101,2740,0
1842000140,20140730T000000,335000,3,1.75,1570,7500,1300,270
5462100240,20140625T000000,196500,3,1,1320,9000,1320,0
8651520510,20140515T000000,582800,4,2.75,2550,7636,1440,1110
3578110200,20140623T000000,440000,3,1.75,1560,7207,1250,310
7555210340,20140825T000000,752500,4,2.25,2360,8616,2360,0
2313900510,20141028T000000,532500,3,1.75,1330,5000,1210,120
2009001600,20150506T000000,265000,3,1,1070,9000,1070,0
1455100116,20150202T000000,397500,3,1.25,1510,13737,810,700
3629790160,20140724T000000,524250,3,2.5,1710,3469,1710,0
1778350070,20140509T000000,765000,4,2.75,2790,10819,2790,0
1703050200,20140806T000000,648000,4,2.5,2620,5450,2620,0
5469700570,20140812T000000,469500,5,2.5,2970,24759,1670,1300
100600860,20150324T000000,237500,3,1.75,1050,7854,1050,0
421049116,20150121T000000,216000,3,1,1280,8712,1280,0
3205200640,20150330T000000,427200,3,1,1030,8400,1030,0
8899200570,20150311T000000,280000,3,2.25,1900,7800,1390,510
1777500160,20150425T000000,718000,5,3,3070,9804,1740,1330
7853340860,20150310T000000,420000,2,2.75,1760,4139,1760,0
1862400132,20140916T000000,379000,2,1,930,5400,930,0
6380500135,20140527T000000,326100,2,1,880,7683,880,0
9528104108,20140529T000000,535000,3,2.5,1360,1016,1310,50
2571910160,20141001T000000,283000,4,2.75,2130,8560,1560,570
316000160,20140821T000000,260000,3,1,1480,7469,1120,360
2695600505,20150413T000000,399000,4,1,1500,6388,1500,0
3904910320,20150225T000000,484950,3,2.25,1670,5004,1670,0
4100000140,20141013T000000,640000,4,1.75,2060,9828,2060,0
3226049270,20150304T000000,585000,4,2.5,2160,8158,1660,500
1455600030,20150108T000000,645000,4,2,2780,11583,1190,1590
5559600140,20150505T000000,253000,3,2,1490,7651,1490,0
5147600105,20140721T000000,178500,2,1,740,6460,740,0
7437100570,20140821T000000,291000,4,2.5,1860,6325,1860,0
8856004730,20140917T000000,199950,2,2.75,1590,20917,1590,0
3856902996,20140804T000000,553500,2,1,850,2340,850,0
1442800370,20150415T000000,189950,2,1,1030,4188,1030,0
8001400340,20140924T000000,289000,3,2,1850,9550,1850,0
3131200640,20150427T000000,700000,4,2,1830,4590,1830,0
984000710,20141022T000000,270000,3,2,1560,8853,1560,0
4167300350,20140508T000000,258000,4,1.75,1730,8320,1230,500
2826049282,20140614T000000,530000,3,2.5,1930,7214,1930,0
8946750030,20141218T000000,245000,3,2.25,1422,3677,1422,0
461004720,20150422T000000,563000,3,2,1380,5000,1380,0
7852090810,20141119T000000,515000,3,2.5,2430,4203,2430,0
9264960340,20140617T000000,325000,4,2.5,2610,7091,2610,0
1624079104,20150402T000000,540000,3,2.25,2000,217800,2000,0
4310700570,20141210T000000,280300,2,1,920,5000,490,430
1254200075,20140509T000000,460000,4,1.75,1750,5500,1050,700
7214820030,20141212T000000,475000,3,1.75,2020,8970,1180,840
865100055,20140612T000000,900000,4,2.25,2460,44431,2460,0
686201000,20141230T000000,538200,4,3,1780,7260,1780,0
342000570,20140909T000000,429000,2,1,1080,3600,1080,0
5476200160,20140725T000000,164808,3,1,1250,5411,1250,0
7199320570,20150126T000000,520000,4,2.25,1870,7700,1870,0
6414100560,20140618T000000,475000,3,1.75,1700,8432,1230,470
1623049214,20140926T000000,283000,4,1.5,1480,47045,1480,0
2379300340,20150331T000000,321500,4,2.5,1930,6228,1930,0
7701990560,20140729T000000,840000,4,2.75,3130,21810,3130,0
2025700860,20150414T000000,287000,3,2.25,1370,6000,1370,0
8562500200,20140605T000000,375000,3,1.75,960,8106,960,0
8143100350,20140825T000000,349500,3,1.75,1260,7128,1260,0
37000335,20140814T000000,446450,3,1.5,1480,7749,1480,0
1862900350,20140610T000000,315000,4,2.5,1930,9643,1930,0
1498302774,20140520T000000,271310,2,1,870,5340,870,0
2224700136,20150122T000000,315000,4,1,1300,8400,1300,0
7697920160,20140515T000000,245000,3,1.75,1490,6930,1490,0
1370804430,20150305T000000,543115,2,1,1380,5484,1030,350
2267000160,20141020T000000,900000,4,2,1190,8190,1190,0
5700004028,20150417T000000,2.45E+06,4,4.25,4250,6552,2870,1380
8682231170,20150429T000000,554000,2,2,1920,6045,1920,0
3353400860,20140717T000000,249900,3,1.75,2080,12522,2080,0
2424059035,20140820T000000,768000,3,2.5,3220,54160,2690,530
2021201000,20140523T000000,980000,4,3,3680,5854,2060,1620
3919000030,20150420T000000,395000,5,2.5,2070,9600,1270,800
789000550,20150413T000000,415000,3,1.75,1480,2200,1480,0
5104511040,20150220T000000,380000,4,2.5,2000,6921,2000,0
7215722010,20150226T000000,566000,3,2.5,1560,5259,1560,0
16000435,20150316T000000,218500,2,1,1600,8961,1390,210
7197300105,20140502T000000,550000,4,2.5,1940,10500,1140,800
2877101031,20140702T000000,512031,3,1.75,1540,3000,770,770
2892600016,20150317T000000,197500,2,1,820,8860,820,0
2423020270,20140715T000000,470000,3,2.25,1780,8784,1230,550
1825079070,20150313T000000,590000,3,1.75,1560,242629,1560,0
5255710160,20150318T000000,465000,4,2.25,2210,8862,1270,940
723069135,20140915T000000,499000,2,1.75,2040,114562,2040,0
2024059094,20140825T000000,515000,3,2.25,1920,11500,1920,0
7613700860,20141106T000000,716500,3,1.75,1930,5000,1230,700
2771101200,20140517T000000,410000,3,2,1700,4250,890,810
7625704510,20141022T000000,850000,4,3.25,3450,6500,2450,1000
1762600260,20140522T000000,1.05E+06,4,3.25,3440,35021,3440,0
2553300030,20140609T000000,648000,4,2.5,2380,13435,2380,0
5309101200,20140605T000000,620000,4,2.25,2400,5350,1460,940
5416300240,20150202T000000,935000,4,4.5,5670,84267,5670,0
3756600240,20150319T000000,379000,3,1,1140,10320,1140,0
8127700445,20140716T000000,699000,3,1.75,1670,5375,1270,400
9421500070,20141230T000000,528000,4,2.25,1910,8005,1280,630
9477710160,20150426T000000,425000,3,1.75,1560,9452,1560,0
1795500240,20140623T000000,249500,2,1.75,1500,8645,1500,0
7203220260,20140716T000000,1.04E+06,5,3.25,4475,6642,4475,0
3524039204,20140813T000000,790000,4,2.75,2840,11900,1640,1200
5706200060,20140818T000000,399950,3,1,1020,18050,1020,0
7283900012,20141021T000000,275000,3,1.5,1410,9000,1410,0
809001070,20150123T000000,550000,3,1,1520,2500,1520,0
3340401535,20141105T000000,140000,1,1,730,6890,730,0
1607100139,20140725T000000,250000,3,1,1190,6250,990,200
8699800060,20140903T000000,318000,3,2.25,1410,8909,1410,0
524069037,20140710T000000,505000,2,1,1240,57000,1240,0
6072600200,20150417T000000,470500,5,2.5,2500,9248,1300,1200
5144000036,20140527T000000,360000,3,1,1050,9206,1050,0
7855300200,20150319T000000,1.24E+06,4,2.75,2680,8500,1480,1200
2485000202,20150410T000000,986000,3,2.5,2380,16080,1340,1040
9209900270,20150205T000000,515000,2,1,1060,4228,860,200
6099400030,20150114T000000,320000,3,1.75,2300,41900,1310,990
9368700223,20150202T000000,310000,4,3,2010,7426,1090,920
1782000160,20140530T000000,356700,2,1,1090,5000,730,360
269001360,20150422T000000,775000,4,1.75,2320,5595,1510,810
390100060,20150421T000000,325000,3,1,1040,7541,1040,0
7888400560,20141002T000000,208000,4,2.75,1810,8677,1810,0
7567600045,20140827T000000,825000,2,1,1150,12775,1150,0
7764200030,20140716T000000,515000,3,2.5,2360,11254,2360,0
9828202545,20150127T000000,490000,3,1.5,1970,3400,1420,550
6114600030,20140520T000000,675000,4,3,2690,28300,2690,0
9834200885,20140717T000000,360000,4,2.5,2080,4080,1040,1040
9834200885,20150420T000000,550000,4,2.5,2080,4080,1040,1040
3509600070,20140725T000000,225000,3,1.5,1370,9000,1370,0
2473002080,20150317T000000,500000,3,2.75,3410,9360,3410,0
1081300370,20150427T000000,385000,4,2,1850,11700,1850,0
11501160,20140617T000000,837700,5,2.75,3010,12611,3010,0
7202330370,20150210T000000,448000,3,2.25,1530,3056,1530,0
7000100631,20150507T000000,730000,5,1.75,2690,21357,1420,1270
2484200171,20140714T000000,575000,4,1.5,2810,7140,1490,1320
9477201040,20141118T000000,430000,3,1.75,1810,7300,1240,570
7202290160,20150114T000000,435000,3,2.5,1560,3987,1560,0
4366700140,20141219T000000,241000,3,1,1010,9611,1010,0
5457300478,20150513T000000,453500,2,1.75,1000,1760,600,400
9158100116,20150406T000000,285000,2,1.5,990,1380,990,0
7227500830,20140528T000000,151000,2,1,720,4222,720,0
7237500390,20141110T000000,1.57E+06,5,4.5,6070,14731,6070,0
2197600451,20141105T000000,631000,5,2,2270,2400,2270,0
3278604400,20140602T000000,285000,2,2.5,1380,1073,1140,240
1788700160,20150220T000000,195000,3,1,1260,8378,840,420
3276930270,20150425T000000,817500,4,2.5,2910,35679,2910,0
7374600060,20150109T000000,550000,3,2,1810,12825,1810,0
2505500030,20140703T000000,1.13E+06,4,2.5,3160,8281,3160,0
2770604942,20141230T000000,609850,2,2.75,1910,1369,1910,0
7831800505,20150106T000000,200000,3,1,1230,4380,1230,0
5416510060,20150306T000000,367000,4,2.5,2960,6219,2960,0
4137010260,20140825T000000,285167,3,2.25,2200,8375,2200,0
7683800200,20150402T000000,275000,2,1.5,1270,32175,1270,0
1509500160,20150324T000000,350900,4,2.5,2540,12843,2540,0
3904940200,20140620T000000,660000,4,3.25,3030,9273,3030,0
4037200295,20140819T000000,525000,3,1.75,1520,8835,1520,0
7258200055,20150206T000000,262000,4,2.5,1560,7800,1560,0
9178600560,20140623T000000,690000,2,1,970,4560,970,0
255520260,20150324T000000,624000,5,3.75,3570,14648,3570,0
751000060,20140506T000000,353000,3,1,1350,7740,860,490
3343900326,20150311T000000,552500,4,3.5,3710,10400,2290,1420
7137900320,20140509T000000,224500,4,1,1430,8355,1430,0
2641800060,20150427T000000,239000,3,1,940,8571,940,0
293760310,20140711T000000,975000,5,4.5,4300,12250,4300,0
7237501180,20140625T000000,1.20E+06,4,1.75,3990,13470,3990,0
5332200550,20150325T000000,505000,3,1,1380,4000,1380,0
3450300240,20140515T000000,302000,4,1.75,2020,7865,1010,1010
9352900695,20140922T000000,170000,3,1,1480,5670,780,700
3324069070,20140707T000000,195000,2,1,1190,27007,1190,0
8062900070,20140909T000000,272000,5,1.5,2550,6300,1560,990
8062900070,20150213T000000,369000,5,1.5,2550,6300,1560,990
4427100030,20150114T000000,332500,3,1.5,1500,6332,1500,0
4039100400,20150506T000000,515000,3,2.5,3000,8250,1760,1240
2171400126,20140605T000000,269000,3,1,1690,4250,1020,670
7135520810,20140730T000000,1.28E+06,4,4,4390,17832,2430,1960
2475201180,20150206T000000,303000,3,2.5,1560,4100,1560,0
4024100951,20150105T000000,420000,7,3,2940,8624,1690,1250
6021502830,20141110T000000,400000,3,1,1130,4100,990,140
7710100083,20150204T000000,225000,3,1,1020,8437,1020,0
2781270550,20140916T000000,219000,2,2,1310,2550,1310,0
200510060,20141231T000000,605000,3,2.5,2570,9487,2570,0
9554200105,20141014T000000,625000,4,2,2020,6867,1010,1010
3320000810,20150224T000000,380000,5,2,1680,3240,840,840
643500060,20150424T000000,620000,4,2,1770,7700,1770,0
2537500140,20140627T000000,687500,4,2.75,3190,10970,3190,0
5112800421,20140723T000000,225500,4,2,1440,7950,1440,0
3352402236,20141215T000000,252500,3,2,1150,6000,1150,0
3905100520,20141029T000000,510000,3,2.5,1860,3658,1860,0
6332940070,20140507T000000,510000,4,2.5,2430,5203,2430,0
809002435,20140808T000000,725000,3,2.5,1940,4000,1940,0
3421079032,20150217T000000,75000,1,0,670,43377,670,0
3797000295,20150312T000000,492000,2,1,880,2970,880,0
1775801260,20150311T000000,425000,4,2.5,1930,14196,1330,600
4055701200,20150421T000000,1.96E+06,4,2.75,3120,7898,1560,1560
7137960030,20150309T000000,298900,3,2.5,1830,6162,1830,0
7880010060,20150406T000000,699000,4,2.5,3230,40319,3230,0
3797001920,20140702T000000,310000,2,1,700,3000,700,0
3901100055,20141222T000000,350000,3,1.75,1010,8580,1010,0
8069000075,20141229T000000,790000,4,1.75,2460,10061,1410,1050
1541700240,20140729T000000,305000,4,2.5,2230,5000,2230,0
6064800710,20141002T000000,315000,3,2.5,1570,2865,1570,0
1865810060,20140812T000000,267500,5,3.5,2390,6600,2390,0
7533800295,20140819T000000,1.75E+06,4,3.25,3460,7749,3020,440
5415300060,20140813T000000,435000,6,3.5,2400,8620,1640,760
3876100320,20140905T000000,482500,6,4.5,2940,7500,2940,0
1247600105,20141020T000000,5.11E+06,5,5.25,8010,45517,5990,2020
3705900238,20140828T000000,439995,3,1.75,1570,8400,1570,0
3876200070,20150508T000000,460000,3,3,1520,7500,1180,340
4388000140,20140729T000000,194000,3,1,1070,6440,1070,0
3523029041,20141009T000000,290000,2,0.75,440,8313,440,0
3110800260,20140715T000000,274700,4,2,2440,9600,1220,1220
3131201290,20150317T000000,900000,4,2.5,2660,3672,1800,860
1117200390,20140507T000000,1.15E+06,4,4,4460,103382,4460,0
8956000350,20140903T000000,605000,3,2.5,2010,3667,2010,0
7853210140,20150309T000000,359000,3,2.5,1450,3850,1450,0
3250500140,20141008T000000,850000,3,1.75,1400,9900,1400,0
2767601375,20140821T000000,505000,3,2,1500,2500,1500,0
9465910320,20140709T000000,565000,3,2.5,2500,7394,2500,0
3334000055,20150429T000000,585000,2,1.75,1280,7110,1000,280
7893800335,20150430T000000,328000,4,3.25,3380,7500,2420,960
3586500700,20140709T000000,749950,4,2.75,2910,18700,2210,700
3630180400,20140626T000000,826000,4,2.5,3060,7140,3060,0
3210950510,20140904T000000,535000,3,1,1330,40259,1330,0
1224069074,20140806T000000,925000,4,2.5,3300,101930,3300,0
7625700935,20140605T000000,875000,3,3.5,3250,6000,2500,750
7856610200,20140523T000000,902000,4,2.25,2530,9200,1570,960
7287100135,20141001T000000,423000,3,1,1830,13900,1830,0
1023059324,20140623T000000,235000,3,1,1170,11100,1170,0
6398000171,20140710T000000,545000,2,2,2930,14057,1680,1250
6149700350,20141016T000000,343000,2,1,1230,7560,1230,0
9558020890,20150324T000000,334950,3,2.5,1620,2930,1620,0
2624049185,20140909T000000,405000,3,1.75,1760,5355,1160,600
236400260,20141215T000000,220000,4,1,1440,8250,1440,0
3826000560,20141002T000000,173000,2,1,1740,8100,1050,690
7011201245,20141107T000000,655000,3,1,1270,3600,1270,0
9222400510,20150107T000000,406000,2,1,880,3000,880,0
9455200570,20141217T000000,632000,6,2.5,2560,8320,1370,1190
2112700030,20141126T000000,357000,5,2.75,1540,4000,1140,400
8658300260,20141209T000000,361000,3,1.75,1150,17585,1150,0
3996900160,20140708T000000,277000,2,1,770,8149,770,0
5561400340,20140605T000000,630000,4,3.75,4610,40202,2500,2110
11900140,20140509T000000,254000,3,2.5,1850,4597,1850,0
6071600340,20141113T000000,472800,3,2.25,1840,8400,1290,550
1231000510,20140922T000000,263000,3,1.75,1490,3800,700,790
1231000510,20150504T000000,510000,3,1.75,1490,3800,700,790
7683800192,20141107T000000,179950,3,1,960,10125,960,0
4123400340,20141203T000000,525000,4,2.25,1580,7307,1160,420
5458300685,20140520T000000,479000,3,2.5,1260,889,1260,0
194000505,20140904T000000,651000,3,2,1940,6440,970,970
3885804305,20140911T000000,949000,4,1.75,2490,7834,1240,1250
3971700560,20150421T000000,392400,5,2.5,2520,27951,1890,630
8585400135,20141105T000000,585000,4,1.75,1760,5356,920,840
8691500990,20141212T000000,460000,4,2.5,4190,7504,4190,0
2770606685,20140813T000000,470000,3,1,1170,4400,870,300
8856971000,20150406T000000,245000,3,2.5,1600,4271,1600,0
1026049082,20141125T000000,500000,4,2,2760,27631,1800,960
2095800400,20141113T000000,455000,3,2.5,2090,8653,2090,0
7852030240,20150408T000000,485500,4,2.5,2320,3974,2320,0
6321000045,20141222T000000,1.88E+06,5,3.25,4110,7920,3150,960
3751600030,20140717T000000,100000,2,1,770,17334,770,0
4046500510,20140905T000000,307000,3,1.75,1410,16105,1410,0
8029520240,20141010T000000,475000,4,3.5,3660,14401,2660,1000
7016310030,20150219T000000,330000,4,2.5,2180,7210,1190,990
1238500451,20150209T000000,130000,3,1,1110,7520,1110,0
4401150070,20140623T000000,320000,3,2.5,2280,7417,2280,0
3331000070,20140606T000000,735000,4,2.5,2820,6180,2050,770
2636900126,20150312T000000,365000,4,2.5,1570,9600,800,770
1842900030,20150416T000000,234000,3,1.5,1200,11935,1200,0
1761300310,20140827T000000,211000,4,2,1710,8288,1710,0
5249800729,20150330T000000,680000,6,3.5,3000,6320,2400,600
5104511600,20141112T000000,457000,4,3,2800,7845,2800,0
8663370060,20141009T000000,349000,3,2.25,1640,7261,1640,0
613400030,20141024T000000,360000,3,2.75,2030,6840,1210,820
6004510240,20150414T000000,350000,4,2.5,2530,10155,2530,0
1450100070,20150430T000000,208000,3,1,990,7420,990,0
6117501820,20140618T000000,250275,2,1,790,11234,790,0
6117501820,20150428T000000,435000,2,1,790,11234,790,0
5420300240,20141205T000000,270000,3,1.75,1800,7763,1470,330
4140900140,20140527T000000,438000,3,1.75,1650,12940,1650,0
1630700135,20141119T000000,659000,4,2,1980,23625,1980,0
5166700055,20150504T000000,645000,4,2.75,2340,6350,1310,1030
3224600310,20141030T000000,685100,4,2.5,2790,5423,2790,0
7227802030,20140623T000000,350000,7,3,2800,9569,1400,1400
226059078,20150227T000000,375000,2,1,1840,81892,1840,0
1796100140,20140715T000000,170000,3,1.5,1350,81549,1350,0
5309100140,20140624T000000,880000,4,2.5,3030,3841,3030,0
8658300510,20150419T000000,410500,4,2.5,1980,5000,1980,0
8691300060,20141023T000000,780000,4,2.5,3690,13609,3690,0
9103000393,20140910T000000,1.23E+06,5,4.5,3732,4426,2932,800
8682281170,20141113T000000,449000,2,1.75,1510,6852,1510,0
472000055,20140514T000000,546000,3,1.75,2000,5000,1110,890
2473400570,20140516T000000,317000,3,2,1760,11410,1060,700
3449500135,20140625T000000,276900,3,1,1270,7566,1270,0
1926049355,20141028T000000,399000,5,2,2620,7030,1420,1200
8650000070,20140808T000000,495000,5,2.75,2630,10165,1690,940
8732131200,20140808T000000,258000,3,1.75,2270,9000,1330,940
1624079051,20140710T000000,600000,2,2.5,2410,102366,1940,470
993001629,20141117T000000,265000,3,2.75,1120,881,1120,0
3832711040,20150424T000000,321000,5,2.75,3030,7000,1540,1490
5244801230,20140829T000000,682000,5,2.25,2120,4000,1720,400
2798600240,20141114T000000,295700,4,2.5,1720,5805,1720,0
5701800030,20140506T000000,609000,4,2.5,2150,37981,2150,0
7636800041,20140625T000000,995000,3,4.5,4380,47044,3720,660
3904901200,20140818T000000,530000,3,2.25,2010,11817,2010,0
4109600055,20141229T000000,614000,5,2.5,3150,5150,1870,1280
3339400349,20141124T000000,390000,3,2.5,2500,21780,1770,730
7202340370,20141110T000000,467000,3,2.5,1690,6642,1690,0
9477500060,20140813T000000,484000,6,2.5,3300,13501,2060,1240
4310701600,20141113T000000,340000,3,2.5,1240,1115,1240,0
2215450060,20141223T000000,302495,3,2.5,2200,7201,2200,0
2919702075,20140925T000000,532500,3,1.75,1620,3360,980,640
8079030350,20140910T000000,441500,3,2.5,2420,9592,1780,640
7893804340,20140724T000000,470000,4,2.5,2680,8062,1530,1150
4389200765,20140625T000000,2.30E+06,4,3.25,4250,8570,4250,0
1822069116,20141217T000000,590000,3,2.5,2400,99752,2400,0
7276100282,20140729T000000,320000,3,1.75,2300,12000,1770,530
567000392,20141103T000000,363000,2,2,920,1201,800,120
5729200030,20140707T000000,747500,4,2.25,2350,18600,2350,0
8682220390,20140723T000000,750000,2,2.5,2630,7957,2630,0
9828700200,20140505T000000,831000,4,3,2170,4000,1610,560
7852180560,20150424T000000,403000,3,2.5,1700,4125,1700,0
3655400060,20140808T000000,445000,3,2.5,2470,4565,2470,0
7955030060,20150326T000000,345000,3,1,1250,17380,1250,0
8964800445,20150209T000000,2.26E+06,3,3.5,3110,14872,3110,0
6204410200,20140616T000000,371025,3,2,1530,8925,1530,0
7625702400,20140730T000000,355000,2,1,960,6250,960,0
5113200310,20140909T000000,270000,3,1,1240,14110,1240,0
7893802800,20140605T000000,425000,4,2.75,2440,15349,2440,0
2473003210,20150313T000000,364808,3,1.75,2320,7875,1620,700
1402600570,20150113T000000,320000,3,2.25,1580,6561,1200,380
8944460030,20141014T000000,325000,4,2.5,2963,5797,2963,0
2473480560,20140904T000000,350000,3,2.25,2470,10290,2230,240
3365900465,20150219T000000,170000,3,1.5,1370,10176,1370,0
5341600030,20140509T000000,255000,2,1,960,28717,960,0
6073500160,20141210T000000,550000,3,1,1130,7500,880,250
2025760160,20140703T000000,835000,4,4.25,4930,25714,4930,0
9393700140,20150310T000000,420000,3,1,1150,5120,800,350
5458800125,20140514T000000,925000,4,2.5,2190,7350,2190,0
2492200435,20140606T000000,389250,2,1.5,1490,4080,930,560
3759500046,20150501T000000,748000,3,2.5,2600,10183,1300,1300
8648220260,20150324T000000,284000,3,1.75,1530,9600,1200,330
6392001670,20140611T000000,588000,4,2,1680,5000,980,700
2026049155,20150320T000000,372500,3,1.75,1680,8648,1680,0
2329800240,20150218T000000,285000,4,3,1900,7194,1900,0
3380900125,20140527T000000,360000,3,1,1570,9467,1570,0
1324079041,20141118T000000,275000,3,1,1370,17859,1150,220
8682230550,20140916T000000,428000,2,2,1350,4225,1350,0
853400240,20150325T000000,847000,6,2.5,3010,17864,3010,0
2130702075,20140926T000000,316000,3,1,1010,7838,1010,0
3260810260,20150505T000000,375000,3,2.5,2050,7205,2050,0
2878600200,20140508T000000,533000,3,1,1670,4080,1170,500
7298040310,20140523T000000,556000,5,2.5,3840,16905,3840,0
766000240,20140915T000000,225000,4,2,2220,14120,1200,1020
3459700340,20141030T000000,537250,4,2.5,2590,9530,1640,950
2473251180,20141217T000000,255000,3,1,1180,13650,1180,0
2407900200,20150409T000000,530000,4,2.5,2950,4836,2950,0
7558700030,20150413T000000,5.30E+06,6,6,7390,24829,5000,2390
203600140,20150324T000000,595000,3,2.75,2150,31238,2150,0
4037800140,20140814T000000,548000,4,2,2100,8880,2100,0
1683600240,20150320T000000,234975,3,1.75,1650,8073,1100,550
1962200036,20140819T000000,600000,3,1.75,1620,1325,1430,190
1775800510,20150324T000000,432000,4,1,1750,12528,1750,0
1822350070,20150202T000000,455000,3,1.5,1380,6657,1380,0
7772400160,20141024T000000,279950,3,1.75,1510,11234,1210,300
273900030,20141020T000000,267500,3,1.5,1600,9072,1600,0
3323069084,20140909T000000,620000,4,2.5,1840,220308,1840,0
4337000160,20150127T000000,110000,2,1,830,7590,830,0
9126100550,20140513T000000,625000,3,3.5,1810,1846,1440,370
5101405274,20140529T000000,389000,2,1,910,7000,910,0
4232400860,20140630T000000,1.20E+06,4,2,2120,3360,2120,0
2723069082,20150424T000000,788500,4,2.25,2510,133729,2510,0
7436500270,20140725T000000,567000,5,2.25,2100,6936,1600,500
5153200030,20150113T000000,515000,2,2.25,2690,15000,1870,820
4022900125,20140902T000000,605000,4,2.5,2430,11870,1590,840
7841300505,20141027T000000,430000,4,3.75,2452,4800,2452,0
573000685,20140717T000000,805000,2,1.75,1550,6000,1550,0
8961990160,20150413T000000,567500,3,2.5,2080,4556,2080,0
1250202255,20140605T000000,647500,3,1.75,1290,3870,1290,0
7234600796,20141126T000000,495000,2,1.75,1850,2530,1850,0
3630180340,20141104T000000,825000,4,2.5,3370,5000,3370,0
5104450070,20150309T000000,435000,4,2.25,2730,7506,2730,0
9477100060,20140909T000000,445950,3,1.75,1300,7800,1300,0
4139440830,20140603T000000,960000,5,2.75,3040,10257,3040,0
6772200055,20140917T000000,780000,4,3,2440,3600,1480,960
8731982190,20140618T000000,274500,3,2.25,1720,9000,1320,400
6300000335,20150429T000000,729953,5,3,3230,5167,2000,1230
9301300751,20140728T000000,464950,3,1.5,1200,890,1030,170
9542100135,20141112T000000,620000,4,1.75,2350,18800,2350,0
8691410700,20150116T000000,735000,4,3.5,3100,5600,3100,0
217500135,20150421T000000,450000,4,2.25,2040,9565,1400,640
3731800055,20140605T000000,450000,4,1,2000,4676,1250,750
7234600786,20140511T000000,842500,4,2.5,2160,5298,2160,0
2423059104,20141008T000000,360000,3,2,1970,79714,1070,900
1823039205,20140624T000000,585000,3,2.5,2270,100545,2270,0
2423020260,20140814T000000,461000,3,2.25,1850,7923,1150,700
2695600070,20140818T000000,345000,2,1,1350,4494,920,430
6844703240,20140702T000000,1.08E+06,3,2.5,3280,10302,1680,1600
3904940070,20150227T000000,643000,4,2.5,2270,8391,2270,0
1939130070,20140929T000000,690000,4,2.5,2820,8307,2820,0
5589300370,20150401T000000,282000,4,1,1200,11111,1200,0
3526039116,20141118T000000,549000,3,1.75,2000,6130,1120,880
6821600390,20150108T000000,815000,3,2,2310,6000,1560,750
1925069082,20150511T000000,2.20E+06,5,4.25,4640,22703,2860,1780
8100400160,20150413T000000,700000,3,2.25,2330,11424,2330,0
5556300102,20140714T000000,933399,3,2.5,3940,10360,3110,830
7222000393,20140703T000000,290000,3,1,1440,11250,1440,0
9407001860,20140524T000000,372000,4,1.75,1960,9300,1340,620
9468200140,20140819T000000,450000,2,1.75,1250,2890,790,460
3295950240,20140905T000000,303700,3,2.5,1981,5700,1981,0
3905000340,20140724T000000,672000,4,2.5,2440,10049,2440,0
3374300070,20140623T000000,334000,4,1.5,1150,9360,1150,0
7812800310,20140625T000000,260000,2,1,1120,5650,1120,0
7015200685,20140731T000000,749950,3,1.75,1800,5700,1000,800
3521069051,20141223T000000,330000,4,2.25,2380,122038,2380,0
8032700140,20141028T000000,830000,5,3,2920,2808,2140,780
6117500320,20140708T000000,1.13E+06,3,2.25,2790,13791,2790,0
7305300045,20140707T000000,320000,3,1,1560,7552,910,650
922069139,20150414T000000,260000,2,1,1550,15250,1550,0
84000335,20140626T000000,225000,3,2,1700,11475,970,730
9232400055,20140917T000000,279200,1,1,640,6350,640,0
1453600202,20140520T000000,520000,4,3.5,2680,10000,2040,640
3904910520,20140625T000000,505000,3,2.5,1860,8060,1860,0
5469300270,20140506T000000,234000,3,1.75,1490,8366,1010,480
8681660060,20140929T000000,503000,4,2.5,2470,5044,2470,0
3902300350,20140806T000000,606000,4,2.25,2390,8858,1740,650
6392003490,20140723T000000,433500,3,1,1230,6000,780,450
3342700465,20150123T000000,250000,3,1.5,2840,10182,1510,1330
2592210160,20140805T000000,719000,3,2.5,2120,9307,2120,0
616000160,20141210T000000,381000,3,2,1770,14400,1770,0
1687000270,20140528T000000,267000,3,2.5,2495,4400,2495,0
4102000075,20140522T000000,275000,1,0.75,1170,14149,880,290
8078460550,20140513T000000,651000,4,2.5,2740,7140,2740,0
2710600070,20150204T000000,439000,2,1,1050,5671,850,200
37000435,20150214T000000,325000,2,1,1130,5070,1130,0
5100401414,20140502T000000,490000,2,1,880,6380,880,0
5631500254,20141007T000000,519900,4,2.5,2403,6172,2403,0
8567300140,20140723T000000,545000,4,2.75,3410,35040,3410,0
98000060,20140714T000000,1.06E+06,4,4,5320,20041,5320,0
2205500400,20140514T000000,542000,4,1.75,1900,8250,950,950
1726069084,20141208T000000,465000,4,1.75,1810,21650,1810,0
8682291840,20150331T000000,408000,2,2,1200,3900,1200,0
5003600240,20141204T000000,292000,4,2.5,2060,5950,2060,0
5636000400,20140507T000000,253000,3,1.75,1250,10122,1250,0
3298700125,20140905T000000,280000,2,1,910,4662,910,0
7880000060,20140604T000000,658588,3,2.25,2560,41346,2560,0
7811200310,20141216T000000,635000,4,2.25,1920,8910,1200,720
5255690160,20141009T000000,439000,4,2.25,2240,8300,2240,0
869700320,20140806T000000,300000,3,2.5,1260,3855,1260,0
6052401631,20150205T000000,345000,3,1.5,1360,13496,1360,0
5089700260,20140812T000000,283500,4,2.25,2100,8050,2100,0
9473200105,20140924T000000,425000,2,1,2110,4920,1460,650
6678900140,20150319T000000,685000,3,1.75,2210,8955,1560,650
9552700550,20150421T000000,750000,3,2.5,2360,12987,2360,0
2171400218,20150416T000000,245000,4,1.5,1280,8000,1280,0
9122001231,20150403T000000,585444,6,3.75,2740,6924,1640,1100
6639900012,20140917T000000,706000,4,2.5,2740,7571,2740,0
8151601090,20140801T000000,445000,4,2,2630,9099,1830,800
6664900260,20150219T000000,241000,3,2,1650,6000,1650,0
7663700030,20150503T000000,1.18E+06,2,2.5,1770,7155,1770,0
952000055,20150206T000000,530000,3,1,1500,5750,1050,450
4292300024,20150302T000000,350000,3,1.5,1430,12199,1130,300
8073000550,20150415T000000,1.70E+06,4,3.75,3190,17186,3190,0
9238450160,20150428T000000,389000,3,1,1280,9630,1280,0
6127600036,20141105T000000,799000,4,2.75,2390,6820,2140,250
1370801331,20140804T000000,1.40E+06,4,2.5,4040,9630,2020,2020
3500100226,20141229T000000,340895,2,1,920,8612,920,0
319500570,20140505T000000,780000,4,2.5,2730,10281,2730,0
3751604974,20141204T000000,350000,2,1.5,1320,73600,1320,0
7852030320,20150217T000000,470000,3,2.5,2620,4874,2620,0
2481630070,20150128T000000,914600,4,3,3180,80837,3180,0
4299000030,20140923T000000,354000,4,2.5,2900,4762,2900,0
3886902590,20150226T000000,470000,5,2,1900,6000,1900,0
9178601000,20140730T000000,715000,3,2,1760,5400,1160,600
2861100030,20141007T000000,265000,2,1,760,4000,760,0
9471200370,20150330T000000,2.54E+06,4,3,3710,20000,2760,950
625049286,20140815T000000,640000,3,1,1530,4944,1530,0
133000135,20141120T000000,290000,4,1.75,1990,18900,1870,120
7214700830,20140513T000000,480000,5,4.75,3830,35000,2130,1700
4473400045,20140826T000000,535000,3,2,2040,5600,1120,920
9413600350,20140829T000000,907000,3,1.75,2170,12220,2170,0
1138010520,20140601T000000,459000,3,1.75,1620,7330,1090,530
7431500341,20150424T000000,1.36E+06,3,2.5,3600,21399,2310,1290
8830400135,20150305T000000,264950,3,1.5,1470,11599,1070,400
5694000710,20141107T000000,352950,3,1,1760,3000,1760,0
1951820070,20140822T000000,491500,3,2.25,2230,13100,1510,720
6137500320,20140625T000000,1.23E+06,4,3.5,3770,37034,2830,940
6703100070,20150406T000000,369500,3,1,1200,9194,1200,0
339350070,20150318T000000,566000,3,2.5,2090,6294,2090,0
7399300860,20140825T000000,290000,3,2.25,1500,7308,1210,290
8907500070,20150413T000000,5.35E+06,5,5,8000,23985,6720,1280
8651430560,20140522T000000,180000,3,1,870,5330,870,0
2228900270,20140812T000000,215000,2,1,1010,6000,1010,0
2228900270,20150212T000000,302000,2,1,1010,6000,1010,0
6880200030,20150410T000000,352500,3,1.75,1860,7881,1160,700
7227501170,20140626T000000,235867,4,2,1330,5926,1330,0
7504460200,20140717T000000,500000,3,2.25,1760,11946,1760,0
1559900200,20150326T000000,382000,3,2.25,1800,4500,1800,0
546000400,20150422T000000,515000,5,2.5,1690,2402,990,700
1596600060,20150501T000000,250000,1,1,660,2600,660,0
6021501920,20140627T000000,672500,3,2.25,2400,5300,1250,1150
3275860270,20141022T000000,755000,3,2.25,3020,13031,3020,0
5457300703,20150320T000000,707500,3,1,1500,2555,1500,0
2919700885,20140826T000000,459000,4,2,1560,3840,960,600
1951500030,20150204T000000,140000,3,1,1090,10620,1090,0
9550200310,20140811T000000,495000,2,1,970,4284,970,0
3630120700,20140513T000000,757000,3,3.25,3190,5283,3190,0
3630120700,20150107T000000,765000,3,3.25,3190,5283,3190,0
6370000070,20140919T000000,359000,4,1.5,1890,6052,1890,0
7935000125,20140605T000000,440000,3,1,1050,7500,1050,0
3034200058,20140529T000000,400000,4,1.5,1390,7200,1140,250
2856102336,20150325T000000,652000,3,2,1700,4080,850,850
2523039239,20140530T000000,260000,3,1.75,1050,5850,1050,0
5452800310,20150420T000000,1.33E+06,5,3,3340,10796,2120,1220
2724069070,20150220T000000,519500,4,2,1540,17859,1540,0
6690500320,20141027T000000,650000,3,1,1710,5992,1560,150
2413301070,20150324T000000,280000,4,2.25,2100,8075,2100,0
1562100030,20140910T000000,515000,4,1.75,1730,7980,1730,0
7941140070,20150318T000000,400000,3,2.25,1500,2692,1500,0
1703050520,20150414T000000,652100,3,2.5,2380,5017,2380,0
2412600030,20140623T000000,235000,6,3,2180,7956,2180,0
5266300140,20150408T000000,701000,4,1.5,1840,10080,1840,0
11520030,20140624T000000,640000,4,2.5,2341,9594,2341,0
7202290140,20140728T000000,455800,3,2.5,1690,4584,1690,0
8161010060,20141218T000000,504750,3,2.5,2490,21937,2490,0
8562900710,20140711T000000,483000,3,3,2440,15540,2440,0
8888000055,20141230T000000,530000,3,0.75,920,20412,920,0
3395800295,20140711T000000,250000,2,1,1030,8786,1030,0
5557320030,20140924T000000,229950,5,2.75,2000,5885,1260,740
2909300640,20140723T000000,884744,4,3.5,4210,9414,4210,0
5202500030,20150401T000000,514000,3,1.5,1610,9964,1080,530
5561300640,20150506T000000,532000,3,2.25,1910,35015,1430,480
3449900030,20140911T000000,423000,4,2.5,2660,5539,2660,0
952003435,20140826T000000,420000,2,1,820,4025,820,0
6204200340,20141110T000000,521000,3,1.75,1730,18250,1730,0
1737100830,20150205T000000,577000,4,2.25,2360,7490,2360,0
2207200520,20140929T000000,425000,3,1,970,8040,970,0
3818400060,20141031T000000,495000,4,2.5,2460,4862,2460,0
9264960560,20141001T000000,340000,3,2.5,2690,8577,2690,0
6362900172,20140923T000000,499950,3,3.5,1820,1991,1430,390
9272200810,20150316T000000,1.22E+06,4,3,3470,4750,2370,1100
3629160060,20150227T000000,720000,4,2.75,3370,7634,2110,1260
4324200060,20150312T000000,249000,3,1.5,1700,8247,1010,690
3830620710,20140613T000000,206135,3,1,1340,11070,1340,0
3276900030,20141006T000000,300000,5,2.75,2000,9276,2000,0
4058800830,20150318T000000,612000,6,3,3840,14040,2460,1380
6202600070,20141106T000000,1.10E+06,5,2.5,3890,27311,3890,0
8581200030,20150224T000000,230000,4,2,1220,9100,1220,0
2771601940,20150504T000000,850000,3,1,2280,4600,1250,1030
2214800270,20140925T000000,355000,4,2.5,2770,7000,1940,830
7312000240,20140623T000000,442000,4,2.5,2520,7253,2520,0
8562890560,20140626T000000,399000,4,3,3060,5000,3060,0
4136930310,20141106T000000,360000,4,2.5,2390,7115,2390,0
1328330350,20150213T000000,390000,3,1.75,1320,7725,1320,0
5255690060,20150318T000000,413000,5,2.5,2900,8711,1650,1250
402000260,20150211T000000,190000,2,1,700,9500,700,0
7787110060,20141013T000000,432900,3,2.5,2210,9226,2210,0
8651580310,20140528T000000,621138,3,2.25,2180,7741,2180,0
3705000060,20140604T000000,270000,3,2.25,2080,4252,1550,530
7525410060,20150109T000000,610000,4,2.25,2090,35040,1490,600
3295700060,20140602T000000,500000,3,2,1720,5525,960,760
8121500060,20140807T000000,715000,4,2.25,2460,40635,2460,0
3728800320,20140529T000000,264000,3,1.5,1470,14821,1470,0
6003501535,20140828T000000,550000,3,1.75,1650,3200,1650,0
2621750340,20141015T000000,337000,3,2,1690,9087,1690,0
3445000274,20150513T000000,170000,3,1,970,8710,970,0
3288200030,20140829T000000,405000,4,2.5,2030,9095,1130,900
4188000640,20140911T000000,775000,4,2.5,2540,28563,2540,0
2558730070,20140825T000000,425000,3,2.25,1570,7475,1200,370
7923500060,20140922T000000,713000,5,2.75,2580,9242,1720,860
8016300030,20141103T000000,555000,5,2.5,2090,8712,1420,670
3629920830,20150506T000000,810000,4,2.5,3260,5608,3260,0
4054510270,20140827T000000,1.25E+06,4,3.75,3830,41263,3830,0
2864600105,20140624T000000,819000,3,3.5,2130,6150,1530,600
8165500830,20150327T000000,409900,3,2.5,1690,1200,1410,280
4395600060,20140630T000000,935000,2,2.5,1780,2067,1780,0
4444800045,20150420T000000,657500,4,1.75,1620,7560,1380,240
1115300270,20150428T000000,900000,6,3.75,4210,6105,3280,930
5363200200,20150402T000000,932800,5,3.25,2980,7095,2980,0
6067900640,20150420T000000,391000,3,2,1490,9000,1490,0
4279200060,20141230T000000,420000,4,2.5,2110,9825,2110,0
3425059222,20141124T000000,1.30E+06,6,3.5,6563,32670,5153,1410
5253300397,20150409T000000,415000,3,1.5,1510,16800,1510,0
1769600204,20150225T000000,350000,3,1.75,1830,9425,1590,240
1176001195,20140621T000000,375000,2,1,1230,1820,830,400
1239400570,20141117T000000,860000,3,1.75,2180,14135,1300,880
6071600270,20140603T000000,495000,4,2.25,2220,8872,1110,1110
1311100520,20150414T000000,250000,4,2.25,1730,8400,1730,0
1402200070,20141013T000000,365000,4,2.25,1990,21312,1990,0
1419700270,20140507T000000,503000,3,2.75,1540,6760,1210,330
5126900310,20150325T000000,150000,2,1,1100,7200,1100,0
8816400885,20141008T000000,450000,4,1.75,1640,1480,820,820
5412100550,20141208T000000,355000,4,3,2590,7213,2590,0
7203000465,20141018T000000,245000,3,2,1450,9333,1450,0
1862900160,20140703T000000,265900,3,2,1180,7793,1180,0
984220240,20141125T000000,299000,4,2.5,1820,7575,1220,600
4458800060,20150409T000000,957500,4,2.25,2360,11523,2360,0
1138000160,20140908T000000,343000,3,1,1120,7250,1120,0
9406520550,20141027T000000,307500,3,2.25,1646,7364,1646,0
7852160070,20150105T000000,937500,5,3.75,4210,14599,4210,0
7214700160,20140509T000000,610000,3,3,2480,45302,1620,860
2483700160,20140917T000000,720000,3,1.5,1590,7080,1310,280
1972201820,20141016T000000,610000,4,2,2130,2620,1650,480
9477000060,20150331T000000,434500,3,1.75,1650,7965,1650,0
7932000041,20150512T000000,602500,2,2.5,3090,47044,2250,840
1231000520,20141118T000000,607010,4,2.5,2180,4000,1700,480
7522500070,20150204T000000,610000,3,1,1800,5750,1040,760
4215250310,20140919T000000,828500,4,2.5,3720,35000,3720,0
5560000070,20140707T000000,199990,3,1,1100,8560,1100,0
1545804460,20150401T000000,294000,3,1.75,1530,9362,1530,0
9510970310,20140612T000000,789500,4,2.5,3010,6100,3010,0
98030160,20150212T000000,797000,3,3.5,3500,9473,3500,0
7853300070,20140818T000000,539950,5,3,3100,5250,3100,0
934300140,20150323T000000,284950,4,1.5,2000,6778,1170,830
1245001820,20150429T000000,776500,4,1.5,2290,10372,1510,780
1974200060,20150424T000000,525000,4,2.5,2400,10070,1510,890
7300410060,20150425T000000,303000,3,2.5,1850,4957,1850,0
1939110310,20150310T000000,722080,3,3.25,3680,7650,2340,1340
7888000390,20140627T000000,140000,3,1,1060,7473,1060,0
7888000390,20150401T000000,235000,3,1,1060,7473,1060,0
1529300435,20141120T000000,440000,3,1,1610,5500,1610,0
2960900045,20140718T000000,605000,3,1.75,2330,6000,1630,700
3959400135,20140602T000000,380000,2,1,1210,4800,1060,150
7972600765,20140625T000000,352000,4,1,1530,8890,980,550
7214810550,20150413T000000,420000,4,2.25,2270,12000,1360,910
3271801090,20150430T000000,1.18E+06,4,2,2590,7220,2590,0
8964800370,20141022T000000,1.38E+06,3,1.5,1850,10572,1850,0
8019200030,20140926T000000,300000,3,1.5,1500,14750,1500,0
2954400400,20141112T000000,1.15E+06,4,3.25,4740,49091,4740,0
3013301525,20141013T000000,453500,2,1.5,1710,4189,1160,550
3303100075,20141014T000000,443500,3,2,1920,7598,1920,0
2004100075,20150326T000000,332000,2,1,1150,8138,1150,0
4221270340,20150327T000000,655000,3,2.5,2320,4721,2320,0
7177300575,20140903T000000,475000,4,1,1420,6000,1420,0
1471630350,20141024T000000,372500,3,1.75,1550,12956,1210,340
1250203335,20140527T000000,1.05E+06,4,2.5,2920,7200,1470,1450
8815400105,20140603T000000,500000,3,1.75,1620,4200,830,790
5315100737,20140528T000000,900000,6,2.75,2300,24773,2300,0
3333002440,20140604T000000,327500,3,1,1070,7140,1070,0
2130702205,20150406T000000,390000,3,1.75,1790,7123,1790,0
2159900060,20150113T000000,451101,2,1.5,1510,1962,1510,0
194000575,20141014T000000,455000,4,1,1340,5800,1340,0
1531000140,20140701T000000,650000,4,2.5,3350,46748,3350,0
2125049139,20140806T000000,895000,3,2.5,2500,7746,1910,590
3623500135,20150326T000000,800000,4,2.25,2350,10664,1510,840
7805460310,20141113T000000,703770,4,2.25,2550,12918,2550,0
3021059244,20140814T000000,249950,3,1.75,1320,10454,1320,0
925049360,20150428T000000,512000,2,2,1270,3881,610,660
3286800260,20150506T000000,780000,5,2.5,3480,74052,1980,1500
4137010240,20140716T000000,336000,3,2.25,2820,11625,2820,0
9368700341,20140822T000000,285000,3,2,2110,6900,1220,890
3832310350,20141021T000000,229900,3,1.75,1100,7224,1100,0
324000350,20150415T000000,667500,4,3,1920,4000,1540,380
9407101840,20140620T000000,378000,4,2.5,1890,12236,1230,660
1422300140,20140905T000000,454000,3,2.5,2530,43733,1530,1000
6127011000,20140508T000000,537500,4,2.5,2550,4630,2550,0
2624049117,20140903T000000,425000,3,1,1550,4160,1550,0
3295750550,20141124T000000,290000,3,2,1760,6600,1760,0
7960100260,20140701T000000,349500,3,2,1270,3600,1270,0
7625700012,20141202T000000,370000,3,2.75,1250,1655,830,420
5418200295,20150309T000000,549500,3,1.75,1620,8438,1620,0
7454000295,20150130T000000,245000,2,1,710,6322,710,0
8100000060,20140729T000000,208000,3,1.75,1070,7200,1070,0
1310500550,20141220T000000,248000,4,2.25,2320,8760,1160,1160
9485950310,20141003T000000,610000,4,3.25,5450,37058,5450,0
4213910030,20150401T000000,550000,4,2.5,1670,5116,1670,0
1223089083,20141028T000000,750000,3,2.75,3010,206910,3010,0
2143700861,20141030T000000,192000,2,1.75,1340,7380,1340,0
5016003230,20150218T000000,169317,2,1,790,4000,790,0
1338801019,20140701T000000,1.20E+06,4,3.5,3400,3850,2790,610
3592500565,20141029T000000,880000,2,1,1530,6350,1530,0
6414600070,20140617T000000,210000,1,1,930,7129,930,0
8645500160,20150107T000000,180500,3,1.5,1540,9800,1010,530
8651520240,20140728T000000,540000,4,2,1990,29078,1990,0
9408300310,20140624T000000,520000,3,1.75,2300,35722,2300,0
4202400135,20140626T000000,177500,3,1.5,1220,6000,1220,0
7129300935,20141105T000000,415000,3,1.75,2380,5650,1190,1190
8143000310,20140909T000000,495000,4,2.5,2020,7200,1010,1010
6082400152,20150304T000000,325000,3,2.25,1890,9646,1890,0
6838000520,20150220T000000,440000,2,1.75,1330,4903,1330,0
4023500118,20140723T000000,411000,3,1.75,1490,9844,1190,300
8952900204,20141029T000000,810000,5,3.5,3550,9600,2550,1000
7922800320,20141016T000000,561750,5,1.75,2040,8996,1020,1020
9542000030,20140722T000000,835100,4,2.5,2380,12573,2380,0
3787000140,20140901T000000,450000,3,2.25,1780,9969,1450,330
646910030,20141104T000000,238000,3,2.5,1650,2807,1650,0
5515600075,20141205T000000,299000,3,1,1510,142803,1510,0
1377300135,20141017T000000,570000,2,1,1100,6240,1100,0
5469501940,20140604T000000,340000,3,1.75,2190,12626,2190,0
9276200890,20150429T000000,450000,2,1.75,1760,2275,1040,720
6385910260,20140910T000000,272750,4,1.5,1800,8786,1330,470
5101402482,20140724T000000,520000,4,2,2000,6380,1860,140
9353300140,20140618T000000,284950,3,1,990,10723,990,0
5379801600,20150424T000000,255000,2,1.5,1480,9660,1480,0
6082400260,20141112T000000,231500,2,1,1200,9488,1200,0
2025079033,20141210T000000,415000,1,2,3000,204732,3000,0
6181430800,20150105T000000,330000,4,2.5,3504,6000,3504,0
3649100473,20140528T000000,365000,3,1.5,1300,12240,1300,0
2011400791,20141007T000000,425000,4,2,1330,9188,1330,0
7549802030,20141104T000000,400000,4,1.75,1850,6480,1120,730
1898200030,20140922T000000,335000,4,2.5,2240,9701,2240,0
567000672,20140930T000000,342000,3,3,1260,1251,1040,220
9126101740,20141204T000000,490000,8,5,2800,2580,1880,920
5127001600,20141106T000000,331500,4,1.75,1820,14319,1820,0
1925069121,20150330T000000,960000,3,2.5,1730,4102,1730,0
7511210310,20140709T000000,720500,4,2.5,3350,35298,3350,0
65000260,20140820T000000,830000,3,2.5,3370,6550,2840,530
6372000060,20140523T000000,662990,3,1.75,1240,3600,1240,0
2005300140,20150330T000000,220000,4,2,2340,10507,2340,0
5649600435,20150108T000000,349950,5,2,1880,4179,940,940
2249500059,20150107T000000,550000,3,2,1810,2159,1010,800
1773100510,20140915T000000,396000,3,1.75,2340,5668,1200,1140
9521100960,20150116T000000,635000,4,1.5,2820,4000,2820,0
1785500132,20141118T000000,293000,3,1,1020,7650,1020,0
8645530060,20140711T000000,339000,3,2.25,2090,10120,1290,800
7697920060,20140630T000000,285000,4,2.25,1830,8734,1830,0
9550202010,20140710T000000,775000,6,2.75,2980,5000,2480,500
1821059264,20140626T000000,224000,4,1.5,1600,9289,1600,0
5700003985,20141029T000000,2.25E+06,4,3.5,4440,8125,3140,1300
2320069248,20140701T000000,165050,3,1,1200,8514,1200,0
2658000335,20141027T000000,275000,3,1.25,1230,4500,1230,0
1702901557,20140911T000000,445000,5,3,2930,5500,1750,1180
1774220350,20150401T000000,510000,3,2.25,2370,38639,1930,440
7355700171,20140610T000000,1.23E+06,4,2.5,3040,7000,3040,0
3971701922,20141029T000000,390000,3,1.5,1610,13500,1060,550
3583300135,20140513T000000,460000,3,2.25,2350,10450,1390,960
9542000075,20150327T000000,700000,3,1.75,2000,14733,2000,0
4055700955,20140622T000000,874150,4,3.5,3530,14406,2570,960
4022902505,20140731T000000,470000,3,2.25,2220,9800,2220,0
8680100030,20140521T000000,374000,3,1.75,2000,9416,2000,0
2923039017,20140717T000000,510000,2,1.75,1210,131115,1210,0
2767604247,20140711T000000,467000,2,2.5,1140,1181,1140,0
5631500505,20140616T000000,576000,4,2.5,2440,28405,2440,0
3356406510,20140530T000000,196440,3,2,1560,7352,1560,0
7701990700,20141231T000000,825000,4,2.5,3210,18901,3210,0
8835200800,20150408T000000,281000,2,1,930,2600,930,0
8902500118,20140812T000000,326000,3,2.5,1782,1577,1782,0
2822079012,20150410T000000,340000,3,1.75,1740,46580,1740,0
9485950060,20141208T000000,440000,5,1.75,3690,36036,1890,1800
424069264,20140522T000000,749000,4,2.5,2930,18199,2930,0
3581000340,20150227T000000,340000,4,1,1230,8316,1230,0
7625704005,20140506T000000,561000,3,2,2000,7000,2000,0
1545803240,20141031T000000,270000,3,2.25,1520,7930,1160,360
8080400045,20140620T000000,600000,2,1,1040,3600,1040,0
8651402920,20140505T000000,219900,4,1.5,1120,5427,1120,0
3121069036,20141208T000000,617000,3,1.75,3020,360241,3020,0
2540800390,20140904T000000,469000,3,2.25,1820,8446,1820,0
7978800621,20140811T000000,229000,3,1,1370,56628,1370,0
1336300445,20150422T000000,1.27E+06,4,3,3130,2646,2290,840
6159400060,20140805T000000,365000,3,1.5,1640,8301,1290,350
9510930350,20141212T000000,429000,4,2.5,2650,9301,2650,0
5535600520,20141208T000000,550000,4,2.5,2850,6809,2850,0
7634800070,20150116T000000,453000,3,2.5,1820,16300,1220,600
8581200350,20140617T000000,187500,3,1.5,1180,7000,1180,0
6190701146,20150415T000000,520500,6,2.5,1880,14350,1640,240
522059299,20150204T000000,300000,3,1.75,1280,12776,1280,0
1513800036,20140516T000000,799000,4,3.25,3120,5000,2370,750
6699930550,20150203T000000,338000,3,2.5,2470,4948,2470,0
9839300875,20140514T000000,800000,3,1,1700,4400,1700,0
2493200435,20140825T000000,360000,2,2,1180,3200,590,590
226039282,20140728T000000,442500,6,2.5,2800,10490,1400,1400
1020069017,20150327T000000,700000,4,1,1300,1651359,1300,0
5450900140,20140508T000000,830000,5,3,3040,9601,1970,1070
8093800200,20141118T000000,360400,3,2.5,1630,11592,1630,0
3205000310,20141121T000000,345000,3,1,1340,9339,1340,0
7230000350,20140909T000000,300000,3,1.75,1830,51836,1430,400
1066600045,20140904T000000,350000,3,1,1240,10800,1240,0
2822069078,20141008T000000,368000,4,2,2500,36900,1540,960
8731900340,20140623T000000,264000,3,1.75,1760,7482,1760,0
5088500310,20150312T000000,435000,3,2,2660,16677,2210,450
1823059205,20140604T000000,200000,3,1.5,2060,15837,2060,0
225039082,20140514T000000,620000,5,2.5,2540,3832,1760,780
5021900140,20141120T000000,1.68E+06,5,4.25,4830,11466,3720,1110
7883603750,20141209T000000,337000,3,1.75,1400,6000,700,700
8081500060,20141001T000000,1.93E+06,4,3.25,4280,20296,4280,0
8099900260,20140528T000000,544500,4,2.5,2230,10414,1450,780
913000340,20150102T000000,252000,1,1,680,1638,680,0
2115200160,20140605T000000,445000,4,2.5,2340,3784,2340,0
5095600310,20140725T000000,379500,3,2.25,2070,14196,2070,0
5402100045,20150311T000000,189950,4,2,1910,4225,910,1000
2258500049,20140602T000000,469000,3,1,950,4250,950,0
626100023,20140611T000000,600000,5,2.75,2910,53898,1510,1400
4309720160,20141107T000000,785000,3,2.5,2930,33981,2930,0
1843100070,20150210T000000,372000,4,2.75,2610,8967,2610,0
4307350520,20150225T000000,445000,5,3,3880,7180,3880,0
5561401260,20141014T000000,508000,4,2.25,3320,53392,2000,1320
2883200966,20150318T000000,780000,5,1.5,1940,4800,1940,0
7214800240,20150316T000000,541100,4,2.25,2510,9800,2510,0
3629920860,20150105T000000,729000,4,2.5,2660,5608,2660,0
1320069179,20141104T000000,397000,3,2,1710,134489,1710,0
9424400200,20140515T000000,451555,2,1,1320,4520,1320,0
3500100189,20140630T000000,300000,2,1,960,8153,960,0
2787720140,20150407T000000,416000,3,2.5,1790,11542,1190,600
3856904740,20141021T000000,490000,2,1,950,3060,810,140
254000445,20150129T000000,480000,6,3.75,2940,5054,2940,0
6821101837,20150203T000000,368000,2,2,930,1662,670,260
5608000700,20140918T000000,1.04E+06,3,2.5,4570,10615,4570,0
7784400060,20150120T000000,545000,3,2.5,2370,9000,1570,800
3295610350,20150323T000000,850000,5,2.75,3430,15119,3430,0
3260570260,20141204T000000,550000,4,3.5,3540,4750,3540,0
1592000260,20150217T000000,600000,3,2.25,2240,9314,2240,0
8670000060,20140827T000000,535000,4,2.5,2710,12138,1700,1010
8113600004,20140520T000000,599950,3,2.5,2660,4975,2660,0
235000075,20140718T000000,531000,5,2.75,2540,5022,1540,1000
1951700700,20140605T000000,530000,4,2.25,2210,7665,2210,0
1832100030,20140625T000000,597326,4,4,3570,8250,2860,710
8565000030,20150429T000000,805000,4,2.5,3450,33460,3450,0
2473350710,20141027T000000,390000,4,1.75,2330,8364,2330,0
9521101221,20140519T000000,487250,4,2,1690,3250,1550,140
6152900273,20140909T000000,301000,3,1.5,1030,8414,1030,0
2721600125,20150205T000000,1.18E+06,5,2.75,2560,5618,2220,340
1180002378,20140926T000000,299000,4,2.5,1950,3000,1950,0
625059051,20140903T000000,2.35E+06,4,2.25,4370,22863,3670,700
2113700060,20141014T000000,400000,4,2.5,2350,3904,2350,0
7016100570,20141201T000000,467500,4,2.5,3160,7210,1880,1280
2944500710,20150220T000000,305000,4,2.5,2430,9103,2430,0
1549500370,20140505T000000,210000,3,1,1340,306848,1340,0
7211340030,20150428T000000,300000,3,1,1010,10168,1010,0
2473480520,20140908T000000,327500,3,2.25,1770,8755,1330,440
1722059326,20140805T000000,269000,3,2,1210,7136,1210,0
9414100030,20150331T000000,975000,4,3.25,3330,17533,1750,1580
8911000030,20141210T000000,355000,3,1,1240,5400,1060,180
2264500890,20140508T000000,712000,3,1,1250,4620,1150,100
2481630200,20140614T000000,883000,4,2.5,2960,41656,2960,0
7299500200,20140815T000000,190000,2,1,840,12252,840,0
8598900125,20150406T000000,443000,3,1.75,1530,8028,1200,330
7504010560,20140509T000000,920000,4,3,3750,11025,3750,0
8732130140,20141222T000000,285000,4,2.25,2150,8250,1240,910
2492200335,20150423T000000,901000,4,3.25,1560,4080,1560,0
2770606602,20150305T000000,552500,3,1.75,2040,5775,1410,630
7211400990,20150303T000000,256000,2,1,860,5000,860,0
7148700160,20140512T000000,341000,3,1.5,1720,7119,1720,0
984220370,20150326T000000,279000,4,2.25,2090,8941,2090,0
2600000510,20140726T000000,686000,4,2.25,2130,10650,2130,0
7123400045,20140523T000000,225000,2,1,1300,11867,1300,0
3751602329,20140627T000000,215500,2,1.75,1220,15600,1220,0
6819100310,20150414T000000,950000,4,3,2420,4800,1520,900
2925079012,20141105T000000,503000,4,2.5,2940,156988,1870,1070
7202430060,20150122T000000,780000,3,2.5,2610,7567,2610,0
185000118,20150223T000000,212000,4,2,1880,7500,980,900
1139000685,20140729T000000,580000,4,2.75,2330,6703,1710,620
5312100060,20141111T000000,465000,4,2.5,2200,3141,2060,140
3356404330,20141119T000000,206000,4,2,1720,7560,1720,0
7805460030,20150223T000000,615000,3,2.5,2250,10171,2250,0
1705400055,20140719T000000,519000,4,1,1640,6305,1640,0
3303980520,20150423T000000,1.14E+06,4,3.25,4130,11444,4130,0
2538410140,20140808T000000,330000,5,2.5,2600,3839,2600,0
3810000860,20150506T000000,240000,4,1.5,1920,7973,1920,0
8079100370,20141107T000000,574000,3,2,2060,7000,2060,0
2025770560,20141103T000000,930000,4,4.25,5710,24663,5710,0
225069017,20140714T000000,850000,4,3,2720,183823,2720,0
1138010510,20141212T000000,415000,3,1.5,1490,7275,1090,400
4358700135,20141118T000000,480000,3,2.5,2360,9005,1340,1020
4327100045,20140721T000000,300000,5,1,1940,8875,1940,0
6804600550,20140708T000000,439000,4,2.25,2570,9503,2570,0
5634500251,20150327T000000,450000,3,1,1160,36831,1160,0
3125079062,20150426T000000,589000,3,2.5,2660,206480,2660,0
3629920140,20150407T000000,477000,3,2.25,1260,3000,1260,0
6844703410,20140924T000000,587500,4,2.25,1780,6120,1310,470
1337300070,20140924T000000,1.32E+06,4,2.25,3180,6105,3180,0
9290900160,20140911T000000,1.43E+06,4,2.5,3380,27589,3380,0
2251500270,20150413T000000,700000,4,2.25,2690,15000,1890,800
414100295,20140623T000000,275000,2,1,1180,6552,1180,0
1771110640,20140624T000000,367500,3,1,1660,11783,1160,500
808300550,20150505T000000,453250,4,2.5,2260,6300,2260,0
4322500055,20150417T000000,607000,5,1.75,1910,5428,1390,520
3810000565,20140702T000000,255000,4,2,2430,8960,1430,1000
461002025,20150501T000000,501000,2,2,1300,2500,770,530
8559900140,20150331T000000,450000,3,1,1060,4650,910,150
8899210320,20140820T000000,360000,3,2.25,2200,8000,2200,0
952002765,20141114T000000,460000,4,1.75,1720,3050,1040,680
7101100055,20150303T000000,753000,3,1.75,2360,8290,1180,1180
3013300510,20150506T000000,389950,2,1,820,4234,820,0
1623300765,20140506T000000,469000,2,1,1030,4400,1030,0
9322800260,20140912T000000,550000,4,1.75,2030,5688,1730,300
6141600140,20140904T000000,565000,5,3.5,2700,11675,1950,750
9315300260,20140521T000000,189650,2,1.75,1100,7600,1100,0
7015200335,20140619T000000,1.53E+06,4,3.25,3620,5131,2350,1270
1545806510,20140820T000000,260000,3,1.75,1340,8000,1340,0
8643200055,20140601T000000,243000,3,1.75,1790,12000,1040,750
7855000550,20141201T000000,1.10E+06,4,2.5,3830,13800,2030,1800
1313500070,20140820T000000,249000,3,1.5,1580,7200,1080,500
290000055,20140516T000000,720000,2,1,2020,7200,1700,320
4139460200,20150325T000000,905000,4,2.5,3330,9557,3330,0
3931900295,20150423T000000,824500,4,2.5,2610,3500,1610,1000
7365600070,20140624T000000,762500,4,2.75,2610,8760,1760,850
9274200320,20150413T000000,580000,3,2.5,1740,1280,1740,0
8856920260,20140818T000000,380000,3,2,1840,8580,1840,0
4083306175,20150401T000000,805000,3,1.75,1080,3200,880,200
7588700204,20140716T000000,520000,4,1.75,1240,4532,1240,0
3271800295,20150203T000000,1.57E+06,5,4.5,5620,5800,4700,920
6052400575,20140514T000000,175000,2,1,1170,8925,1170,0
7861300140,20140616T000000,353500,4,2.25,1760,9602,1760,0
6117501176,20150102T000000,500000,4,2.5,2230,26989,1400,830
2592400140,20150211T000000,386500,3,1.75,1520,7350,1140,380
7135300046,20140716T000000,210000,2,1,1450,4750,850,600
8665900295,20150423T000000,439500,3,2.5,1600,6510,940,660
6699000810,20140813T000000,315000,5,2.5,3220,5751,3220,0
5104510240,20140519T000000,339000,4,2.5,1830,8601,1830,0
7856700990,20140924T000000,655000,4,2.25,2200,9163,1430,770
8682300640,20140828T000000,740000,2,2.5,2170,8678,2170,0
6918700320,20150306T000000,685000,5,2.5,1900,7843,1900,0
9560700055,20150310T000000,550000,5,2.5,2960,9877,1480,1480
3013300055,20140602T000000,405000,2,1.75,1710,4234,1330,380
9201000320,20150416T000000,765000,4,2.25,2620,17366,1430,1190
9151600695,20150304T000000,625000,3,2,2140,3600,1680,460
2143700830,20141006T000000,207000,4,2.5,2100,19680,2100,0
2143700830,20150312T000000,370000,4,2.5,2100,19680,2100,0
2591020140,20141202T000000,475000,3,2.5,1460,4961,1150,310
6414600262,20140829T000000,365000,2,1,990,8250,990,0
1387301360,20141222T000000,411800,4,2.25,2190,6800,1340,850
5561400260,20140721T000000,668000,5,3.5,3990,42436,2710,1280
7942601805,20140911T000000,618000,3,2.5,2340,3630,2340,0
1887500045,20141226T000000,247500,4,2,2460,5921,1230,1230
5505700055,20140730T000000,345000,5,3,2080,6150,1040,1040
3886902505,20150311T000000,616300,3,2,1700,8400,1700,0
6703100135,20150116T000000,348000,3,1.5,1330,6768,1330,0
1552520070,20141202T000000,425000,3,2.5,1630,10762,1630,0
8163300320,20140614T000000,850000,5,2.75,2920,11880,1660,1260
1853081000,20140717T000000,820000,5,2.75,2830,6137,2830,0
4403600240,20150113T000000,832000,4,2.25,3190,52953,3190,0
3885803625,20141203T000000,835000,3,1.75,1490,3840,1490,0
869700370,20150410T000000,350000,3,2.5,1630,3425,1630,0
4307301160,20140722T000000,349000,4,2.5,2280,4096,2280,0
2402100575,20140613T000000,1.13E+06,6,3.75,3010,4360,2000,1010
4307350990,20150309T000000,320000,3,2.5,1590,3480,1590,0
2873000260,20150305T000000,150000,3,1,1250,7210,1250,0
795001600,20141125T000000,340000,3,1,1710,10190,1310,400
98030140,20141013T000000,785500,4,4,3280,8448,3280,0
5409800140,20150217T000000,410500,4,2.5,3362,8601,3362,0
9253900354,20140701T000000,580000,3,2.5,2200,11000,2200,0
3319500922,20150421T000000,345000,2,1.5,830,920,830,0
3404700041,20140929T000000,550000,3,2.25,2160,37000,1760,400
2314300200,20141021T000000,449500,4,3,2580,7299,2580,0
9265700045,20140624T000000,300000,3,1,2150,7007,2150,0
3528000260,20141111T000000,915000,4,2.5,3510,28052,3510,0
3066120030,20150127T000000,1.58E+06,4,3.75,3810,9916,3810,0
4278900055,20140528T000000,599000,4,2.75,2020,2750,1010,1010
9512000140,20140505T000000,755000,4,2.5,2120,10202,1620,500
6381500505,20150402T000000,400000,3,1,1250,7157,1250,0
1697000400,20150330T000000,133000,3,1,980,9115,980,0
2548100140,20150116T000000,330000,4,1.5,1250,8400,960,290
7225000140,20150218T000000,330000,4,1,1100,5000,1100,0
2126049032,20140905T000000,375000,3,1.75,1330,9417,710,620
3876300890,20141211T000000,485000,4,2.75,2560,8956,1500,1060
7715800710,20140722T000000,470000,4,2.5,1850,11250,1210,640
2397101200,20141221T000000,1.05E+06,4,3,2790,3600,1880,910
5100401160,20140707T000000,548800,4,1,1660,4704,1260,400
2741100800,20140708T000000,315000,2,1,1080,2674,720,360
34001160,20140919T000000,590000,3,2,3030,9374,2100,930
5637200200,20140523T000000,439950,4,2.5,2380,12067,2380,0
3410600335,20140603T000000,325000,3,1.75,2250,26337,2250,0
8024201370,20141208T000000,400000,2,1,880,5111,880,0
3066410800,20141211T000000,685000,4,2.5,2770,10051,2770,0
5306100240,20140918T000000,339950,3,2,1340,10200,1340,0
9334800140,20141023T000000,315000,3,1.75,1660,8160,1660,0
7203101260,20150211T000000,411753,3,2.5,1710,3795,1710,0
7577700070,20140828T000000,577000,2,1.75,1620,4879,1040,580
6072100140,20141017T000000,500000,3,1.75,1530,8829,1530,0
3874000240,20141202T000000,210000,3,2,1440,10111,1440,0
6151800135,20140827T000000,640000,4,1.75,2020,16120,2020,0
1826049225,20150417T000000,460000,4,1.75,1870,8663,1870,0
8150100240,20150218T000000,265000,2,1,620,4760,620,0
5152960710,20140514T000000,740000,5,5,5774,31675,4490,1284
4027701275,20140718T000000,230000,3,1,1240,6195,1240,0
1545807990,20150217T000000,315000,3,1.75,1890,10661,1460,430
1726069179,20141223T000000,432000,3,1.75,2410,51763,1410,1000
3905100070,20150203T000000,467000,3,2.5,1530,3984,1530,0
7316400070,20140925T000000,255000,5,3.75,2800,9900,2800,0
2113700335,20150408T000000,316500,3,1.75,1460,6360,1010,450
3972900160,20150403T000000,190000,4,2,1580,6250,860,720
2767603215,20140516T000000,490000,3,2,1450,2400,1450,0
3664500041,20150417T000000,378000,4,1.75,1990,23200,1990,0
5379804150,20150211T000000,598800,6,4,4470,17877,3230,1240
9188200570,20140902T000000,333800,5,3,1980,3868,1220,760
3905010140,20140529T000000,690000,4,2.5,2920,9904,2920,0
5141000685,20141021T000000,320000,4,1.75,1660,6200,830,830
6738700320,20150414T000000,1.25E+06,4,3.5,3190,6000,2410,780
1246700152,20140721T000000,335000,3,1.5,1560,9600,1560,0
2926069062,20140811T000000,840000,3,2.5,3050,33920,3050,0
6114400136,20140714T000000,608250,4,2.75,3030,21780,3030,0
6127010800,20140609T000000,550000,3,2.5,2260,4165,2260,0
4222000320,20150422T000000,240000,3,1,1260,7920,1260,0
2600010070,20150414T000000,998000,3,2.25,3370,11757,3370,0
3826500570,20140829T000000,275000,3,1.75,1490,8000,1490,0
8159620160,20150424T000000,284200,3,2.5,1570,9292,1110,460
1118001805,20140724T000000,1.72E+06,4,3.75,4490,7623,3090,1400
3398800055,20141119T000000,2.40E+06,4,3.75,4090,24825,3400,690
3528000510,20140905T000000,930800,5,2.5,4150,96574,4150,0
627300105,20140729T000000,930000,4,3,2900,10400,1530,1370
3279000070,20140828T000000,215000,4,1.5,1430,8775,1030,400
1922039062,20150420T000000,480000,2,1.5,1008,26487,1008,0
312000135,20140520T000000,483945,2,1.75,1480,5120,840,640
6054650510,20140609T000000,347000,3,1.75,1240,8050,1240,0
3279000240,20150330T000000,232500,3,2,1370,9760,1110,260
1402000070,20140520T000000,390000,4,2.25,1770,33132,1190,580
1562200240,20140918T000000,550000,3,2.25,2160,15360,1410,750
3904921070,20140812T000000,590000,4,2.5,2340,8971,2340,0
4045500510,20140521T000000,420850,1,1,960,40946,960,0
8849300160,20150205T000000,345000,4,2.5,2280,8190,1390,890
4123810140,20150227T000000,429800,3,2,1970,7000,1970,0
2473251170,20140626T000000,302000,4,1.75,1530,17664,1530,0
6430500186,20141104T000000,800000,4,1.5,1790,3952,1790,0
4136950140,20141215T000000,250000,3,2.5,1700,6000,1700,0
1370802650,20140729T000000,605000,3,2,2660,4500,1330,1330
1721069036,20140529T000000,412000,3,1.75,1950,52256,1950,0
8637100370,20141112T000000,252000,3,2,1340,5670,1340,0
8952900260,20140919T000000,375000,3,1,1130,12500,1130,0
1972202080,20140710T000000,725000,2,1.75,1950,2719,1010,940
9476200350,20141013T000000,471750,5,3.5,3790,8200,2120,1670
1523069204,20141208T000000,490000,4,2.25,2020,85813,2020,0
2856100125,20141001T000000,439000,2,1,800,5100,800,0
2968800626,20140822T000000,355000,4,2,1770,8890,1770,0
2129700320,20150505T000000,250000,1,0.75,940,87120,940,0
8965500320,20150326T000000,780000,4,2.25,2260,16188,2260,0
952005224,20141105T000000,409000,2,1,890,3271,890,0
4443801160,20140610T000000,420000,2,1,860,3880,860,0
5101404170,20141113T000000,200000,1,0.75,680,9600,680,0
1241500350,20150105T000000,830000,2,1.5,2130,35679,2130,0
4379400560,20140529T000000,695000,3,2.5,2390,4555,2390,0
629810350,20140521T000000,815000,4,2.75,3488,9614,3488,0
5466400550,20141113T000000,210000,3,1.75,1260,6223,820,440
3619600132,20140915T000000,635000,3,1.75,2940,6000,1590,1350
4113800550,20140721T000000,562500,4,2.5,2440,7322,2440,0
7298020240,20140509T000000,402500,4,2.5,2600,11951,2600,0
434000030,20141219T000000,555000,3,2,2080,7020,1040,1040
1138000830,20140909T000000,310000,3,1,1990,7173,1990,0
8568000070,20140905T000000,500000,4,2.5,2840,18001,2840,0
8822901200,20140723T000000,430000,6,3,2630,8800,1610,1020
1118002090,20140628T000000,1.60E+06,3,4.25,2820,7200,2460,360
3856901525,20141001T000000,627500,4,1,1560,4080,1560,0
1180500070,20141124T000000,335000,4,2.5,2330,7050,2330,0
7856560320,20150317T000000,962000,4,2.25,3320,20100,1810,1510
5103900045,20140725T000000,299000,3,1.75,1730,14270,1730,0
8562890370,20150414T000000,399950,4,2.5,3110,5868,3110,0
8807600340,20150325T000000,322000,3,1,1230,9660,1230,0
993002325,20140623T000000,430000,2,1.5,950,4625,950,0
1022059082,20140508T000000,307000,3,1.75,1890,13860,1890,0
179000350,20141105T000000,194000,3,1.5,1010,5000,1010,0
3915500045,20141114T000000,180000,3,1,1010,8581,1010,0
3578400030,20140718T000000,465000,4,2.25,2340,13383,1170,1170
9346700320,20150323T000000,722500,4,2.5,2460,9296,2460,0
3856901715,20140924T000000,470450,2,1,1010,3400,1010,0
8700120520,20150127T000000,280000,3,2.5,1650,6000,1650,0
7335400400,20150410T000000,176250,4,2,1440,6702,1440,0
4319200505,20140617T000000,560000,5,1,1710,9100,1320,390
1426049083,20141022T000000,830000,3,2.5,2760,11287,2000,760
7795400046,20140611T000000,276900,2,1,1350,10096,1350,0
1337800045,20141001T000000,625000,3,1.75,1660,4800,1660,0
2207500695,20150304T000000,1.02E+06,4,2.5,2960,4760,2160,800
1112000125,20140930T000000,463500,1,1,1090,8750,1090,0
2472930270,20140905T000000,485000,3,2.5,3110,9015,3110,0
5651500140,20140617T000000,272000,3,2,1380,7476,1380,0
7203102080,20141217T000000,305000,2,1,1290,3140,1290,0
3626500045,20140626T000000,760000,3,2.5,1980,13964,1980,0
3226049117,20150213T000000,387500,2,1,870,6126,870,0
6699940140,20140908T000000,352000,4,2.5,2470,5015,2470,0
7702600160,20140709T000000,507000,3,1.75,2140,40098,1490,650
5379804730,20140718T000000,156000,3,1,770,9750,770,0
3383900058,20141118T000000,580000,3,3.25,1490,857,1220,270
629600030,20140714T000000,630000,4,2.5,2510,35020,1610,900
1823049171,20141218T000000,275000,5,1.5,1950,9000,1130,820
3760500516,20140724T000000,835000,5,4,3600,14720,1800,1800
2641400160,20141205T000000,340000,4,2.5,2380,7850,2380,0
534000075,20140506T000000,329350,2,1,720,6687,720,0
3892500070,20140728T000000,1.48E+06,3,3.5,4070,26000,4070,0
224069084,20150325T000000,475000,3,1,1250,150117,1250,0
2767600400,20141118T000000,719950,3,2.25,2190,2416,2190,0
5347200160,20140512T000000,235000,1,1,810,2451,810,0
9553200125,20150331T000000,875000,3,1.5,2440,5750,1320,1120
5379804888,20150421T000000,380000,4,1.75,1740,9150,1740,0
421079105,20150309T000000,325000,3,2.25,1480,97138,1480,0
4215250030,20140819T000000,475000,4,2.5,2120,57050,2120,0
2420069017,20150324T000000,152900,1,1,900,4368,900,0
2414600400,20140805T000000,210000,2,2,1190,7570,1190,0
2461900510,20140926T000000,350000,4,1,1010,6000,750,260
7695500200,20150323T000000,505000,3,2.5,2100,17882,2100,0
251200200,20140627T000000,464900,4,2.25,2020,8424,1380,640
513000550,20140922T000000,650000,3,2,2520,5980,1790,730
8730000260,20150504T000000,369950,2,2.75,1370,1140,1080,290
3395040550,20140728T000000,250000,3,2.5,1530,2890,1530,0
3395040550,20150429T000000,320000,3,2.5,1530,2890,1530,0
9471200200,20150325T000000,2.53E+06,4,4.25,5040,16048,3420,1620
5469700260,20140903T000000,340000,4,2.25,2530,24700,2530,0
2767600171,20140519T000000,440000,2,1.5,1010,1968,1010,0
898000200,20150402T000000,219950,3,1,1200,7727,1200,0
5315100806,20140915T000000,940000,4,3,2720,11740,2720,0
9269200786,20140722T000000,399950,4,1.5,1850,6125,1110,740
1118001370,20150102T000000,1.57E+06,3,2.75,2340,8828,2340,0
3558910640,20150401T000000,528000,4,1.75,1860,9750,1460,400
3761100341,20140828T000000,545000,4,1.75,1940,8990,1560,380
8682261070,20150427T000000,575000,2,2,1680,6194,1680,0
8732040810,20141104T000000,235000,4,2.75,1770,10184,1250,520
2991000400,20140723T000000,272000,3,2.5,1790,6371,1790,0
2155500030,20150428T000000,380000,4,1.75,1720,9600,1720,0
5727500102,20150426T000000,195000,3,1,1280,6967,1280,0
5104510370,20141014T000000,297000,3,2.5,1690,4988,1690,0
1895450200,20150415T000000,349000,4,2.5,2190,7294,2190,0
8122101146,20140929T000000,320000,2,1,710,5200,710,0
7789900030,20140725T000000,319990,4,1.5,1890,10707,1890,0
6893300350,20140602T000000,439900,2,2,1410,12282,1410,0
4073800140,20140811T000000,429000,3,3.25,2210,3600,1820,390
538000030,20140730T000000,272500,3,2,1540,6250,1540,0
6632300478,20140916T000000,400000,4,2,1350,7255,1350,0
4083800340,20150402T000000,462000,5,2,1380,4300,1380,0
9214400135,20150310T000000,510000,2,1,890,6095,890,0
8944600200,20140623T000000,550000,3,2.5,1900,3255,1900,0
8651430370,20150425T000000,150000,3,1,1240,5200,1240,0
2296700260,20140626T000000,460000,3,2.5,1730,8490,1210,520
3066400140,20140620T000000,632500,4,2.5,2090,10306,2090,0
1771100240,20140925T000000,361000,3,1.75,1650,11220,1650,0
461003251,20140801T000000,437000,3,2.25,1130,1221,1030,100
8699100240,20150505T000000,370000,6,2.75,3240,5750,2160,1080
8691350200,20150417T000000,884250,4,2.5,3840,12151,3840,0
2525300550,20140603T000000,225000,3,1,1200,9936,1200,0
7452500045,20140805T000000,235000,2,1,870,5000,870,0
2489200070,20140720T000000,767500,6,3.5,2410,6000,2220,190
3623500260,20140512T000000,1.20E+06,3,1.75,1560,8078,1560,0
425069104,20141215T000000,715000,3,2.5,2410,46609,2410,0
2239800070,20140627T000000,417000,4,2.25,2300,7700,1380,920
2618300350,20140718T000000,199000,3,1,1390,12145,1390,0
1336800160,20140605T000000,875000,5,2.5,2920,5568,2320,600
7519000570,20141110T000000,545000,4,1.5,1370,3708,1370,0
257000105,20140520T000000,192500,2,1,950,7692,950,0
4401200350,20150210T000000,822500,3,2.5,3090,7708,3090,0
6402300070,20141208T000000,800000,4,2.5,2390,10000,1590,800
5317100570,20141215T000000,1.25E+06,3,2.5,2070,4944,2070,0
8106100105,20141114T000000,3.85E+06,4,4.25,5770,21300,5770,0
9407150240,20141001T000000,295000,3,2.5,1460,7936,1460,0
8682291940,20140630T000000,419000,2,1.75,1510,4980,1510,0
4139420070,20140910T000000,1.20E+06,5,3.25,5180,19606,2610,2570
629400340,20141222T000000,750000,4,2.75,3430,13907,3430,0
3380900160,20150428T000000,502000,4,1.5,1700,8400,1700,0
2175100270,20140604T000000,1.03E+06,3,1.75,2640,8000,1320,1320
3448000270,20150313T000000,398500,3,1,1200,15960,1200,0
8701600510,20150414T000000,700000,2,1.5,1850,4945,1850,0
6083000083,20140611T000000,248000,5,1.5,1510,9078,1510,0
9178600135,20140826T000000,800000,4,2,2130,2800,1070,1060
1721059286,20150121T000000,383000,4,2.5,2640,8055,2640,0
8161600135,20140527T000000,688000,4,3,3000,4000,1970,1030
2568300132,20141008T000000,521000,3,2,1870,5455,1060,810
6414100111,20141105T000000,365000,2,1,990,9223,990,0
9818700320,20141007T000000,491000,3,2,2005,7000,1605,400
686200510,20141122T000000,643000,3,2.75,2030,7700,1400,630
3279000370,20150202T000000,279000,3,2.5,1500,7350,1060,440
2767601031,20150202T000000,583500,4,1,1530,3900,1530,0
4142450510,20140723T000000,310000,3,2.5,1990,3600,1990,0
3291800510,20140610T000000,310000,3,1.75,1420,7650,1100,320
7893203450,20150323T000000,280000,3,1,1400,13975,1400,0
908000260,20141117T000000,272000,4,2.5,1870,5692,1870,0
3225069239,20140707T000000,870000,4,3,3040,36246,2680,360
8645540320,20141118T000000,307000,3,2,1790,7259,1390,400
9280200030,20140717T000000,490000,2,1.5,1590,4500,920,670
6159400030,20141008T000000,399950,3,2,2050,9396,1170,880
7787400030,20140609T000000,1.64E+06,5,3.5,4220,26784,2110,2110
1888120140,20140709T000000,989000,5,4.5,4030,13474,4030,0
2916620240,20140618T000000,264950,4,1.75,1770,9011,1050,720
251200240,20140725T000000,491500,4,2.75,2100,7236,1400,700
7695500240,20140514T000000,345000,3,2.25,2120,15003,2120,0
7749500070,20150119T000000,339900,4,1.75,2600,18042,2020,580
6762700340,20150427T000000,852000,3,3,2400,4000,1860,540
824069121,20141222T000000,585000,5,3.5,3180,40946,1690,1490
2600100370,20150211T000000,723000,4,2,2790,8793,1640,1150
2326059082,20150126T000000,594000,3,2.25,2080,70567,2080,0
2591010240,20141201T000000,405000,2,1.5,1370,4102,1370,0
1085610030,20140801T000000,725500,4,2.5,2790,74495,2790,0
9551202025,20140625T000000,800000,2,1,1740,5719,1740,0
4379600030,20140729T000000,1.33E+06,3,3.75,6400,76665,3810,2590
4345000510,20141015T000000,180500,3,2.5,1800,8518,1800,0
4345000510,20150428T000000,325000,3,2.5,1800,8518,1800,0
3327000140,20140617T000000,235000,3,1.75,1190,7280,1190,0
7100000135,20140520T000000,330000,2,1,860,8308,860,0
2483200060,20140612T000000,678500,3,2,2460,6600,1370,1090
2592400550,20140709T000000,463000,4,2.5,1980,6660,1980,0
2113701200,20140912T000000,250000,2,1,670,4640,670,0
5249804510,20140716T000000,655000,3,2,1410,4800,1410,0
9264901040,20140516T000000,239900,4,2.25,1860,7000,1120,740
7967600069,20141117T000000,185000,3,1,980,9135,980,0
4219400520,20140616T000000,1.74E+06,4,2.25,3040,5000,2080,960
3810000202,20140905T000000,251700,3,2.25,1810,11800,1240,570
1226039129,20150209T000000,400000,4,2,1560,8250,1320,240
8146100370,20140904T000000,735000,4,1.75,2100,7960,1340,760
1224059053,20141027T000000,1.70E+06,5,2,2500,15250,2500,0
1623049041,20140508T000000,82500,2,1,520,22334,520,0
98020140,20140708T000000,765000,4,4,3010,7221,3010,0
9510900070,20140923T000000,292500,4,1.75,2140,8162,1420,720
2473381090,20150325T000000,270000,3,2.25,2390,7000,1990,400
6378500105,20141224T000000,415000,2,1,1510,6807,1090,420
3861400030,20141124T000000,950000,4,1.75,2210,19025,1460,750
705700640,20140916T000000,353000,3,2.75,2170,8396,2170,0
2767603210,20141210T000000,670950,3,2.5,1790,2375,1790,0
3294700030,20140509T000000,280950,3,1.75,1390,8700,840,550
7524950830,20140527T000000,585000,3,1.75,1850,7735,1850,0
2124069078,20141211T000000,525000,2,1.5,1480,43645,1480,0
5728000060,20140801T000000,605000,3,1.75,1850,8823,1370,480
2880100160,20141119T000000,1.01E+06,4,3.5,3350,3752,2550,800
4435000520,20140926T000000,245990,3,1,1040,8410,1040,0
8856900310,20150203T000000,535000,4,2.25,2810,12607,2810,0
4315700390,20140630T000000,410000,1,1.5,1010,5750,1010,0
2095800520,20150424T000000,550000,3,2.5,2250,7752,2250,0
4193500140,20140911T000000,665000,3,1.75,1800,8000,1800,0
3582200200,20150427T000000,455000,3,1,2400,17239,1890,510
9521100106,20140826T000000,440000,4,1,1780,4000,1780,0
7351000160,20140708T000000,332000,3,2.25,2120,14915,1720,400
5422420140,20140611T000000,280000,3,2.5,1860,6607,1860,0
7234601162,20140915T000000,570000,3,3.5,1460,1021,1150,310
6623400217,20140515T000000,250000,3,1,1230,10350,1230,0
3354400060,20150501T000000,238000,2,1,1088,8453,1088,0
408100105,20141103T000000,265000,3,1,800,5760,700,100
7297700055,20150305T000000,306000,3,1,1190,10350,1190,0
8029740060,20150507T000000,345000,5,2.75,1940,4182,1240,700
1355200060,20140904T000000,765000,4,2.5,3300,10764,1720,1580
4136890560,20150430T000000,346300,4,2.5,2590,11018,2590,0
1320069271,20140612T000000,342500,3,2,2080,11375,2080,0
9269260240,20150424T000000,501000,4,2.25,2680,5439,2680,0
1796381070,20140625T000000,270000,3,2.5,1670,8364,1300,370
6840701125,20150422T000000,638000,3,1,1830,4400,1720,110
7443000640,20140912T000000,460000,3,1.75,1400,2003,700,700
6344000060,20141015T000000,760000,4,1.75,2770,8521,1470,1300
3317500030,20150316T000000,1.09E+06,3,2.5,3630,11019,2150,1480
2130702270,20140628T000000,234000,3,1,1040,8128,1040,0
3343301920,20150302T000000,1.65E+06,3,2.75,2690,8890,2690,0
2688100075,20140506T000000,488000,5,2,2020,5000,2020,0
6448600060,20150226T000000,1.55E+06,5,2.5,2450,20805,2450,0
6619510060,20150327T000000,499000,4,3,2030,12675,2030,0
4058802105,20140904T000000,150000,3,1,1450,6776,1450,0
7212660640,20150326T000000,333000,4,2.5,2400,7270,2400,0
8026700105,20150218T000000,700000,4,2.75,2870,8625,1860,1010
8018600640,20140918T000000,275000,4,1,1340,22500,1340,0
623049315,20140701T000000,330000,3,2.5,1680,11312,1080,600
6632900340,20141124T000000,360000,4,2,1850,8827,1850,0
6798100070,20150511T000000,467000,3,1,1220,8040,1220,0
8644400060,20141029T000000,568000,3,2.5,2320,57063,1790,530
4388600030,20141103T000000,605000,5,2.25,3220,9603,3220,0
629420260,20141002T000000,750000,4,2.75,3190,9023,3190,0
1117200550,20141014T000000,760000,3,2.75,3530,69834,3530,0
7461420060,20140804T000000,265000,3,1.75,2050,10519,1240,810
5566100060,20140718T000000,490000,3,1.75,1720,12540,1720,0
7714000340,20140619T000000,360000,4,2.5,2850,4650,2850,0
5149300400,20150206T000000,311750,4,2.25,2270,12000,1290,980
3815500045,20141003T000000,399000,3,2.25,1880,12473,1420,460
1843100520,20140725T000000,347000,4,2.5,2770,9751,2770,0
1329000030,20140904T000000,1.68E+06,4,3.75,4490,34982,4490,0
7853240560,20140903T000000,585000,4,2.5,3110,6479,3110,0
8078100260,20140912T000000,340000,4,2.5,2360,7475,2360,0
3905120830,20150415T000000,612000,3,2.5,2180,5496,2180,0
1442800400,20140628T000000,230000,2,1.75,1910,3376,1910,0
3905000200,20140509T000000,604000,4,2.5,2260,7753,2260,0
4399200075,20140703T000000,250000,3,1.75,1770,8868,1770,0
1545802830,20150309T000000,258500,3,2,1460,7930,1460,0
1370804100,20150324T000000,783000,4,2.75,2080,5000,1470,610
269000240,20141030T000000,1.05E+06,5,2.25,2960,7680,1550,1410
2619920030,20150318T000000,760000,4,2.5,3220,4031,3220,0
3438500339,20140526T000000,276000,3,1,1140,5000,1140,0
8563001070,20150323T000000,550000,4,2,1660,12377,1660,0
4427100105,20150428T000000,398000,4,1,1430,6240,1430,0
2767800140,20150313T000000,775000,3,3,1820,4300,1620,200
2600140070,20150409T000000,1.03E+06,4,3,3540,10202,2720,820
7231501610,20141023T000000,327000,4,1,1620,6000,1620,0
2787250240,20150421T000000,564500,4,2.75,3100,14568,3100,0
5309100295,20141017T000000,782000,4,1.75,1500,6820,1500,0
2781260370,20150128T000000,398000,4,2.5,2820,5510,2820,0
1926059155,20150130T000000,257000,3,1.75,1850,10920,1850,0
7137900960,20140625T000000,235000,4,2,1570,9415,1570,0
2817100570,20140627T000000,453000,4,2.75,2300,37533,1550,750
3886902445,20150316T000000,535000,2,1,920,9000,920,0
2215902010,20140507T000000,275000,3,2.5,1600,7000,1600,0
1778350270,20140915T000000,665000,3,2.5,2630,10047,2630,0
1449000270,20140806T000000,670000,4,2.75,3020,13530,1540,1480
3755100520,20150427T000000,465000,3,1.75,1490,10757,1060,430
8651441620,20141023T000000,210000,3,1.5,1160,5200,1160,0
1321970240,20141204T000000,265000,4,2.5,2040,4443,2040,0
6816300060,20150413T000000,426000,2,2.5,1550,2657,1550,0
8563000520,20141029T000000,529219,4,2.25,1990,7610,1290,700
3663000070,20140708T000000,600000,3,2.25,1900,46609,1440,460
255400070,20140701T000000,875000,5,3.5,3840,8279,3840,0
269000070,20150106T000000,608000,4,3,2400,7680,1200,1200
1163400070,20141112T000000,220000,3,1,1660,21514,1660,0
4139420370,20140811T000000,1.76E+06,4,5,6055,21630,3555,2500
2599200160,20140818T000000,295450,3,2,2030,17120,1890,140
1704900135,20141111T000000,315000,2,1,840,5087,840,0
6648701420,20150213T000000,205000,4,2,1450,8175,1450,0
6123000070,20140709T000000,310000,3,1.5,1460,9908,1460,0
7015200136,20150503T000000,1.00E+06,5,1,2010,5210,1890,120
5104531820,20140602T000000,525000,4,2.5,2910,7631,2910,0
6620400631,20140709T000000,284000,4,1.75,1880,8800,1130,750
3582500240,20140514T000000,510000,3,1.75,2170,26460,1450,720
1529300160,20140619T000000,405000,2,1,1260,4377,1260,0
4027700844,20140916T000000,509950,3,2.5,1970,9153,1970,0
425069139,20141027T000000,600000,4,2.25,2090,45738,2090,0
3047700105,20150423T000000,990000,4,3.75,3450,4940,2570,880
2976800550,20150414T000000,280005,3,1.5,1130,7200,1130,0
6151800070,20140903T000000,700000,3,1.75,2600,7668,1300,1300
4364700105,20140804T000000,330000,3,1,1030,7620,1030,0
7893804845,20150223T000000,340000,2,1,1700,6718,1230,470
7694800070,20140818T000000,468000,2,2.5,1480,2167,1390,90
1922000070,20140609T000000,1.34E+06,4,2.5,4250,19387,3260,990
4035900060,20140919T000000,515000,3,1.75,1600,20873,1600,0
8880600070,20141112T000000,245000,4,2,1870,8750,1870,0
739800070,20140527T000000,265000,3,2.5,1440,7741,1000,440
1561910270,20150317T000000,372400,3,2.5,2720,11937,2720,0
7305300370,20150504T000000,390000,3,1.5,1240,8410,1240,0
7345000340,20150203T000000,208000,3,1,1020,6120,1020,0
3971701455,20141003T000000,273000,2,0.5,1180,7750,590,590
8035350260,20141009T000000,455000,5,3.5,3080,7759,2310,770
104550520,20150330T000000,270000,4,2.5,1750,6397,1750,0
4037400295,20140730T000000,618000,4,2.25,2530,8736,1210,1320
5413200140,20141021T000000,213550,3,2.5,1580,8541,1580,0
522049104,20140729T000000,210000,5,1.75,2340,9148,2340,0
3859900060,20150112T000000,2.75E+06,5,4,6300,16065,4360,1940
6145601715,20141215T000000,403500,4,2.75,2400,3844,1200,1200
1645000310,20150225T000000,235000,3,1.5,1300,7600,1300,0
7471900045,20150421T000000,287500,3,2,1760,7147,880,880
7697100030,20140929T000000,546800,4,1.5,1520,5910,1020,500
3313600340,20140616T000000,183000,3,1.75,1070,8100,1070,0
1921069082,20140512T000000,560000,3,2,2560,216777,2560,0
4263200030,20141205T000000,299500,3,1,1280,6726,1280,0
6918700370,20141027T000000,610000,4,2.25,1660,7350,1660,0
8125200483,20140609T000000,288350,3,1.5,1860,7963,1200,660
1930301555,20140701T000000,500000,2,1,950,4500,850,100
7974200776,20141205T000000,625000,4,2.75,2140,4000,1190,950
2719100013,20150429T000000,418000,2,1.5,1480,1349,1240,240
7234601544,20140825T000000,660000,3,3,2260,1825,1660,600
5652601455,20140623T000000,775000,4,2.5,2300,6158,2300,0
2558600060,20150123T000000,429500,3,2.75,1650,7272,1230,420
5017000575,20141124T000000,569000,3,2,1990,3000,1230,760
2796100160,20140520T000000,250000,4,2,1960,7560,1160,800
5470100270,20141209T000000,225000,3,1.5,1310,10491,1310,0
6112300140,20140514T000000,530000,4,2.75,2450,15002,2450,0
4024101715,20140905T000000,306000,3,1,910,8658,910,0
3205100060,20150413T000000,517100,3,1.75,1580,9719,1580,0
4450700030,20140822T000000,354950,3,1.75,1780,9689,1130,650
7920100083,20150414T000000,348000,3,1.5,1040,1824,1040,0
1774350160,20140718T000000,522250,4,2.5,2340,41600,1640,700
2115510340,20140604T000000,275000,3,2.5,1720,8755,1000,720
8901000445,20141218T000000,390000,3,1.5,1600,10440,1600,0
6121800060,20140910T000000,260000,3,1.5,1320,9750,1320,0
8712100320,20140728T000000,585000,5,2.75,2350,4178,1520,830
2979800520,20140603T000000,605000,5,2.75,2740,5616,1670,1070
2331540070,20140703T000000,342000,4,2.5,2300,6448,2300,0
6345000160,20140827T000000,900000,5,3,4350,37169,2950,1400
5126950340,20150330T000000,252000,3,1.75,1430,7700,980,450
5152100160,20150219T000000,357000,3,1.75,2400,14012,2400,0
3298201290,20141224T000000,370000,3,1,940,7910,940,0
428000055,20150406T000000,322500,3,1,1020,13504,1020,0
8698600055,20140620T000000,210000,2,2,1680,5756,1680,0
3034200885,20141208T000000,290000,2,1,1340,9840,1340,0
2538400060,20140612T000000,860000,4,3.25,3960,7012,3960,0
3145600045,20150225T000000,302000,6,2,2650,4621,2650,0
7183000070,20140821T000000,369160,4,2.25,2120,9680,2120,0
6788200800,20150507T000000,1.19E+06,4,2.75,2850,3000,2530,320
824059083,20140902T000000,993000,4,2,2850,14810,2490,360
2724069117,20141114T000000,380000,6,2,1870,6969,1870,0
9157600060,20140910T000000,635000,4,2,2660,8160,1380,1280
943100262,20141030T000000,260000,3,1,1190,11120,1190,0
3810000465,20140520T000000,243000,2,1,1770,5522,960,810
2451000070,20150402T000000,1.40E+06,4,2.5,2770,8879,2770,0
7640400070,20140915T000000,665000,4,2.5,2080,8100,1220,860
7732410370,20140909T000000,898000,5,2.25,2700,9000,2700,0
3253500030,20140725T000000,583000,4,2.75,2200,9453,1100,1100
2128000160,20141204T000000,429000,4,1.75,2160,7700,2160,0
3764650070,20141216T000000,471000,3,2.5,2010,4059,2010,0
1118000465,20150312T000000,1.81E+06,3,3.5,3780,8295,2430,1350
2622059062,20141015T000000,739500,3,3.25,4460,51177,4460,0
2211700160,20140512T000000,450000,3,1.5,1770,17208,1160,610
9376301180,20150408T000000,552500,3,1,1430,5000,1430,0
2203500570,20150217T000000,437000,4,1.75,1700,10642,850,850
3634100030,20150109T000000,270000,4,2,1830,5220,1830,0
2599200830,20140716T000000,226740,3,1.5,1410,8800,1410,0
4140090370,20150218T000000,446500,4,2.5,3060,7920,1810,1250
2320069083,20141125T000000,283000,3,2,1820,15068,1520,300
6893300295,20140715T000000,445000,4,1.75,2430,13211,2430,0
7454000030,20140816T000000,250000,2,1,740,6840,740,0
7454001090,20150309T000000,307000,3,1,770,6552,670,100
2944500340,20140721T000000,315000,4,2.75,2200,8580,1860,340
2346800270,20150106T000000,555000,3,3,2920,23085,1540,1380
2796100640,20150424T000000,264900,4,2.5,2040,7000,1250,790
993000046,20140922T000000,510000,3,2,1600,4510,990,610
2333230270,20140814T000000,328000,4,2.5,1990,3980,1990,0
5104510340,20150504T000000,358000,4,2.5,1830,7308,1830,0
2517000700,20150421T000000,325000,3,2.5,2540,4260,2540,0
1724069062,20140714T000000,1.37E+06,2,3.25,2700,3444,2700,0
5556800260,20150305T000000,230000,4,2,1440,10800,1440,0
2771603610,20150423T000000,545000,3,2,1550,4000,940,610
3629910240,20140505T000000,705380,3,2.5,2490,4343,2490,0
5634500036,20140820T000000,459000,5,2.5,2650,12987,1350,1300
2887703066,20140528T000000,815000,4,2.25,2000,3800,2000,0
3185600055,20140611T000000,495000,6,5,3440,4500,3280,160
1421069159,20141110T000000,520000,3,2.5,2280,58712,2280,0
476000335,20141217T000000,430000,2,1.5,1320,1194,1320,0
251300260,20140515T000000,255000,4,2.5,2070,7800,2070,0
2887700140,20140707T000000,588000,3,2,1860,4777,1860,0
3298201170,20141110T000000,350000,3,1,940,7811,940,0
2024059084,20150313T000000,625000,4,2.75,2290,21486,2290,0
7229700105,20150424T000000,172500,2,2,1510,20685,1250,260
2313900560,20140825T000000,554000,3,2,1830,3500,1290,540
6192400400,20140728T000000,775000,4,2.5,3090,7112,3090,0
1425069116,20141107T000000,1.19E+06,4,3.5,4340,217800,4340,0
3582900200,20141028T000000,618000,3,2.75,3200,12682,3200,0
243000335,20140929T000000,305000,4,1,1560,8450,1560,0
7760400350,20141205T000000,232000,3,2,1280,13356,1280,0
128500260,20140508T000000,262000,4,2.5,2020,6236,2020,0
1697000370,20150325T000000,234000,3,1,1040,8122,1040,0
8902000267,20150402T000000,500000,4,2.75,2260,7209,1330,930
1218000030,20140827T000000,278000,3,1,860,7632,860,0
6099400140,20140904T000000,230000,5,1,1920,19040,1160,760
5710600030,20140922T000000,500000,4,1.75,2290,9215,1270,1020
7304300570,20140519T000000,366500,4,2.75,2070,9300,1120,950
1702901180,20140611T000000,665000,6,3,4250,4400,3020,1230
3508100135,20150316T000000,1.10E+06,3,1.5,2220,4830,1790,430
4443800030,20141201T000000,575000,2,1.75,1840,4076,1140,700
2553300140,20141103T000000,674750,4,2.5,2590,9753,2590,0
4154300465,20140916T000000,719000,5,2,3110,6131,1560,1550
3623029045,20140925T000000,482000,3,1.75,2600,105587,1300,1300
9371700125,20140528T000000,254000,2,1,1060,8187,1060,0
4443800810,20140819T000000,443725,3,1.75,1250,3880,750,500
1330900570,20141106T000000,575000,4,2.5,2520,35636,2520,0
4017110200,20150127T000000,469000,3,2.25,2070,9957,1440,630
303000445,20140523T000000,175000,2,1,1300,44431,1300,0
7857003505,20140909T000000,437000,5,2,2190,8316,1390,800
4027701291,20140820T000000,550000,4,3,2760,13113,1760,1000
3831200200,20150420T000000,172040,3,2.25,1710,7134,1130,580
4123830070,20141224T000000,363000,3,2,1750,7000,1750,0
8946750140,20150430T000000,282000,3,2.25,1552,3600,1552,0
7129300400,20140814T000000,400000,6,2,2350,6554,2000,350
2126059234,20140924T000000,650000,5,3.5,5110,10018,3850,1260
621069074,20140603T000000,365000,3,2.5,1720,99916,1720,0
7879600070,20141024T000000,269950,4,2.5,1960,7230,1960,0
6151800486,20140718T000000,260000,2,1,1270,19602,1270,0
8581200160,20141024T000000,193000,3,1.5,1180,7000,1180,0
2395710070,20140725T000000,340000,4,2.25,2230,6791,2230,0
6669100070,20140512T000000,900000,4,3.25,4700,38412,3420,1280
8856920070,20141021T000000,371000,3,2.5,2150,8361,2150,0
323089084,20140827T000000,592000,3,2.5,2400,81892,2400,0
798000342,20140815T000000,300000,3,2.5,1830,12750,1830,0
5104511840,20140827T000000,449950,4,3,2800,6977,2800,0
5205000400,20141022T000000,299500,3,2.5,2090,7163,2090,0
8565900160,20150326T000000,995000,4,2.25,2340,13406,2340,0
4302700445,20140923T000000,335000,4,1.75,1670,9472,1100,570
2413300240,20141110T000000,280000,4,2.25,1990,7350,1180,810
9477201620,20140516T000000,446000,4,2.25,2270,7800,1290,980
3395000070,20140927T000000,1.54E+06,4,2.75,4910,15139,2560,2350
3336000791,20150407T000000,325000,3,1,950,4500,950,0
1087700030,20140619T000000,450000,3,1.75,1610,11200,1610,0
8856970570,20141027T000000,322500,4,2.5,1940,7107,1940,0
2206700295,20140915T000000,453000,3,1,1210,9473,1210,0
293910030,20141008T000000,655000,4,2.5,2570,4412,2570,0
9547205660,20150504T000000,603000,3,2.25,1700,2800,1150,550
8856004400,20140902T000000,235000,4,1,1610,24000,1610,0
3888100128,20140728T000000,968933,4,3.5,4120,7304,3070,1050
8562900240,20141114T000000,1.02E+06,3,3.5,2880,11340,1690,1190
1088000030,20141203T000000,435000,4,2.25,1990,8548,1990,0
1545800640,20140618T000000,242000,3,2,1260,8092,1260,0
3020079078,20141027T000000,487000,6,3.25,4750,248600,4750,0
11520640,20140801T000000,810000,4,2.75,3010,10450,3010,0
3407700046,20140624T000000,625000,3,2.5,2410,64073,1820,590
7696600240,20141023T000000,165000,3,1.5,1280,7742,1280,0
3904100106,20150427T000000,335000,3,1,2320,6750,1160,1160
7849201600,20140724T000000,286700,3,1,1220,6600,1220,0
8924100111,20150424T000000,699000,2,1.5,1400,4050,1400,0
2221000070,20150327T000000,280000,3,1.75,1590,7280,1140,450
8078350030,20140602T000000,580000,4,2.5,2220,7064,2220,0
8682281710,20140620T000000,754800,2,2.5,2770,7781,2770,0
1383500070,20150210T000000,525000,4,2.5,2303,16801,2303,0
6744700181,20150217T000000,562000,3,1.75,1600,10530,1600,0
6728700075,20140520T000000,575000,4,1.75,1280,6060,860,420
3630180240,20140711T000000,808900,5,2.5,2900,5901,2900,0
2162000160,20150303T000000,992000,3,2.25,2950,15207,2070,880
705700140,20140919T000000,335000,3,2.5,1700,6698,1700,0
9423400193,20141226T000000,473000,3,2.75,1050,7200,1050,0
5137200140,20150325T000000,350000,4,2.75,2990,11210,1880,1110
5026900160,20150424T000000,1.60E+06,5,2.5,3100,5374,3100,0
4024101052,20141217T000000,305500,3,1,1240,6090,1240,0
1726069051,20140523T000000,306000,2,1,780,13500,780,0
6300000693,20141202T000000,233000,2,2.25,850,1656,850,0
6413100270,20150331T000000,490000,3,1.75,1540,9000,1540,0
7215420160,20140701T000000,445000,4,2.5,2280,42077,2280,0
7878400135,20141120T000000,355000,3,2.25,2550,9674,1850,700
2597710070,20150402T000000,360000,2,2,1770,7607,1770,0
9244900248,20140709T000000,737500,3,1.75,2320,10900,2320,0
824059277,20141215T000000,985000,3,3.5,2600,11920,2600,0
3278601940,20140806T000000,349950,2,3.25,1570,2031,1310,260
7853250160,20150220T000000,520000,4,2.5,3060,7161,2860,200
1163100070,20141217T000000,355950,4,2.5,1960,8540,1220,740
8106300510,20141229T000000,485000,5,2.5,3270,6129,3270,0
4239400960,20141212T000000,143000,3,1,1090,3315,1090,0
7524900003,20141210T000000,3.28E+06,2,1.75,6840,10000,4350,2490
3893100327,20140723T000000,355000,3,1,940,8512,940,0
7856640560,20140604T000000,1.13E+06,5,3.5,3880,13885,2540,1340
7206900075,20140818T000000,200000,5,1.75,1770,15525,1770,0
8691310070,20140618T000000,913000,4,2.5,3640,10576,3640,0
4389200796,20140522T000000,1.60E+06,3,2.5,3160,12824,1820,1340
7436300160,20140625T000000,409900,2,2.5,1590,1845,1590,0
7896300070,20150501T000000,265000,4,1,1290,6034,1050,240
2425059074,20150410T000000,740000,5,3,3655,51836,2174,1481
2111010340,20140612T000000,306000,4,2.5,2490,8124,2490,0
7852150140,20141007T000000,381000,3,2.5,1470,3999,1470,0
1370800830,20150505T000000,1.22E+06,3,3.25,3960,6132,2600,1360
7632400400,20150320T000000,1.05E+06,3,3.5,3190,29982,2630,560
5220300140,20140903T000000,408000,2,1,810,7440,810,0
2568200140,20140625T000000,739900,5,2.5,2980,5377,2980,0
1137300340,20141121T000000,674250,4,2.5,2780,35000,2780,0
7640400106,20140911T000000,438400,2,1,1340,8100,1340,0
2175100055,20141230T000000,1.70E+06,5,5,4930,14649,4160,770
9274200990,20140619T000000,703000,3,2,1360,5980,1360,0
5028600550,20141229T000000,262000,3,1.75,1320,6530,1320,0
1471630160,20150423T000000,353000,3,2,1210,14499,1210,0
9430110030,20150114T000000,500000,4,2.5,1940,7607,1940,0
9275700016,20140706T000000,1.28E+06,4,2.5,3160,4620,2020,1140
6654700240,20150408T000000,332000,4,2.5,1980,6566,1980,0
8563080270,20140821T000000,824000,4,2.5,2320,14240,1620,700
7548300326,20150220T000000,290000,4,2,1660,4788,1660,0
5457300696,20140627T000000,700000,3,2.5,1660,1545,1400,260
1175001125,20141006T000000,550000,2,1,1080,3420,780,300
3034200197,20140903T000000,549000,2,1,1510,11165,1510,0
7787400105,20150306T000000,1.87E+06,4,2.5,2950,43560,2550,400
9346700270,20150302T000000,858000,4,2.25,3070,13720,3070,0
6414600260,20141030T000000,345000,2,1,970,10423,970,0
2620069195,20141104T000000,340000,4,1.75,2140,11651,2140,0
1300301840,20150425T000000,1.22E+06,4,2.25,2570,9600,2570,0
4358700186,20141211T000000,275000,3,2.25,1260,1488,1260,0
259600560,20140827T000000,405000,3,1,1220,7771,1220,0
2634500070,20150116T000000,432500,3,2,1720,8145,1720,0
7186800105,20150112T000000,236500,4,1,2140,4217,1320,820
4459800070,20140718T000000,679000,4,1.5,1420,4923,1420,0
3034200370,20141031T000000,543000,4,2.5,2060,8451,2060,0
7887200390,20140926T000000,294000,3,1,1320,9520,990,330
2473390710,20150403T000000,340500,3,1.75,1810,10463,1810,0
2600140370,20140703T000000,1.01E+06,4,2.5,2980,16263,2980,0
7525100520,20140502T000000,335000,2,2,1350,2560,1350,0
6204200560,20140723T000000,425000,3,2,1540,8011,1540,0
5416100160,20150210T000000,353000,3,2.5,2510,9240,2510,0
3905040070,20150504T000000,540000,3,2.5,1670,5146,1670,0
8562900520,20140612T000000,640000,5,3.5,3690,11928,2540,1150
4027701182,20140722T000000,339950,3,1,1320,11457,1320,0
9407110710,20141107T000000,195000,3,1.75,1510,8400,980,530
9407110710,20150226T000000,322000,3,1.75,1510,8400,980,530
5160300030,20150401T000000,660000,4,1.75,1870,10450,1620,250
1000102,20140916T000000,280000,6,3,2400,9373,2400,0
1000102,20150422T000000,300000,6,3,2400,9373,2400,0
8945300200,20140815T000000,207500,3,1,1170,8816,1170,0
7796600070,20140825T000000,195000,3,1.5,1190,8726,1190,0
4443800765,20140610T000000,700000,3,2,2080,3880,1160,920
3298720030,20150417T000000,560000,4,1.75,2150,8555,1460,690
1781500435,20140820T000000,260000,3,1.75,1580,7344,1580,0
1781500435,20150225T000000,575000,3,1.75,1580,7344,1580,0
6979970140,20150417T000000,475000,3,2.5,2370,3239,1950,420
1005000036,20140613T000000,285000,3,1.75,1840,8601,920,920
3629921160,20140508T000000,753888,4,2.5,2660,5500,2660,0
3629910370,20150410T000000,650000,3,2.5,2190,3600,2190,0
5200100105,20140807T000000,620000,3,2.25,1660,3478,1100,560
1024069159,20150313T000000,526000,3,1.75,1780,37801,1300,480
418000310,20140514T000000,155000,2,1,700,5200,700,0
765000060,20140827T000000,342000,4,2,1570,11200,1120,450
2126079046,20150407T000000,390000,3,1.75,1220,216332,1220,0
2024079035,20140605T000000,685000,3,2.75,3150,219978,3000,150
7202270830,20140625T000000,608000,4,2.5,2690,4736,2690,0
133000070,20140916T000000,179900,2,1,680,6400,680,0
2818600060,20140904T000000,1.25E+06,6,3.25,3750,14150,2750,1000
6082400083,20150430T000000,166000,3,1,1010,11675,1010,0
9412900045,20140519T000000,462000,3,1.5,1710,4500,1410,300
3905030140,20140622T000000,545000,4,2.5,2090,6023,2090,0
7228501580,20150116T000000,415000,3,1,1560,4500,1560,0
6679000390,20140610T000000,269000,3,2.5,1560,4200,1560,0
1822500160,20141212T000000,356500,4,2.5,2570,11473,2570,0
6889000060,20141223T000000,225000,3,1,1010,7633,1010,0
835000055,20140620T000000,175000,2,1,1020,5130,1020,0
7811210320,20140801T000000,549000,5,2.5,1710,9720,1710,0
3123049320,20150415T000000,535000,3,2.75,2300,12197,2300,0
4123400320,20140505T000000,627000,4,2.25,1990,7712,1210,780
4477000270,20140822T000000,565000,3,2,2730,15677,2730,0
3126049094,20141112T000000,392450,4,2,2195,2681,1060,1135
8682282180,20140923T000000,509000,2,2,1560,4675,1560,0
1232000810,20140912T000000,340000,3,2.5,1400,4800,1200,200
1232000810,20150326T000000,537000,3,2.5,1400,4800,1200,200
8691330310,20140505T000000,865000,4,3,3690,9892,3690,0
3996900295,20141214T000000,358000,2,1,1140,8340,1140,0
117000003,20140919T000000,595000,4,2.25,1920,3225,1300,620
1471590060,20140619T000000,661000,4,2.5,2496,8058,2496,0
2558650200,20140916T000000,419950,3,2.25,2280,8500,1680,600
5104531580,20150416T000000,490000,4,3.5,3200,6420,3200,0
6021503570,20140918T000000,525000,2,1,880,4000,880,0
1862400517,20140813T000000,350000,3,2,1320,1298,1320,0
2738650030,20150511T000000,552500,3,2.5,2450,3582,2450,0
5560000710,20150327T000000,210000,3,1,1040,8970,1040,0
7215410320,20150311T000000,390000,3,2.5,2480,53250,2480,0
3971700510,20150129T000000,336800,5,1.75,1830,16650,1610,220
7202330270,20150303T000000,465000,3,2.5,1440,4473,1440,0
9542830160,20141218T000000,299900,4,2.5,1580,3632,1580,0
3630120960,20140718T000000,715000,3,3.25,3230,5000,3230,0
3622059155,20140523T000000,235000,4,2.5,1810,39639,1230,580
1687000240,20141210T000000,276000,3,2.5,2495,4400,2495,0
4322300340,20150112T000000,265000,4,1.5,1740,12728,1180,560
3797000830,20140530T000000,425000,3,1.75,1680,3000,840,840
4137060270,20150105T000000,313000,4,2.5,2460,10320,2460,0
7277100640,20150409T000000,715000,3,2.5,3050,6000,1720,1330
1312920060,20141212T000000,265000,3,2.25,1630,10969,1630,0
1472330030,20150324T000000,646000,3,2.75,2460,6413,2460,0
2973800030,20140721T000000,175000,3,1,1030,6600,1030,0
5152920070,20140731T000000,649000,3,2.5,3410,13809,2450,960
2021200058,20150423T000000,785000,3,2.75,2310,5200,1520,790
9828202255,20140922T000000,890000,4,2.75,2610,4400,1260,1350
2126059276,20141126T000000,612000,3,3,2330,10327,2330,0
7796450340,20141205T000000,330000,4,2.5,2980,5674,2980,0
1449000260,20141112T000000,493000,3,2.25,1790,11393,1790,0
8722100570,20150403T000000,1.60E+06,4,2.25,2940,5735,1470,1470
7856400240,20140627T000000,1.62E+06,4,3,3900,9750,2520,1380
7856400240,20150211T000000,1.65E+06,4,3,3900,9750,2520,1380
3037200060,20140926T000000,499000,3,2.5,1750,2150,1230,520
6071700160,20140623T000000,603500,6,2.75,2660,8400,1550,1110
7645900055,20140624T000000,530000,2,1.5,1580,3680,1280,300
292000070,20150406T000000,895000,5,2.5,2350,14197,1220,1130
9510900710,20140513T000000,267345,4,2.25,2510,8165,1610,900
1471620240,20140516T000000,275000,3,2.5,1480,15639,1480,0
1626079012,20150225T000000,439950,3,1.75,1720,223377,1240,480
3904901670,20140620T000000,455000,3,2.25,1470,4653,1470,0
8927600070,20150113T000000,630000,3,1.75,1540,6930,1250,290
3629970240,20141103T000000,690000,3,2.5,2820,5001,2820,0
1099610260,20140826T000000,212000,4,1.75,1250,12705,1250,0
5420300270,20140813T000000,231500,4,2.25,2080,7526,1280,800
2954400520,20150430T000000,1.24E+06,4,3.25,5180,49936,5180,0
1121059105,20140708T000000,378500,3,2.5,2860,43821,2860,0
2591720070,20140502T000000,482000,4,2.5,2710,35868,2710,0
9178600055,20150505T000000,695000,2,1,1140,3990,1140,0
9290850800,20141202T000000,965000,4,2.5,4070,57587,4070,0
5040800060,20150204T000000,675000,3,1.75,1710,5913,1120,590
1437900350,20141027T000000,387000,3,1.5,1340,6500,1340,0
1328300810,20150330T000000,347500,4,2.75,2290,7000,2290,0
3990200125,20140711T000000,385000,3,2,1860,7400,930,930
7452500340,20141204T000000,265000,3,1,1080,4930,1080,0
9215400075,20150422T000000,406000,3,1,960,5264,960,0
5061300030,20140508T000000,134000,2,1.5,980,5000,980,0
3362900696,20141020T000000,415000,3,1,1500,3399,1300,200
2558640340,20140527T000000,375000,3,1.75,1440,8775,1440,0
8078460810,20141210T000000,620000,4,2.5,2580,7465,2580,0
538000390,20141028T000000,337500,5,2.5,2070,4698,2070,0
3584900160,20140922T000000,565000,3,2.5,1880,12368,1260,620
8572900135,20140523T000000,399500,3,1.75,2420,12676,2420,0
8056000075,20140521T000000,1.07E+06,2,1.75,1890,9466,1890,0
2972300140,20140821T000000,352500,3,2,1920,33630,1920,0
7697870350,20140617T000000,259000,3,2,1870,5909,1270,600
7972601710,20150415T000000,320000,2,1,900,7620,900,0
6421100342,20140811T000000,733000,3,2.5,2160,9888,2160,0
2464400340,20140625T000000,381500,2,1,900,2910,900,0
8113101232,20141202T000000,343000,2,1,1180,9261,940,240
5706500140,20140818T000000,205500,2,1,900,6400,900,0
1024069037,20140915T000000,525000,3,2,1600,16530,1600,0
9476700135,20150319T000000,300000,3,1.75,1500,8352,750,750
1926069035,20140722T000000,299000,2,1,1070,189486,1070,0
3904990030,20140709T000000,561000,4,2.5,2570,5250,2570,0
7132300550,20150224T000000,450000,3,1,1210,4000,1090,120
2193340140,20140814T000000,540000,4,2.5,1850,7850,1850,0
1422300160,20140624T000000,379000,3,2.5,1740,30886,1740,0
2946000751,20140724T000000,230000,3,1,1300,14000,1300,0
1796250140,20150310T000000,399950,3,2.5,2000,30605,2000,0
6699001200,20150507T000000,355000,5,2.5,3220,5806,3220,0
7525300310,20140619T000000,580000,4,2.25,2160,9593,2160,0
5700000340,20150427T000000,700000,3,2,2130,4299,1680,450
3210400340,20140506T000000,279900,3,1.75,1580,8151,1100,480
179003055,20141113T000000,210000,3,1,1200,7500,1200,0
9829200566,20140630T000000,1.17E+06,3,3,3790,5001,2810,980
1723059050,20140611T000000,290300,2,1,860,3874,860,0
2624059036,20141003T000000,1.60E+06,5,4.5,5130,43123,5130,0
5101406441,20150416T000000,490000,3,1,1600,6380,1400,200
8582010240,20140506T000000,606000,4,2.5,2110,13850,2110,0
6300500505,20140714T000000,359950,3,1,1400,4980,950,450
3275890310,20150212T000000,677100,3,2,2110,9199,2110,0
7715801040,20150221T000000,465000,3,2,1430,7125,1430,0
7738500731,20140815T000000,4.50E+06,5,5.5,6640,40014,6350,290
1822079046,20150504T000000,500000,3,2,3040,41072,1520,1520
1062100075,20150503T000000,455000,2,1,980,5000,980,0
8825900070,20140818T000000,705000,6,2,2570,4240,1970,600
1158700135,20140812T000000,420000,3,2.5,2060,7020,1460,600
7983000200,20141005T000000,169575,3,1,1300,8284,1300,0
7983000200,20150225T000000,250000,3,1,1300,8284,1300,0
1727510030,20150312T000000,530000,3,2.25,1680,7262,1180,500
3286800370,20150206T000000,590000,5,3.25,4020,40341,2170,1850
6791400320,20140923T000000,257500,3,1.75,1530,14087,1070,460
3992700036,20140626T000000,415000,3,1,1170,6700,1170,0
1175000059,20141010T000000,536000,3,1.75,1580,3764,1280,300
8732000390,20140529T000000,246500,3,1.5,1270,11600,1270,0
1441800030,20140706T000000,395000,3,1.75,1480,7700,1480,0
4045800030,20150511T000000,739000,3,2.25,2220,10530,1700,520
1727850340,20140929T000000,1.27E+06,4,2.75,3200,13729,3200,0
2268000370,20140708T000000,190000,3,1,910,10575,910,0
2023049350,20150410T000000,305000,3,1.5,1480,9086,1480,0
7018000560,20150420T000000,925000,4,4.25,3770,13058,3770,0
4147200140,20140821T000000,895000,4,3,3500,13444,2360,1140
3176600055,20140717T000000,656000,3,1.75,1480,7475,1480,0
7518500885,20140519T000000,560000,4,1,1660,4690,1260,400
7504020810,20141020T000000,610000,5,2.25,2520,11700,2520,0
3276930370,20140708T000000,645000,4,2.5,2850,37522,2850,0
1687000200,20150410T000000,259000,3,2.5,2153,4400,2153,0
7501000340,20140818T000000,980000,4,2.5,3780,10962,3780,0
7611200136,20140723T000000,872000,4,4,3770,9750,1940,1830
5459500125,20140805T000000,1.00E+06,6,2.75,3600,9675,1940,1660
825059271,20140910T000000,900000,3,2.75,2980,12600,1590,1390
9465200181,20150428T000000,475000,4,1.5,2320,5534,1540,780
5469502860,20150107T000000,350000,5,2.75,2980,13482,1730,1250
486000565,20140515T000000,840000,4,1.75,2930,11562,1670,1260
6071900070,20140622T000000,500000,4,2.5,2040,8400,1420,620
7957600075,20150406T000000,202500,3,1.5,1510,9898,1110,400
823069074,20141223T000000,523000,4,2.5,2660,65340,2660,0
2366800055,20141203T000000,225000,3,2.5,1740,10050,1740,0
7272001805,20150309T000000,418200,3,2.25,2240,9542,1190,1050
3582700070,20141205T000000,356500,4,1.75,1570,9670,1170,400
2402100055,20140716T000000,670000,4,3,2500,5000,1460,1040
5146000070,20141204T000000,456150,3,2.25,1750,12408,1150,600
2607760890,20140603T000000,471000,4,2.5,3030,9687,2020,1010
9274200316,20150409T000000,558000,3,2.5,1680,934,1680,0
4139500200,20150305T000000,1.38E+06,6,4.5,5740,10312,3610,2130
3021059155,20141212T000000,161500,3,1,1220,6000,1220,0
3580900160,20141010T000000,311000,3,1,1310,8370,1310,0
3876000350,20150224T000000,470000,6,1.75,2490,8732,2490,0
3959400400,20140709T000000,569000,3,3.25,2220,8227,1770,450
8079100700,20150318T000000,689000,4,2.5,2240,7350,2240,0
9407001610,20140715T000000,271900,3,1.75,1890,11875,1230,660
8700120270,20141210T000000,278000,4,2.5,1850,6037,1850,0
3204300860,20140723T000000,820000,2,2.5,2210,4440,1440,770
3204800520,20150225T000000,399500,3,1.75,1410,7700,1410,0
8857320260,20141105T000000,462000,3,2.75,1890,2614,1890,0
6791400800,20150413T000000,347500,3,1,1830,12036,1550,280
2768000270,20140625T000000,562100,2,0.75,1440,3700,1200,240
1432400060,20140529T000000,230000,2,1,950,7560,950,0
2547200240,20140622T000000,687000,4,2.5,2370,10083,2370,0
6441800060,20141209T000000,725786,4,2.5,3070,5762,3070,0
1775800710,20150126T000000,315500,3,1,1300,12600,1300,0
7694600253,20140506T000000,312000,4,2,1300,7054,1300,0
8910500238,20141106T000000,343000,3,3.25,1210,1173,1000,210
3076500830,20141029T000000,385195,1,1,710,6000,710,0
1072030510,20140829T000000,415000,4,2.25,2240,12650,1730,510
3888100226,20140630T000000,461000,3,1.75,3600,8666,2400,1200
7227501369,20140610T000000,369990,4,2.5,1960,7133,1960,0
3820350070,20140929T000000,349950,4,2.5,1820,3134,1820,0
7616800350,20150412T000000,285750,3,2.25,1960,17126,1400,560
7811210200,20150420T000000,542500,4,2.25,1750,10160,1320,430
6891100260,20141111T000000,830000,5,3.5,3700,5400,2890,810
6076500160,20141223T000000,705000,4,2.5,2910,20946,2350,560
2872100445,20140624T000000,615000,2,1,1270,5000,1090,180
3352400004,20150129T000000,184500,2,1,720,5880,720,0
7942601200,20141001T000000,412000,2,1,1040,5120,1040,0
985001266,20141215T000000,250000,3,1.5,2210,11111,2210,0
2218000390,20140612T000000,580000,5,2,2060,6000,2060,0
7231502505,20150312T000000,220000,2,1,780,6000,780,0
7555220140,20140916T000000,675000,4,2.75,2240,8937,1460,780
7445000105,20140522T000000,373500,2,1,800,3330,800,0
5583200810,20150402T000000,662700,2,1.5,2440,6900,1590,850
7340600827,20140516T000000,239950,5,1,1460,6032,1460,0
7436900045,20140925T000000,383000,3,1,1150,10196,1150,0
4027701294,20150129T000000,485000,3,2.75,2650,12350,1470,1180
3570000160,20140710T000000,610000,4,2.75,2600,36583,1580,1020
9276202190,20140808T000000,545000,6,1.75,1820,6250,1130,690
5016002180,20140708T000000,780000,2,2.5,2560,2500,1690,870
7300000550,20150424T000000,305000,3,2.5,1714,3240,1714,0
6817810310,20140612T000000,405000,3,1,1330,15678,900,430
7851980260,20140730T000000,1.11E+06,5,3.5,7350,12231,4750,2600
1423400260,20150402T000000,273000,3,1.75,2050,9045,2050,0
3876810140,20140527T000000,326500,3,1,1810,12375,1810,0
3276180140,20150424T000000,365000,3,1.75,1380,9134,880,500
9808590310,20150408T000000,1.00E+06,3,2.75,3070,10739,2440,630
546000045,20150325T000000,422500,2,1,800,4046,800,0
2595650060,20150324T000000,354450,4,2.75,2140,9920,2140,0
1771110550,20141204T000000,320000,3,1,1330,9540,1330,0
5335700030,20140603T000000,223000,3,1,1030,9120,1030,0
7203101580,20140724T000000,410000,3,2.5,1740,4948,1740,0
272000125,20140829T000000,438000,3,1,1200,4000,1200,0
2770601741,20141106T000000,390000,3,3,1490,2944,960,530
4250200140,20150219T000000,298500,4,2.5,1890,5954,1890,0
8965400390,20140905T000000,749999,5,2.25,3060,13630,3060,0
5071401000,20140829T000000,779000,6,2.5,3250,12000,1800,1450
3760500435,20150114T000000,570000,3,2.75,2730,11936,1530,1200
5680000260,20150512T000000,385000,3,1,810,4600,810,0
9170500060,20140818T000000,649000,4,2,2240,11040,1120,1120
795000885,20141001T000000,283000,3,1,1740,5247,1270,470
4038600260,20140922T000000,699900,4,2.25,2380,16236,1540,840
4406000560,20150220T000000,278500,4,1,1540,8400,770,770
2260000340,20141115T000000,700000,4,1.75,2340,9100,1610,730
9510310030,20140728T000000,535000,4,2.75,2710,45963,2710,0
4245400045,20140923T000000,234500,3,1.75,1310,18400,870,440
9371700132,20140806T000000,374150,3,1.75,1390,9585,1390,0
7272001610,20150317T000000,397000,4,2.5,2201,9542,2201,0
1324059139,20140918T000000,613000,3,2.25,1960,10385,1960,0
1552100135,20140609T000000,1.15E+06,3,2.5,2850,10474,1730,1120
1257200060,20150327T000000,595000,4,1.75,1880,4080,940,940
2822059350,20140910T000000,340000,5,2.75,2440,6858,2440,0
2781260070,20150108T000000,388000,4,2.5,2560,5800,2560,0
619000045,20140922T000000,404000,3,1.75,1410,15210,1410,0
8934100125,20140829T000000,810000,3,2,2870,6360,1790,1080
2472920140,20150403T000000,405000,4,2.5,2620,9359,2620,0
7215730310,20140714T000000,726000,5,3,2970,10335,2970,0
7697870310,20140514T000000,266000,3,2.5,1780,7214,1400,380
2795000060,20141222T000000,722500,5,2.25,3700,7207,1850,1850
2408600160,20150228T000000,352000,4,2.5,1252,25002,992,260
7888200240,20150319T000000,265000,4,1.5,1240,8158,1110,130
151000075,20150206T000000,856000,3,2.5,2160,3920,2160,0
5104530240,20140724T000000,346950,3,2.5,2040,4348,2040,0
4139680070,20140617T000000,866059,5,3.5,3130,4797,2570,560
7852180260,20150129T000000,410000,3,2.5,2350,4456,2350,0
1471610060,20140708T000000,370000,3,1.75,1570,16817,1570,0
3520069033,20140623T000000,230000,3,1,1530,389126,1530,0
9268200550,20141010T000000,400000,2,2,1520,5010,1520,0
1788700295,20150311T000000,172000,3,1,1350,9680,820,530
7379600240,20140714T000000,615000,3,1.75,1950,8480,1250,700
8691330060,20150407T000000,860000,4,3.5,3950,9600,3950,0
6384500581,20140618T000000,555000,3,1.75,2040,6000,1120,920
6690500070,20140721T000000,579000,3,2.5,1990,4040,1390,600
3205400140,20140630T000000,385000,3,1.75,1300,7030,1300,0
6662410070,20150414T000000,420000,4,2.25,2030,12000,2030,0
1919800260,20140716T000000,645000,3,1.75,2340,6750,1620,720
7283900045,20150428T000000,549950,3,2.5,2160,6288,2160,0
3756100160,20140923T000000,678000,3,2.75,2770,10000,1640,1130
3352401981,20140521T000000,199000,4,2,2030,8120,2030,0
5315100394,20150218T000000,604000,3,1,1440,13824,1440,0
3450300270,20150403T000000,268000,5,1.75,1730,10368,1010,720
2325069117,20140805T000000,960000,5,3.5,4510,16305,2820,1690
7199340310,20150218T000000,509250,3,2.5,2100,7600,1450,650
8663260030,20141118T000000,416000,3,2.5,1800,5372,1800,0
9315100030,20140515T000000,190000,3,1,1090,8520,1090,0
2190601049,20150429T000000,212000,3,1.5,1010,10000,1010,0
9264930400,20141029T000000,325900,3,2.5,2040,9765,2040,0
2490200055,20140801T000000,560000,3,3.5,2270,4088,1880,390
3830630140,20140924T000000,275000,3,2.5,1730,5799,1730,0
6385260160,20150309T000000,665000,4,2.5,2480,15411,2480,0
5701500030,20140601T000000,1.51E+06,4,3.5,3480,7232,2580,900
859000160,20141203T000000,375000,4,2,1720,2410,970,750
123039633,20140909T000000,359950,3,1.75,1570,6975,1040,530
3601200465,20150123T000000,340000,4,2.75,3527,7200,3527,0
106000320,20141031T000000,401000,2,1,840,8100,840,0
7631200292,20140626T000000,669000,2,1.75,1950,10766,1160,790
2526059046,20150429T000000,638500,4,2.5,1980,6568,1980,0
3416600111,20150323T000000,545000,2,1.5,1620,3760,1170,450
3205500160,20141226T000000,524000,4,1,1980,7015,1260,720
824059331,20141108T000000,1.61E+06,5,3.75,3530,13260,3530,0
5347200060,20140909T000000,280000,2,1,1260,4800,1100,160
9323610260,20140825T000000,828000,4,2.5,2120,10841,1500,620
8732160240,20141017T000000,223000,3,1.75,1360,10573,1360,0
9808640320,20150102T000000,1.29E+06,4,3.5,3100,2261,2250,850
1326069050,20150504T000000,750000,2,2,2370,155130,2370,0
1454100267,20150417T000000,430000,2,1,1460,9207,1210,250
5021900160,20140618T000000,711000,4,1.75,1980,10800,990,990
818100030,20141204T000000,310000,4,2.5,1930,7014,1930,0
393000045,20141226T000000,415000,5,1.75,3700,9140,1850,1850
8091411040,20140701T000000,274900,4,2.5,1970,6600,1970,0
5561200310,20140609T000000,525000,3,3,2470,36445,2470,0
3204500340,20141219T000000,179500,3,1,1180,32214,1180,0
9222400935,20140523T000000,478000,3,1,1280,2580,1280,0
1796350570,20140521T000000,195000,3,1.75,1380,7350,990,390
2473450200,20150305T000000,385000,4,3,2740,10925,1670,1070
1387300570,20141201T000000,401000,3,2.75,2020,9505,1260,760
8857640860,20140926T000000,522000,4,2.5,2835,6598,2835,0
5415000240,20150224T000000,330000,4,1.75,1520,14417,1520,0
2591760070,20140603T000000,503000,3,2.5,2190,4882,2190,0
4131500140,20150212T000000,175000,5,1.75,1680,8400,1680,0
7203220370,20150320T000000,963990,4,3.5,3915,6364,3915,0
1651500060,20140929T000000,845000,5,2,1720,9972,1720,0
7883600700,20150122T000000,157500,2,1,670,4500,670,0
567000755,20141205T000000,450000,2,3,1790,1709,1400,390
9294300615,20140918T000000,925000,4,1.75,2440,11793,1420,1020
3213200215,20150105T000000,600000,2,1,920,5029,920,0
9136101776,20140918T000000,709000,4,1,1680,4087,1680,0
5035300850,20141110T000000,1.39E+06,5,3.75,3290,6480,2190,1100
3668001080,20140911T000000,248000,3,2.5,2120,6840,1220,900
5540800100,20150511T000000,245000,3,1,910,6630,910,0
3679401110,20140530T000000,332000,2,1,1000,4776,1000,0
7852130100,20150313T000000,459950,3,2.5,2340,4273,2340,0
9828200147,20150410T000000,425000,3,2,1180,1800,1180,0
826069085,20140903T000000,460000,3,2.25,2080,50965,1590,490
6383900090,20140904T000000,838300,6,2.5,3760,12978,2360,1400
8100000090,20141111T000000,256000,3,2.5,1480,7200,1480,0
7805450750,20150120T000000,864000,3,2.75,3060,13554,3060,0
148000705,20150305T000000,900000,4,3.5,3070,4440,2030,1040
1432400490,20150401T000000,145600,3,1,1170,7560,1170,0
7974200820,20140821T000000,865000,5,3,2900,6730,1830,1070
8731951130,20140609T000000,250250,3,2.25,2210,8000,2210,0
7227801955,20140919T000000,162000,4,2,1440,7641,1440,0
3558910490,20140731T000000,450000,4,1.75,1980,7350,1430,550
324059112,20150325T000000,675500,4,2.75,2060,21344,1460,600
2710600025,20141103T000000,697000,3,2.25,2420,5304,1640,780
7582700100,20141111T000000,1.32E+06,3,3.25,3440,4080,2560,880
3882300100,20141201T000000,490000,3,1.75,1600,16510,1600,0
3735900590,20141021T000000,590000,3,2.25,2210,5742,1460,750
5153200356,20150512T000000,280000,4,1.75,2250,16000,1450,800
7625702350,20140523T000000,515000,2,1,1680,6500,1140,540
2755200090,20140714T000000,576000,3,1,1140,5395,1010,130
626059317,20141120T000000,375000,3,1.75,1430,10574,1430,0
7199360090,20150320T000000,478000,3,1,1440,7107,1000,440
8651443480,20150128T000000,282000,3,1,1670,5200,1030,640
9359100750,20141031T000000,1.40E+06,4,4.5,3080,10550,1940,1140
5561400740,20150210T000000,593500,5,3.25,4300,50405,3220,1080
1723099031,20141020T000000,724950,4,3.5,3010,174240,3010,0
7236500025,20140829T000000,306000,3,1.75,1560,7500,1560,0
2473411080,20140609T000000,341000,4,1.75,1920,7665,1500,420
1773101335,20141103T000000,399950,3,2.5,1400,4400,1400,0
9126100850,20141120T000000,534000,5,2,2280,3600,2280,0
7202331220,20140721T000000,635000,6,2.5,3880,5700,3880,0
5511600245,20150324T000000,350000,2,1,1350,3880,950,400
1344300090,20150217T000000,856000,3,1.5,1480,2700,1480,0
9828702812,20140923T000000,582000,4,3,1670,1189,1427,243
3825310820,20140729T000000,799000,4,2.5,3400,6742,3400,0
7852040110,20140908T000000,423700,3,2.5,2070,3986,2070,0
6752500090,20150127T000000,1.84E+06,4,3.5,4870,39190,4870,0
3222079162,20140813T000000,322000,3,2,1760,43575,1160,600
1025069192,20141105T000000,929000,4,3.25,4030,57499,4030,0
5101404608,20141201T000000,443000,2,1,1130,5413,880,250
9477100490,20150424T000000,441500,3,1.75,1510,7700,1510,0
324069015,20140708T000000,875000,4,3.5,3110,108464,3110,0
4114601570,20141118T000000,3.60E+06,3,3.25,5020,12431,3420,1600
7920100025,20150427T000000,450000,2,1,740,5100,740,0
3275730110,20140908T000000,425000,3,2.25,1630,10500,1100,530
7504030090,20140601T000000,660000,4,1.75,2780,9900,2780,0
8813400405,20140616T000000,763101,3,1.75,1990,5560,1100,890
1313300300,20150407T000000,499000,4,2.75,2250,14149,2250,0
8121610110,20150303T000000,521000,3,1.75,1720,37363,1350,370
1820069019,20140529T000000,302000,2,1,900,423838,900,0
9406450090,20150408T000000,293000,4,2.25,2360,6260,2360,0
2619950490,20140712T000000,335000,3,2.25,1530,4580,1530,0
1646500785,20141215T000000,499000,2,1,1450,3090,1450,0
1868901690,20150505T000000,600000,3,1.75,2040,5000,1780,260
9542400025,20140916T000000,720000,4,1.75,2620,11041,2620,0
2781270090,20150225T000000,195000,2,2,1180,2553,1180,0
1665400165,20140507T000000,249000,3,1,1110,8423,1110,0
1326069191,20150202T000000,334000,3,2.25,1840,9781,1840,0
381000110,20141107T000000,599950,4,1.75,2720,7810,1510,1210
3530530110,20150217T000000,149900,2,1.75,1090,1950,1090,0
5210200107,20141125T000000,700000,4,1.75,1730,6500,1250,480
1574100025,20140807T000000,525000,4,1.5,1170,6240,1170,0
2523069192,20140708T000000,1.05E+06,4,3.75,4740,126759,4740,0
6706600090,20140508T000000,402000,3,2.5,1960,8000,1290,670
1994200031,20140620T000000,450000,3,2,1430,3480,980,450
2523069156,20141203T000000,520000,3,2.25,2510,43995,2510,0
5029450850,20141204T000000,205000,3,1.75,1420,6980,820,600
2723069147,20140902T000000,635000,3,2.25,2680,175982,2680,0
3750605349,20150304T000000,210500,3,1,1220,9600,1220,0
9285800735,20140812T000000,406650,2,1,1070,6100,1070,0
7574000100,20150408T000000,350000,3,1.75,1580,19998,1580,0
9212900100,20150423T000000,425000,4,1.75,1820,6000,930,890
8651611130,20140605T000000,798000,3,3.5,3590,6402,3590,0
423059184,20141201T000000,180000,3,1,1960,9583,1960,0
5451200600,20140602T000000,1.25E+06,5,3.25,3160,13238,3160,0
6300000378,20150303T000000,435000,4,2,2030,4033,1630,400
2570300090,20141126T000000,355000,3,1.5,1240,15867,1240,0
9808100100,20150202T000000,3.00E+06,5,3.25,5370,14091,3850,1520
4019300906,20140724T000000,685000,5,2.5,2670,14455,2670,0
1023059223,20140725T000000,311000,3,1,1640,12060,1640,0
9320700090,20140911T000000,305000,4,2.25,2130,9600,2130,0
5700002460,20140725T000000,675000,3,2.5,2550,4954,1850,700
7598100735,20140829T000000,769000,4,2.75,3630,15405,1850,1780
2202500110,20140805T000000,430000,3,1.5,1690,9708,1690,0
726059395,20140923T000000,516250,6,2,2390,8660,2390,0
1455600015,20141212T000000,760000,3,3.5,2350,10739,1340,1010
9528101224,20141007T000000,579950,3,3.5,1420,1217,1180,240
6713100031,20150211T000000,476000,3,2.25,1570,7187,1170,400
8677900123,20140612T000000,510000,3,1.75,1600,19200,1600,0
4302201130,20140508T000000,205000,2,1,720,5040,720,0
1310800090,20141007T000000,240000,3,1,1470,7350,1470,0
6117502727,20140902T000000,738000,5,3.5,2790,16952,1970,820
9324800110,20140728T000000,420000,3,1.75,1720,8102,860,860
8965000110,20141114T000000,455000,3,1.75,1300,9600,1300,0
5700001055,20140915T000000,765000,4,1,2520,5500,1820,700
49500090,20141205T000000,372000,4,1.5,1780,7914,1780,0
3812400657,20141204T000000,160000,3,1,1200,8360,1200,0
2725069162,20140815T000000,772000,4,2.5,2990,9643,2990,0
4232400110,20141111T000000,1.13E+06,5,1.75,1910,5640,1910,0
9521100586,20140524T000000,479000,3,1,1370,3000,1370,0
7215721570,20150505T000000,570000,3,2.5,1910,4941,1910,0
3834000805,20140710T000000,350000,4,1,1170,8147,1170,0
2274000026,20141101T000000,353000,3,2.5,1250,864,1250,0
5103300090,20140801T000000,699000,5,2.5,3340,24755,3340,0
9558200025,20140730T000000,265000,3,2,1380,8536,1380,0
8649401270,20150430T000000,167000,1,1,780,10235,780,0
686200740,20141020T000000,500000,4,2.25,2080,8000,1390,690
7658600025,20140709T000000,700000,3,1,1410,7200,1410,0
3702900165,20141104T000000,295000,1,1,520,5600,520,0
7977201240,20150311T000000,1.01E+06,4,3.5,3500,4080,2590,910
8651410090,20150508T000000,209000,2,1,840,5265,840,0
3750603732,20150128T000000,276000,3,1.75,2240,9200,1440,800
1023059429,20150122T000000,380000,4,2.5,2100,5857,2100,0
2412100025,20140606T000000,315000,3,1.5,1750,12500,1150,600
203600600,20150310T000000,685530,4,2.5,3130,60467,3130,0
2021069059,20140626T000000,254600,3,2,1470,20000,1470,0
7227501645,20140603T000000,230000,3,2,1440,5600,720,720
4310702787,20140717T000000,335000,3,3,1430,1249,1430,0
1494300110,20140603T000000,550000,4,2.5,2170,9600,1460,710
1950900245,20141226T000000,123300,3,1,1150,8050,1150,0
3512100110,20140902T000000,275436,4,2.75,2170,9658,2170,0
8732750100,20140525T000000,325000,4,3.5,2630,3435,1640,990
1332000110,20140725T000000,635000,4,2.5,2490,40608,2490,0
2768100690,20150423T000000,513000,3,1.75,1710,5000,1110,600
7525410090,20140708T000000,580000,4,2.5,2130,35752,1490,640
9558800025,20150429T000000,225000,3,1,940,9272,940,0
2788400315,20140922T000000,265000,3,1,1400,9460,1060,340
7128300855,20141014T000000,313000,4,1.75,1630,3000,930,700
7655900038,20150414T000000,296000,2,1,1370,8400,1370,0
7923500090,20141020T000000,655500,4,2.75,2380,15800,1680,700
3339900096,20141210T000000,250750,5,1.75,2140,12058,2140,0
5214500690,20140904T000000,438000,4,2.5,1970,8545,1970,0
4045900147,20140801T000000,590000,3,2.75,2550,54014,1980,570
6450302900,20141006T000000,329500,3,1,1080,5250,1080,0
2597460090,20150316T000000,1.20E+06,3,2.25,3070,9645,2110,960
2770601595,20150320T000000,415000,2,1,1470,6000,900,570
4188000490,20140922T000000,900000,4,2.5,3620,42580,3620,0
1324079085,20150504T000000,378000,3,1.5,1050,57499,1050,0
1720069006,20140812T000000,474000,2,1,1050,403365,1050,0
1947300115,20140619T000000,464000,3,1,1320,3625,1320,0
5490700100,20141208T000000,310000,3,1,1210,7649,1210,0
7278100690,20140918T000000,580000,3,1.5,1860,7190,1860,0
2322029048,20141119T000000,999000,3,2.75,2830,505166,1830,1000
6821102100,20150317T000000,510000,2,1,810,6480,810,0
3176100110,20140506T000000,650000,3,1.5,1630,7475,1160,470
2188200785,20140912T000000,196000,3,1,880,19600,880,0
1446801030,20140822T000000,220000,4,1.75,1660,11664,1010,650
8965520100,20141008T000000,855000,3,2.25,3440,10628,3440,0
3649100586,20140829T000000,483000,3,1.75,2110,10454,1440,670
7283900153,20150407T000000,400000,3,1,1060,12000,1060,0
1036100100,20140702T000000,435000,3,2.5,1900,7984,1900,0
3278602670,20140930T000000,219500,1,1,820,1060,760,60
3625049014,20140829T000000,2.95E+06,4,3.5,4860,23885,4860,0
7276100165,20140916T000000,427000,3,2.5,2050,3218,2050,0
9136103130,20141201T000000,430000,2,1.5,1090,4013,1090,0
9136103130,20150512T000000,685000,2,1.5,1090,4013,1090,0
1193000025,20140903T000000,495000,2,1.5,1920,6250,1060,860
2744000100,20140625T000000,299950,3,2.5,1870,7942,1870,0
3744600028,20141121T000000,390000,4,1.75,2690,46609,2690,0
3679400025,20140812T000000,385000,3,1.75,2160,5863,1260,900
9545260100,20140625T000000,740000,4,2.5,3000,10392,3000,0
375000165,20140723T000000,991700,4,3,2290,2350,1610,680
4003000053,20140813T000000,765000,3,2.75,2250,9600,1830,420
7855600820,20140904T000000,802000,4,2.25,2130,8734,2130,0
3860400100,20141121T000000,950000,4,2.75,2500,20000,1700,800
121059147,20141104T000000,392000,4,2.5,2300,41167,2300,0
825079019,20141203T000000,590000,3,2.5,3360,218235,3360,0
123039313,20150410T000000,425000,4,2.5,1920,9000,1920,0
7784000110,20140722T000000,765000,5,1.75,2440,15143,1740,700
8835220090,20140807T000000,313500,3,2.25,1440,3488,1440,0
6381501636,20140820T000000,320000,3,1,1780,6840,1780,0
1370804446,20150210T000000,604000,4,1.75,1490,4485,1350,140
9828701871,20150212T000000,570000,3,2,1400,1657,1060,340
3396200090,20140520T000000,639000,4,2.5,2150,12028,2150,0
1463400047,20140822T000000,335000,4,2,1910,10200,1910,0
8825900855,20141014T000000,896000,4,1.75,2660,3520,2080,580
7147600245,20140627T000000,259500,3,1.75,1650,12349,1650,0
5071400485,20140807T000000,637000,3,2,1980,6000,1380,600
8732040090,20150506T000000,307450,4,2.75,2690,8874,1370,1320
8082400100,20140825T000000,535000,3,1.75,1380,3561,860,520
546000930,20140630T000000,669500,4,2.25,2500,4046,1520,980
1665400025,20141028T000000,259000,3,1.75,1590,7148,1590,0
9187200245,20141231T000000,441000,4,1.5,1100,3300,1100,0
2123700015,20150512T000000,228800,4,2.5,1470,1612,980,490
8682291730,20140513T000000,530000,2,2,1680,4950,1680,0
5318100504,20140728T000000,524000,2,2,1450,2272,750,700
9297800165,20141211T000000,430000,4,2.25,2020,4840,1200,820
1342300265,20141001T000000,1.33E+06,4,3.25,2470,4760,1890,580
2212901130,20141103T000000,210000,3,1,1230,12201,1230,0
8122100690,20140623T000000,449000,4,2.5,1850,5040,1230,620
148000375,20140619T000000,945000,2,2.5,2540,7089,2540,0
3423049209,20150318T000000,200450,3,1,970,9130,970,0
16000015,20150417T000000,219950,3,1.5,1070,6601,1070,0
4035900015,20140619T000000,659500,4,3,2620,18362,1870,750
8563010300,20141126T000000,746000,4,2.75,2110,8190,2110,0
3396200300,20150331T000000,540000,3,1.75,2110,7129,1280,830
2291401425,20140910T000000,485000,5,2,1910,5508,1020,890
7454000110,20150127T000000,202000,2,1,670,7844,670,0
3377900195,20140929T000000,2.53E+06,4,5.5,6930,45100,4310,2620
3824100082,20150401T000000,502000,3,2.75,2010,11200,1360,650
3751604169,20150224T000000,279000,2,2.75,1770,10534,1210,560
6431500283,20141117T000000,409500,3,1,1340,4120,1040,300
6647400090,20140702T000000,453000,3,2,1660,15050,1260,400
7387500195,20150227T000000,367000,4,1,1820,5500,1820,0
3342101785,20140523T000000,550000,3,2.5,2510,5400,2510,0
9320600090,20150127T000000,273500,3,1.5,1560,8314,1560,0
8901001185,20141007T000000,505000,4,3,2280,7400,1340,940
825069097,20140619T000000,770000,3,2.5,2650,40705,2650,0
7745000090,20140509T000000,565000,4,2.25,2470,7447,2470,0
1771110090,20140820T000000,316000,3,0.75,1270,10092,1270,0
7888100090,20140925T000000,160000,4,1,1520,7298,1520,0
5083000375,20141027T000000,170000,3,1,1310,9529,1310,0
5083000375,20150319T000000,235000,3,1,1310,9529,1310,0
1329000090,20141219T000000,1.80E+06,4,3.5,3930,39098,3930,0
8143000600,20140918T000000,310000,3,1,990,7050,990,0
2144800215,20140519T000000,285000,4,1.75,2080,13629,1040,1040
9268200658,20140604T000000,280000,2,1,960,4920,960,0
5452301785,20150218T000000,2.30E+06,4,4.25,4070,13860,4070,0
1137500090,20140814T000000,763776,4,2.5,2750,16139,2750,0
6117500025,20150217T000000,530000,5,2.75,3230,13572,1880,1350
2326079039,20150211T000000,362000,1,1,890,211576,890,0
7595700025,20140725T000000,430000,2,1,990,4920,990,0
4443800110,20140725T000000,456500,3,1,1290,3880,1290,0
5101405265,20140911T000000,445000,4,2.5,2170,5257,2170,0
9206200110,20150310T000000,386900,3,1,1330,10500,960,370
2205700405,20140708T000000,479000,3,1,1340,13750,1340,0
7852020300,20150313T000000,525000,3,2.5,2200,4544,2200,0
5559200051,20150106T000000,272000,4,1.75,2520,10890,1260,1260
2826049165,20150226T000000,517000,4,1,1180,13500,1180,0
2675600028,20150226T000000,615000,3,1.75,2660,7800,1330,1330
259801110,20140828T000000,439000,3,1.75,1250,7030,1250,0
1150001270,20140724T000000,716000,3,2.5,2270,7866,2270,0
7130300690,20141028T000000,308000,2,1,1080,6250,1080,0
2652500015,20140610T000000,800000,3,2.25,1620,4500,1620,0
3693901801,20150505T000000,575000,3,2,940,5000,880,60
8092501240,20140701T000000,219950,3,1.5,1620,9310,1620,0
9552701030,20140522T000000,770000,4,2.5,2350,8001,2350,0
9477101280,20141230T000000,424950,3,1.75,2090,7505,2090,0
7462900015,20150108T000000,387000,3,2.25,1760,45133,1760,0
6744700302,20140620T000000,790000,4,1.75,2050,10920,1450,600
3163600015,20150128T000000,156000,2,1,600,4000,600,0
6896300375,20140505T000000,580000,2,1,2540,7000,1320,1220
7419700015,20140919T000000,490000,4,2.25,2090,10869,2090,0
4473400195,20140716T000000,950000,5,3.25,2700,3650,2070,630
9358001566,20150213T000000,400000,2,2.5,1410,1281,1090,320
6145600900,20150513T000000,325000,2,2.5,1170,1638,1170,0
1865000110,20140929T000000,365000,4,2.5,2540,6688,2540,0
8698100115,20150407T000000,255000,3,1.75,2190,6000,2190,0
1454600038,20150323T000000,985000,5,3.5,3890,13261,2870,1020
5652601425,20150423T000000,595000,4,2.5,2030,10722,1100,930
6381500690,20140716T000000,427500,3,1,1350,7085,1350,0
1778500015,20141016T000000,728000,3,1.5,1940,4000,1310,630
6021500245,20140910T000000,549950,2,1,1260,4000,1000,260
2926049382,20141208T000000,650000,3,2,2800,10501,1400,1400
1692900110,20150320T000000,1.13E+06,5,3.25,3080,13394,2230,850
8651401270,20150504T000000,203000,3,1,840,6500,840,0
3332500265,20140807T000000,311000,2,1,860,3300,860,0
4027700853,20150428T000000,387500,6,2,2400,7684,1200,1200
7301300215,20150318T000000,370000,4,2,1640,7200,1640,0
7663700792,20140724T000000,228000,2,1,1060,6100,1060,0
2919702235,20140528T000000,740000,2,1.75,2080,4800,1080,1000
5476200123,20140710T000000,200000,4,2,2090,6630,1070,1020
3797002585,20140709T000000,660000,3,1,1240,3500,1240,0
8864000735,20140709T000000,275000,4,2,2030,8426,2030,0
1193000115,20150429T000000,708000,2,1,1120,5250,950,170
7334501240,20140519T000000,280000,3,2.5,1270,9675,1270,0
7885801460,20150106T000000,325000,4,2.5,2260,5702,2260,0
1823099076,20140820T000000,495000,3,2.5,1780,47480,1780,0
8900000110,20140922T000000,691000,2,2,1780,3810,980,800
251620110,20140702T000000,2.29E+06,4,2.5,4080,18362,4080,0
221049191,20150428T000000,329500,3,2.5,2120,22482,1360,760
9264950940,20140805T000000,348000,3,2.5,2060,7458,2060,0
8820902540,20141114T000000,425000,2,1,1670,6212,1670,0
3438500625,20140519T000000,210000,3,1,1080,21043,1080,0
7452500315,20141220T000000,285000,2,1,1210,4895,710,500
8945200750,20150430T000000,222000,3,1,990,8840,990,0
2599001240,20140527T000000,200000,4,2.5,1720,9600,1120,600
5360200054,20141002T000000,247500,3,2,1530,8749,1530,0
622069006,20140820T000000,1.50E+06,4,5.5,6550,217374,5400,1150
84000245,20141120T000000,190000,3,1.75,1100,9452,1100,0
5605000590,20141215T000000,975000,4,2.5,3020,4950,2020,1000
6613000015,20141223T000000,1.13E+06,4,3,3180,4649,2070,1110
5151600195,20150504T000000,283200,4,1.75,1830,12540,1130,700
7308900490,20140714T000000,650000,3,2.5,2540,8073,1880,660
2222900082,20140513T000000,449500,3,2,1770,6610,960,810
3574801720,20141022T000000,400000,3,1.75,1470,6682,1470,0
1721801591,20150219T000000,89950,1,1,570,4080,570,0
2641800015,20141124T000000,158800,3,1,960,8291,960,0
7625703885,20140917T000000,870000,4,3,2940,7108,2220,720
3751600176,20150306T000000,196000,3,1.5,1000,18568,1000,0
5035300750,20140731T000000,850000,3,1.75,2450,8603,1340,1110
9510970300,20140923T000000,775000,4,2.5,3310,5101,3310,0
9286100300,20140801T000000,483500,3,2.5,1670,4308,1670,0
4047200850,20150402T000000,387000,3,1.5,1620,21929,1620,0
4019300195,20150124T000000,900000,3,3,2990,30869,2990,0
7891600590,20150407T000000,336000,3,1.5,1240,5000,1240,0
5249802424,20150417T000000,415000,2,1,670,6000,670,0
3918400017,20150205T000000,380000,0,0,1470,979,1470,0
9209900315,20140811T000000,350000,3,1.5,1320,4400,1320,0
7237500590,20141117T000000,1.32E+06,4,5.25,6110,10369,6110,0
3271800850,20140806T000000,765000,3,1.75,2440,5800,1320,1120
1023059511,20141020T000000,527000,4,2.5,2900,6736,2900,0
4109600195,20140718T000000,524000,4,2.75,2310,5000,1480,830
5100401468,20140715T000000,448000,2,1,1110,5413,890,220
1926069137,20140707T000000,775000,4,3.25,4100,241322,2500,1600
3828000405,20150116T000000,176500,3,1,930,9900,930,0
7773800015,20150416T000000,750000,4,2.25,2420,11120,1620,800
1084000107,20141202T000000,1.27E+06,4,2.25,2870,6000,1730,1140
7832800015,20150226T000000,250000,3,1,1480,6750,1480,0
9829200590,20141028T000000,759000,3,2.75,1960,6390,1960,0
8127700820,20141211T000000,640000,3,2,1470,4640,1470,0
9547202265,20150427T000000,990000,3,3.25,2460,4182,2100,360
7663700261,20141008T000000,395000,4,1.75,1960,7945,980,980
1445200110,20150421T000000,275000,2,1.5,1160,1103,890,270
1023059313,20150205T000000,390000,3,2.5,1910,4755,1910,0
170000215,20150324T000000,752500,5,2.75,2720,4680,1710,1010
7550801220,20150227T000000,450000,2,1,1020,5000,1020,0
7518501390,20140617T000000,473000,2,1,900,5100,900,0
9407102460,20150323T000000,178500,3,1.75,1120,10450,1120,0
8567300110,20140604T000000,485000,3,2.5,2340,59058,2340,0
5029450110,20150327T000000,215000,3,1.5,1410,8415,780,630
7915100490,20140812T000000,589000,4,1.75,1920,4862,1060,860
114101500,20150417T000000,325000,4,1.75,1370,9993,1370,0
9274201807,20140820T000000,580000,3,2.5,1590,1937,1590,0
7893206095,20140716T000000,181100,4,1.75,1850,7500,1850,0
2770602265,20150224T000000,345000,3,2,1430,4200,830,600
5418200245,20150330T000000,781000,3,1.75,1940,8729,1460,480
7228502150,20141023T000000,402500,4,1,1270,3630,1270,0
7972601030,20150420T000000,426000,3,1.5,1380,7200,1080,300
7853270940,20140905T000000,389000,3,2.5,1720,4515,1720,0
5561401220,20140707T000000,670000,6,3,4050,36171,2620,1430
1336800015,20140521T000000,1.51E+06,4,3.25,3660,5800,3360,300
8944750850,20140521T000000,288400,3,2.25,1870,3230,1870,0
3362400590,20150219T000000,700000,4,2,2230,4635,1510,720
6821100195,20150331T000000,830000,4,3,2020,6000,1220,800
1827200265,20140911T000000,1.90E+06,2,2.75,3690,32044,3690,0
5100401429,20141009T000000,350500,2,1,1450,6380,1450,0
6116500028,20150503T000000,431000,3,1.75,1630,9000,1630,0
2759800110,20141031T000000,485000,3,2.5,1840,8250,1340,500
579000096,20141010T000000,780000,3,1.5,1620,7500,1620,0
9169600096,20140801T000000,720000,2,1.5,1840,9000,1340,500
1226059112,20150220T000000,415000,3,1,1360,73616,1360,0
6021503830,20140620T000000,480000,4,1,2080,5500,1040,1040
3824100291,20140916T000000,452250,4,2.25,2550,10000,1560,990
9264921030,20150406T000000,316000,3,2.5,2550,8170,2550,0
8073000495,20141010T000000,700000,2,1,1160,17635,1160,0
7129304105,20140729T000000,285000,4,2,1760,5500,780,980
525049085,20140918T000000,575000,3,1.75,1720,4050,860,860
6117500785,20140722T000000,590000,3,2.25,2300,12430,1580,720
6115400008,20150226T000000,587500,4,1.75,2500,20868,1600,900
4024101545,20140922T000000,364000,4,2.25,1750,10270,1750,0
8651511220,20141217T000000,490000,3,2.5,1890,10190,1890,0
5561301280,20140505T000000,410000,3,2.25,1800,36704,1360,440
3629800100,20141028T000000,520000,3,2.5,2160,4297,2160,0
6141100750,20141008T000000,389000,3,1,1380,6591,1380,0
2770605065,20141118T000000,450000,2,1,1180,6000,1180,0
2517100490,20141205T000000,325000,3,2.5,2550,4240,2550,0
4083801785,20150313T000000,660000,2,1,1070,5000,1070,0
4318200405,20140620T000000,850000,3,2.25,2870,8170,2250,620
2329810590,20140806T000000,285000,3,2.5,1940,9874,1940,0
2768301214,20141211T000000,395000,2,1,870,3121,870,0
1931301105,20140717T000000,440000,3,2,1550,2401,1550,0
3343903640,20150313T000000,249000,3,1.75,1400,5648,1400,0
8813400245,20150227T000000,635000,3,1.75,1210,4400,1210,0
3521049048,20140811T000000,515000,3,2.5,3430,48993,3430,0
1118001645,20150130T000000,1.40E+06,3,3.25,3020,6073,3020,0
2968801105,20150304T000000,200000,2,1,950,8100,950,0
3524039209,20140506T000000,1.14E+06,4,2.75,3370,8103,1970,1400
952003480,20141117T000000,445000,4,1,1460,4600,780,680
2877102670,20140707T000000,555000,3,1.5,1740,4200,1640,100
5014000100,20140924T000000,537000,4,2,1720,6413,860,860
7399301050,20150127T000000,315000,3,1.75,1480,7500,1480,0
6979940100,20150129T000000,805000,5,2.5,3320,7266,3320,0
8731982840,20140826T000000,414000,4,2.5,3490,9030,3490,0
6909200037,20140815T000000,375000,2,1.5,1160,1648,1160,0
1160000115,20150304T000000,401000,4,1.75,3010,12523,1780,1230
7893207665,20150128T000000,210000,3,1,1030,4583,1030,0
8024201270,20140722T000000,365000,2,1,980,5110,780,200
3800008,20150224T000000,178000,5,1.5,1990,18200,1990,0
6788200931,20140520T000000,710000,2,1,1790,4000,1040,750
723049596,20140509T000000,255000,2,1,810,7980,810,0
7214711270,20141204T000000,528000,5,2.25,2940,38009,1700,1240
4136980090,20150407T000000,537000,4,4.25,4883,26040,3859,1024
9278200131,20140804T000000,442000,4,1.5,1360,6110,1010,350
4046600750,20150414T000000,375000,3,1.75,1370,19550,1370,0
9510970090,20141121T000000,637250,4,2.5,2120,3220,2120,0
2594200375,20150330T000000,427500,3,1.75,1240,7200,1240,0
1125069064,20150331T000000,700000,4,2.5,2770,89298,2770,0
117000100,20150319T000000,680000,3,1.75,1660,5750,1080,580
9212900820,20140828T000000,393820,2,2,1170,8251,1170,0
3959400855,20140820T000000,525000,4,2.75,2470,7200,1350,1120
2028700265,20150115T000000,505000,2,1.75,1310,3816,1110,200
3041700090,20141111T000000,555565,3,2,1670,11337,1670,0
868001295,20141029T000000,650000,3,1.75,1660,10819,1240,420
7853270740,20140917T000000,632500,5,3.25,3500,7254,2760,740
5416500090,20140724T000000,269000,3,2.5,1440,3800,1440,0
3574801110,20141125T000000,405000,4,2.75,2360,7716,1390,970
624110930,20140724T000000,845000,3,3.5,3460,15745,3460,0
5335700110,20140725T000000,234000,3,1,1750,8820,1750,0
1176000964,20150422T000000,638000,4,1.75,1470,4236,1470,0
7334602070,20140804T000000,290000,3,1.75,1710,10950,1060,650
2420069251,20150225T000000,262000,1,0.75,520,12981,520,0
7885800740,20150218T000000,270000,4,2.5,2350,5835,2350,0
8082400076,20141118T000000,875000,4,2.25,2380,4876,2240,140
1310980110,20140717T000000,299000,3,2.25,1920,7840,1920,0
2354300740,20150303T000000,551000,3,1,1580,6000,1580,0
3023049236,20140916T000000,350000,3,2.75,3070,5280,2360,710
9808700405,20140604T000000,1.90E+06,3,2.5,2660,13367,2660,0
2877102345,20141027T000000,511718,2,1.75,1700,5000,850,850
1924069058,20141010T000000,965000,4,3.25,5010,49222,3710,1300
9269260100,20141216T000000,475000,4,2.25,2680,4673,2680,0
2877104265,20150415T000000,1.06E+06,4,2.75,2720,4000,1840,880
3123039089,20140715T000000,252000,2,1,940,15450,940,0
8576400110,20150317T000000,580000,6,2.5,3596,13700,1798,1798
7660600131,20141020T000000,374950,2,2.25,1240,1172,1000,240
2296500131,20141216T000000,739000,5,4,4660,9900,2600,2060
1761300850,20141217T000000,271000,4,1.75,1710,7200,910,800
6083000037,20140613T000000,230000,2,1,930,7550,930,0
5259800090,20150427T000000,210000,3,2.25,1430,9150,1070,360
2968801366,20150224T000000,350000,3,2.75,1650,5700,1650,0
2126059172,20150506T000000,491500,3,2.25,1560,12000,1110,450
7334501250,20140909T000000,325000,3,2.5,1870,9825,1250,620
1545805490,20141006T000000,190000,3,2,1320,7625,1320,0
7518500855,20150504T000000,658600,4,2,1400,4690,1400,0
4171200025,20150327T000000,299950,3,1.5,1940,8951,1300,640
9818700215,20150330T000000,464000,5,2,2000,3000,1200,800
798000535,20140625T000000,308000,3,1,1640,18144,1640,0
3900100265,20150129T000000,625000,3,1,1020,7650,1020,0
1951100110,20150205T000000,240000,3,1.75,1630,9450,1080,550
7215420590,20150504T000000,530000,4,2.5,2940,35996,2940,0
3343301910,20141020T000000,1.00E+06,5,4.5,2120,8944,2120,0
9828702095,20140925T000000,439000,1,1,790,2400,790,0
2917200645,20150511T000000,575000,4,1.75,2020,6200,1010,1010
6163900501,20141021T000000,418000,3,1.75,1530,7238,1530,0
540100057,20150428T000000,1.21E+06,4,3.75,3250,10949,2940,310
2652500300,20140603T000000,1.10E+06,4,3.75,2930,3200,2130,800
1330300300,20150415T000000,1.90E+06,3,3.75,3150,8550,3150,0
1137301780,20141126T000000,580000,3,2.5,2180,40278,2180,0
9842300485,20150311T000000,380000,2,1,1040,7372,840,200
7224000315,20140723T000000,256000,3,1,880,5375,880,0
6161000015,20140515T000000,349950,3,1,1400,7066,1400,0
5207200195,20140701T000000,691500,4,2.5,2600,7200,2600,0
9191201790,20141031T000000,556000,3,1.75,1590,2500,1190,400
8731902680,20141120T000000,218000,3,2.25,1610,7084,1280,330
9448300115,20141205T000000,425000,4,2,1390,4500,1390,0
4045500625,20140822T000000,935000,3,3.25,3710,38509,3710,0
5603700025,20141007T000000,732000,4,1.75,2360,11300,2360,0
1266200015,20150127T000000,805500,3,1,1440,10330,1440,0
952003350,20150204T000000,507250,3,1.75,1400,5750,1100,300
2386000300,20141202T000000,800000,4,2.5,4600,67369,4600,0
3625059143,20140903T000000,600000,3,2.25,2100,8276,2100,0
8651500850,20150317T000000,627800,4,1.75,2010,12044,2010,0
3359500110,20140624T000000,660000,2,2.25,2550,6000,1860,690
818500490,20141009T000000,153503,2,2.5,1240,3649,1240,0
3876311390,20150120T000000,456500,3,2.25,2090,9163,1460,630
8085400490,20140801T000000,1.31E+06,5,2.5,2770,8100,2770,0
2355010090,20141207T000000,843500,3,2.5,3560,11448,3560,0
9550200265,20140818T000000,625000,3,1,1240,4080,1240,0
8818400490,20140611T000000,527000,2,1.75,1640,4080,840,800
8964800025,20150226T000000,1.97E+06,5,3.75,3940,13738,3940,0
2125059112,20150326T000000,1.00E+06,5,2.5,3150,50094,3150,0
2028700535,20150225T000000,855000,4,3,2550,5300,1720,830
4309710100,20140620T000000,725000,4,3.25,3940,27591,3440,500
4364700805,20141015T000000,315000,1,1,580,7200,580,0
3356407665,20140924T000000,180000,3,1.75,1330,16000,1330,0
9238900855,20150313T000000,700000,2,1,930,5000,930,0
1086100100,20140811T000000,476500,3,1,1060,8625,1060,0
6121000110,20140603T000000,193000,3,1.5,1180,9048,1180,0
8700100100,20140819T000000,295000,4,2.5,1850,6663,1850,0
9417400215,20140731T000000,363000,2,1,820,4880,820,0
7701961030,20150129T000000,875000,4,2.5,3600,21794,3600,0
2149800148,20140514T000000,257200,3,2,1850,8250,1150,700
686450490,20140929T000000,555000,3,2,2240,11250,2240,0
9413400165,20140624T000000,380000,3,2.25,1860,15559,1860,0
104550690,20140725T000000,282000,4,2.75,2390,7330,2390,0
1995200245,20140606T000000,545000,4,2.5,2040,6034,2040,0
7409700215,20140606T000000,550000,3,1.5,1900,5000,1640,260
7409700215,20150313T000000,921500,3,1.5,1900,5000,1640,260
1337800855,20150512T000000,885000,3,1.5,2200,2880,1440,760
7015200615,20140529T000000,820000,4,2.25,2280,6660,1960,320
8805400090,20140513T000000,289000,3,1,1090,7315,1090,0
2391602350,20150213T000000,334000,1,1,670,5750,670,0
844001140,20141028T000000,206000,3,1,1050,5233,1050,0
5210200131,20140630T000000,491950,3,2.25,2090,10733,1440,650
6893300110,20141113T000000,430000,3,2.5,2030,7770,2030,0
1796351080,20140718T000000,208000,3,2,1250,7995,1250,0
1938400300,20140708T000000,245000,4,2.25,2600,6390,1390,1210
2877101340,20150318T000000,426000,2,1,640,2500,640,0
6084200100,20140801T000000,400000,3,2.5,2120,3742,2120,0
7977201910,20150414T000000,553000,3,1,1330,5100,900,430
6638900115,20150331T000000,296000,2,1,750,4680,750,0
2587920110,20150217T000000,428000,3,2.5,2230,32660,2230,0
3438500714,20140506T000000,325000,4,2.5,1890,6156,980,910
726049184,20140721T000000,294000,2,1,820,6366,820,0
2787720300,20150319T000000,410000,3,1.75,1880,8424,1380,500
2821049048,20140603T000000,590000,4,4.25,2360,57514,2360,0
3904901450,20141120T000000,445000,3,2.25,1850,4050,1850,0
9829200495,20150325T000000,921000,4,2.5,2310,5362,2010,300
1523089097,20150304T000000,496000,3,1.5,2520,37616,2520,0
2724200705,20141212T000000,95000,2,1,800,8550,800,0
8122600245,20140925T000000,359000,4,1.75,1580,6396,790,790
1323089184,20140502T000000,452500,3,2.5,2430,88426,1570,860
2600300110,20141202T000000,555000,4,1.75,2350,6200,1410,940
9485951030,20140924T000000,549900,5,3,3800,42316,3800,0
4021700025,20140610T000000,569000,5,3,3670,10583,2060,1610
2473250850,20140716T000000,318500,4,2,1780,7350,900,880
9828702310,20140611T000000,487028,2,1.5,1295,1093,1105,190
7523700245,20141015T000000,240000,3,1,1350,7560,950,400
1765100025,20150202T000000,253000,3,2.25,1440,9806,1440,0
2011400405,20140831T000000,380000,5,1.75,1320,38125,1120,200
3410600015,20150406T000000,250000,2,0.75,700,16828,700,0
3276050110,20141010T000000,368500,2,1.75,2510,19141,2510,0
7792000025,20150211T000000,340000,3,1,3180,27586,1400,1780
2810600015,20150427T000000,400000,2,1,910,4000,910,0
8081900011,20140916T000000,835000,3,2,1570,4625,1570,0
104550740,20141201T000000,299000,3,2.5,2450,7062,2450,0
1959701745,20141107T000000,1.68E+06,6,2.25,4910,6600,3580,1330
8078520090,20140514T000000,265000,3,2,1570,5706,1570,0
6403510090,20141111T000000,437500,4,2.5,2680,7513,2680,0
2326300090,20140604T000000,865000,3,1.75,2090,4725,1610,480
8078380090,20150311T000000,626000,3,2,2150,7200,2150,0
7132300042,20141028T000000,247300,2,2,1140,1118,1040,100
3861470110,20140623T000000,2.08E+06,4,3.5,4230,20377,4230,0
2734101055,20141001T000000,425000,3,1,1790,6000,1790,0
4039701080,20140625T000000,905000,5,3.5,3100,10200,1660,1440
464000600,20140827T000000,641250,3,2.5,2220,2550,2220,0
5437400100,20150331T000000,675000,4,2.5,2370,9679,2370,0
1423089055,20140613T000000,845000,4,2.75,4070,115434,4070,0
6713700100,20140907T000000,401500,4,1,1790,8400,1260,530
339600110,20140923T000000,395000,3,2.5,1610,3755,1610,0
5021900090,20150306T000000,1.10E+06,5,2.75,2830,18050,1630,1200
6099400053,20140529T000000,145000,3,1,1010,5490,1010,0
7518508625,20150416T000000,900000,3,1,1560,3825,1390,170
8143000490,20150112T000000,374500,3,1.5,1330,8636,1330,0
3260000300,20141118T000000,850000,4,2.25,2330,10451,2330,0
5742600090,20150425T000000,490000,3,1,960,5750,960,0
7212650850,20150427T000000,304000,3,2.5,1710,6773,1710,0
9158800090,20140703T000000,400000,4,2.25,2230,7200,1300,930
7820000038,20141114T000000,454000,3,2,1700,10000,1700,0
7135300026,20141224T000000,160000,2,2,1040,4750,850,190
8562700300,20140708T000000,542000,3,1.75,1070,8030,1070,0
6114400028,20140618T000000,403500,5,2.5,3600,17300,2410,1190
3793501130,20150316T000000,418000,4,2.5,2750,8471,2750,0
6052400625,20150326T000000,406000,4,1.5,1920,6000,1920,0
2560805630,20140923T000000,242500,3,2.25,1770,10000,1340,430
9558020600,20150407T000000,425000,4,2.5,2460,5440,2460,0
9136101335,20140515T000000,613000,4,2,1550,4815,1550,0
9407101380,20141230T000000,189000,3,2,1460,11481,1170,290
8901500178,20141030T000000,700000,4,2.25,2440,9450,2440,0
9551201250,20140902T000000,750000,3,1,1640,6516,1440,200
3544400236,20140707T000000,494000,2,1,1290,4650,1290,0
7215730090,20140609T000000,700000,4,3,3150,7778,3150,0
8682291390,20150403T000000,705000,2,2.5,2305,5580,2305,0
1770000490,20140522T000000,356000,2,1.75,1060,16470,1060,0
2935400100,20140522T000000,625000,3,1.75,2060,12558,1350,710
7686205020,20150312T000000,144975,2,1,900,7500,900,0
3629921240,20140728T000000,970000,4,4.5,3890,5906,3060,830
1775801340,20140606T000000,415000,3,1.75,1910,12596,1340,570
3574801780,20140505T000000,485000,4,3,2340,7048,1340,1000
7854800090,20141107T000000,799950,3,3,2900,11769,2900,0
4054530090,20150429T000000,783350,4,2.5,3290,35001,3290,0
8807900236,20141219T000000,430000,1,1,630,1362,630,0
1118001408,20141124T000000,2.54E+06,5,4.75,5410,13431,5050,360
9290850740,20140618T000000,975000,4,2.5,4270,43386,2680,1590
3025059089,20150505T000000,950000,3,1.5,1700,8050,1130,570
923000265,20140806T000000,350000,2,1,1430,8157,1150,280
8901001335,20141103T000000,637000,4,2.75,2850,7510,2850,0
1523059066,20150219T000000,895000,3,2,2160,105415,2160,0
5249801785,20141205T000000,579000,2,2,1760,7200,880,880
2190601055,20140624T000000,314900,4,1.75,2700,27072,1380,1320
1917300025,20150127T000000,122000,2,1,860,6000,860,0
3797000300,20140808T000000,405000,2,1,880,3000,880,0
5332200026,20140508T000000,553650,2,2.5,1360,1349,1050,310
3278602760,20150203T000000,369900,2,2.5,1770,1853,1770,0
2721049059,20140528T000000,225000,3,2,2030,24829,1220,810
2172000750,20140527T000000,160000,2,1,1180,9350,1180,0
1022069058,20141009T000000,449500,4,2,2430,199940,1310,1120
249000115,20140828T000000,650000,3,1,1300,8266,1300,0
7214710300,20140716T000000,542126,4,2.5,2360,43088,2360,0
192450300,20140919T000000,309950,3,1.5,1200,15606,1200,0
3356403820,20141205T000000,115000,2,1,1000,16524,1000,0
8075400100,20141231T000000,221700,2,1.5,1556,20000,1556,0
1982200245,20150127T000000,726000,3,2.5,1890,3880,1460,430
7905200037,20141119T000000,515000,3,1.75,1810,5733,1010,800
2597531030,20140826T000000,756000,4,2.5,2730,10753,2730,0
5318100645,20140527T000000,1.57E+06,4,3.75,3070,5850,2400,670
7504400850,20140521T000000,442000,4,2.25,2080,12007,1220,860
1761300110,20140702T000000,260000,4,2,1620,7992,1620,0
9390700100,20140910T000000,390000,2,1.75,1150,2723,770,380
7518503200,20140701T000000,459500,2,1,1250,3825,850,400
3971700940,20140930T000000,330000,3,1.5,1430,8000,1430,0
1446403835,20141103T000000,189000,2,1,790,7128,790,0
9183702251,20141211T000000,280000,3,1,1200,9322,1200,0
5589900590,20140505T000000,400000,2,1.75,2110,9519,2110,0
7227501745,20150325T000000,368000,4,2,3160,11193,2410,750
2473350930,20140609T000000,390000,4,1.75,2700,7875,2700,0
6450303820,20140930T000000,245000,2,1,820,7475,820,0
5469000100,20140806T000000,375000,4,2.5,1800,8432,1200,600
8679600100,20150130T000000,465000,5,1.5,1750,12491,1390,360
638100015,20150312T000000,445000,3,2,1540,67953,1540,0
3241600015,20150305T000000,250000,3,1,1130,7800,1130,0
6411600026,20141003T000000,475500,3,1,1500,9416,1500,0
3179101050,20140804T000000,672324,2,1.75,1600,5795,1600,0
5363200266,20140623T000000,420000,3,2,1200,5029,880,320
7518502490,20141229T000000,515000,3,2,1690,5100,1690,0
7732400490,20141105T000000,732350,4,2.5,2270,7665,2270,0
5416510110,20140605T000000,297500,4,2.5,1910,5000,1910,0
8604900017,20141008T000000,475000,3,1.5,1640,2720,1640,0
808300490,20150505T000000,414000,4,2.5,2120,6497,2120,0
6855700115,20140626T000000,357250,3,1.5,1400,8840,1400,0
9325800110,20141030T000000,289950,2,1,760,6000,760,0
8121100015,20150505T000000,550000,3,1,1070,3713,1070,0
8568700015,20150423T000000,446000,3,1.75,1460,9998,960,500
6399600115,20141015T000000,279000,3,1.5,1280,16738,1280,0
5651010300,20140821T000000,370000,3,2.25,1650,4859,1650,0
3423049311,20141017T000000,216000,3,2,1260,4125,1260,0
7000100711,20140621T000000,1.10E+06,3,2.5,2200,20000,1400,800
5482700115,20141020T000000,1.28E+06,4,2.5,3560,15450,2060,1500
9349900110,20150217T000000,355000,2,1.5,1140,2500,630,510
9328510100,20140911T000000,699000,4,2.5,2550,7312,2550,0
6300500475,20140902T000000,412000,3,2.5,1553,1991,1553,0
7849200315,20150205T000000,276000,2,1,1140,7200,1140,0
7813200115,20140904T000000,100000,2,1,790,6426,790,0
2851200100,20140701T000000,955500,4,1.75,2130,5080,2130,0
2823059055,20150329T000000,199000,3,1,1390,21262,1390,0
7853301560,20140625T000000,762000,4,3.5,4000,15253,4000,0
9477001280,20140506T000000,425000,4,2,1520,7983,1520,0
7905200147,20141104T000000,546000,2,1,1657,5031,1657,0
6190701110,20150420T000000,419600,3,1.75,1680,8460,1180,500
871001500,20140623T000000,735000,4,2.25,2270,5102,1340,930
2559950110,20150422T000000,1.23E+06,2,2.5,2470,609,1910,560
3693900245,20140707T000000,445000,2,2,1240,2500,1240,0
1023089140,20150106T000000,665000,3,2,1740,41275,1740,0
3026059085,20150317T000000,1.29E+06,5,3.5,4090,290980,2920,1170
3575302345,20141208T000000,508500,4,2.75,2520,12500,1720,800
1568100076,20141210T000000,345950,5,1,1340,11198,1340,0
6600400090,20150113T000000,207500,3,1,1640,9750,1640,0
5451200110,20141204T000000,1.08E+06,4,2.5,3000,10920,1550,1450
3204300090,20141110T000000,640000,3,1,1210,3720,1210,0
3023039066,20150323T000000,329500,3,1,1810,13068,1360,450
3824100246,20141021T000000,460000,4,2.75,2200,9676,1500,700
7768700315,20140630T000000,1.23E+06,3,1.75,2200,14630,2200,0
4154305290,20141120T000000,805000,5,3,2350,6480,1650,700
621069113,20141218T000000,200000,3,1.5,1090,10454,1090,0
1523059201,20150217T000000,749700,3,1.75,2280,77972,1460,820
1453602309,20140805T000000,288000,0,1.5,1430,1650,1430,0
7518504291,20141215T000000,535000,2,1,1520,3360,830,690
4058801240,20141028T000000,330000,3,2.25,1620,7150,1280,340
2313900165,20140730T000000,479200,3,2,1510,3750,1510,0
2122059206,20140513T000000,373000,5,2.5,3001,5710,3001,0
9282801720,20150319T000000,355000,4,1.5,2020,6000,1010,1010
9542840590,20140602T000000,275000,3,2,1380,4500,1380,0
2493200015,20140620T000000,380000,3,1.5,1520,4288,1020,500
9550202870,20150209T000000,417000,2,1.75,1090,4590,790,300
98000750,20141021T000000,1.17E+06,5,3.75,4220,15959,4220,0
7504010900,20140926T000000,598500,3,2.25,2520,12000,2520,0
1370803820,20140602T000000,629000,3,2,1760,5000,960,800
1446401220,20141009T000000,226950,2,1,930,6600,930,0
868000615,20141231T000000,1.23E+06,4,2.5,2600,11542,2200,400
6625910100,20150203T000000,415000,3,2.25,2180,11100,1700,480
3629870110,20150422T000000,595000,3,2.5,1910,3075,1910,0
8651400750,20141028T000000,209950,3,1.75,1100,5525,1100,0
925069111,20150507T000000,568000,3,1.75,1760,235224,1760,0
3352402250,20141021T000000,119900,2,1,700,3180,480,220
4168000110,20140826T000000,207000,3,1,1080,10200,1080,0
5647900930,20141215T000000,195000,3,1,1070,22489,1070,0
2523039278,20140624T000000,324950,3,1.5,1460,8710,1460,0
6149700405,20141222T000000,210000,1,1,1050,7583,1050,0
203100690,20150425T000000,1.08E+06,4,2.75,3160,42733,3160,0
4410600100,20141204T000000,325088,4,1,1400,6739,1000,400
3223059303,20150116T000000,790000,4,3,3120,157875,3120,0
522069097,20141125T000000,150000,2,1,720,212137,720,0
2023069059,20141030T000000,790000,3,3,2840,206910,2840,0
7987400356,20140512T000000,255000,2,1,1220,2500,770,450
461005360,20141107T000000,697000,4,3,2820,2850,1860,960
461004195,20141104T000000,457500,2,1,840,5000,840,0
9547204350,20140519T000000,690000,3,2,1610,5100,1610,0
2331300025,20150311T000000,967000,4,3.25,1860,4356,1860,0
2288000090,20150429T000000,980000,4,1.75,2260,17711,2260,0
5525400300,20140521T000000,619420,4,2.75,2450,14803,2450,0
9523103001,20141013T000000,389000,2,1,850,3276,850,0
5249802460,20141210T000000,500000,3,1,1800,7200,1020,780
7000100850,20140926T000000,569000,4,1.75,1230,7890,1090,140
9477000300,20140728T000000,425000,4,2.25,2060,8540,1540,520
8121100265,20140521T000000,635000,4,2.25,2750,6180,1500,1250
2817100900,20140519T000000,256500,2,1,1120,9912,1120,0
3578700017,20150123T000000,695000,4,2.5,3010,11393,3010,0
7550800195,20140730T000000,535000,4,1.5,1580,5000,1390,190
3449900090,20150410T000000,454200,4,2.5,2630,5379,2630,0
9232900165,20150123T000000,418500,2,1,790,5800,790,0
1137300900,20140605T000000,749950,4,2.75,3110,35235,3110,0
2617370090,20141019T000000,338500,3,1.75,2130,5489,1370,760
5452301800,20140722T000000,1.25E+06,4,3.75,4520,9240,3270,1250
6648760100,20140711T000000,299950,3,2.5,1600,9830,1600,0
798000337,20140731T000000,325000,4,1.75,1950,12500,1330,620
1737300110,20140826T000000,434000,4,3,2010,8171,2010,0
2817800100,20140701T000000,328950,4,1.75,2550,8976,1300,1250
5700003640,20140519T000000,2.10E+06,5,3.75,5340,10655,3740,1600
824069156,20150429T000000,570000,4,2,2000,46902,2000,0
1997200165,20140916T000000,802000,3,2.25,2170,5001,2170,0
4083301645,20141024T000000,525000,3,1,1550,6840,1550,0
3880900245,20150202T000000,700000,6,3,2790,4550,2790,0
1322059002,20150319T000000,350000,3,1.75,1980,273556,1040,940
2426039313,20150218T000000,277500,2,1.5,1190,1236,1190,0
6448000090,20140512T000000,1.58E+06,5,2.75,3650,20150,2360,1290
8005100025,20140919T000000,195000,3,1,1510,4350,1510,0
2891000750,20140821T000000,222000,3,2,1200,6074,1200,0
5456000110,20150416T000000,865000,5,3,2830,8854,1500,1330
5393601050,20140509T000000,445000,4,2,1650,6000,1000,650
2979801095,20141209T000000,495800,4,1.5,1710,4600,1710,0
6840701095,20150403T000000,548500,3,1,1740,4400,1740,0
2221000100,20140507T000000,310000,3,1.75,1840,10723,1220,620
5070000100,20140711T000000,205000,3,1.5,1820,8585,1820,0
3793501450,20140910T000000,470000,5,3.75,3860,6901,3860,0
321079066,20150423T000000,430000,3,1.5,1810,349351,1810,0
2026049125,20150501T000000,310000,2,2,1030,2271,1030,0
1844500025,20150325T000000,355000,4,1,1410,7693,1410,0
3541600405,20150127T000000,621500,5,2.5,2140,15950,1370,770
1823049202,20140610T000000,175000,6,1.5,1930,8400,1030,900
1823049202,20150107T000000,326000,6,1.5,1930,8400,1030,900
1563100705,20140912T000000,690000,4,3.5,1930,5400,1930,0
7968200090,20140819T000000,335000,4,2.5,2210,7214,2210,0
5379802816,20150224T000000,197000,4,1,1360,11175,1360,0
3340401570,20140703T000000,312500,3,1.75,1830,7969,930,900
7300700056,20141029T000000,436000,3,2.25,2120,6710,1420,700
1257201130,20141001T000000,1.02E+06,4,2.5,2700,4590,2700,0
7526400100,20140826T000000,805000,4,2.5,3160,35225,2250,910
7504400750,20150105T000000,652427,4,2.25,2770,13129,2770,0
1525059112,20141018T000000,1.01E+06,3,2.5,2240,41339,2240,0
7300410300,20141106T000000,355000,4,2.5,2570,6466,2570,0
1326039039,20140729T000000,334550,2,1,880,12000,880,0
8100400110,20140708T000000,557500,3,2.25,1820,9670,1820,0
6385900090,20141103T000000,277500,4,2.25,1660,7184,1110,550
7229000025,20140707T000000,300000,4,3,2200,10800,2200,0
6145602355,20150225T000000,325000,4,1,1640,3844,1460,180
3600057,20150319T000000,402500,4,2,1650,3504,760,890
4040200490,20140820T000000,461000,3,1.75,1420,5170,1420,0
2919201095,20150327T000000,540000,3,1,1270,3840,1270,0
5248800625,20150316T000000,385000,3,1,1070,4000,1070,0
1257201295,20140708T000000,480000,2,1,1060,3040,860,200
3342700371,20140609T000000,539950,3,2.25,2190,7149,1240,950
1724079013,20140718T000000,529000,3,2.25,1940,217800,1940,0
2770606822,20140820T000000,417000,3,2.5,1300,877,1060,240
5706201930,20150217T000000,405000,3,1.5,1330,12500,1330,0
8731800300,20140723T000000,299000,3,2.25,1940,9100,1630,310
3751600457,20140813T000000,299000,3,1.75,2100,15480,2100,0
9169100214,20140514T000000,372220,3,1,1290,5500,980,310
809000820,20140522T000000,494400,2,1.75,1560,1750,780,780
9460000110,20140924T000000,280000,3,1.75,2630,6500,1330,1300
7888780090,20141121T000000,277950,3,2.5,2100,6021,2100,0
2423059067,20141219T000000,770000,3,2.75,2070,54557,2070,0
1331900110,20141008T000000,760000,4,2.5,2960,28005,2960,0
6600490300,20150126T000000,230000,2,2,1300,3608,1300,0
6042000090,20141002T000000,525000,4,2.5,2520,7731,2520,0
7846700850,20140701T000000,307000,3,1,1150,6000,1150,0
5381600110,20140618T000000,253779,4,2,2030,9600,1430,600
3459100300,20140617T000000,405000,3,1.5,1880,7400,1480,400
8151600590,20150312T000000,360000,2,1,2320,11250,2320,0
7936000252,20150511T000000,521000,2,1,1050,7500,1050,0
2825059256,20140926T000000,680000,4,2.5,3030,13068,3030,0
1925069006,20141203T000000,355000,1,0.75,530,33278,530,0
1274500300,20140623T000000,200000,3,1.5,1090,9600,1090,0
7129304085,20140708T000000,330000,3,2.25,2220,4060,1330,890
104540820,20140812T000000,221000,3,2.25,1430,5999,1430,0
9272200090,20150204T000000,1.60E+06,4,4.5,3780,6000,2770,1010
1787600164,20140723T000000,310000,2,1,1560,4920,780,780
8127700215,20150409T000000,862000,4,2.25,2220,4200,1310,910
7348200115,20140619T000000,200000,3,1.5,1140,8340,1140,0
7752200100,20140930T000000,630000,4,2.5,2540,11100,2540,0
3904901570,20150320T000000,432250,3,2.25,1440,6232,1440,0
1238501116,20150123T000000,478000,3,2.25,1570,9500,1070,500
9392500100,20140723T000000,249000,4,2.25,1860,9576,1400,460
7857003465,20140605T000000,495000,5,3,2440,4750,1450,990
4038700930,20141113T000000,630000,4,2.5,2100,8800,1240,860
6979920090,20140626T000000,550000,4,2.5,2150,27540,2150,0
1515920090,20140919T000000,350000,3,2.5,2440,18674,2440,0
2473100090,20141202T000000,270000,5,1.5,1930,7480,1930,0
6402700100,20141007T000000,488250,4,2,1830,9610,1830,0
104530490,20140516T000000,248000,4,3.5,1850,6519,1130,720
2487200940,20140814T000000,889000,4,3.5,3210,5000,3210,0
6132600315,20140827T000000,375000,1,1,1090,5250,980,110
6848200475,20141126T000000,933000,3,1.5,1870,3300,1870,0
2141310490,20150102T000000,625000,3,2.25,1920,8412,1460,460
7571200110,20140728T000000,328000,2,1,700,4350,700,0
5072300100,20140718T000000,470000,4,2.25,3380,9900,1690,1690
3342103148,20150213T000000,502500,5,2.5,2430,6168,2430,0
1770000090,20150407T000000,484000,3,1.75,1950,17400,1210,740
8658303585,20140807T000000,252500,2,1,900,7500,900,0
1115400090,20140821T000000,610000,3,2.5,2060,8893,2060,0
4400800061,20140725T000000,419000,4,2,2180,10447,1280,900
4137000590,20140717T000000,322500,4,2.25,2140,9377,2140,0
809000945,20150106T000000,563000,6,1,1730,2760,1250,480
4397000100,20150324T000000,464000,4,2.5,3140,12591,3140,0
3426049031,20140617T000000,870000,4,4.25,3010,4887,1940,1070
4310702775,20150203T000000,280000,2,1.5,800,1196,800,0
8965450110,20140912T000000,850000,3,2.5,3300,11570,3300,0
2887700805,20141022T000000,458950,2,1,1530,4370,1130,400
1446401460,20150422T000000,122000,2,1,760,5280,760,0
225039175,20140513T000000,525000,5,3,2450,4591,2450,0
1151100165,20140716T000000,286300,2,1,1000,31838,1000,0
4330600301,20140718T000000,218450,2,1,840,7425,840,0
2767602141,20140905T000000,525000,3,1.5,1380,4290,1080,300
2767602141,20141222T000000,650000,3,1.5,1380,4290,1080,300
2223089048,20140625T000000,356000,4,2,2020,48693,2020,0
3693900985,20140529T000000,436500,2,1,1260,5000,1040,220
3574801790,20140807T000000,410000,3,1.75,1440,7112,1180,260
2568800121,20140911T000000,512500,4,1.75,1540,8311,1540,0
5249804560,20140818T000000,510000,4,1,1060,7200,880,180
7811100100,20140918T000000,566000,4,1.75,1900,10297,1900,0
6116500300,20140910T000000,525000,3,1.75,2870,26500,2870,0
2489200165,20140807T000000,435000,3,1,1050,5500,930,120
425079100,20141231T000000,406500,3,2.75,1840,68479,1340,500
1828001220,20141007T000000,550000,5,2.75,3000,9473,1500,1500
5602000025,20150226T000000,251000,3,2,1200,10212,1200,0
191101015,20141211T000000,830000,3,1.5,1840,10125,1220,620
4249000100,20150414T000000,803000,4,2.5,2790,7673,2790,0
7877400266,20150407T000000,206000,3,1,970,9360,970,0
7657000165,20140730T000000,200000,4,1,1070,7467,1070,0
4302200535,20140506T000000,219000,2,1,900,5160,900,0
369000881,20140905T000000,777000,4,4,2680,6000,1380,1300
7527200110,20150218T000000,593700,3,2.5,2000,22000,2000,0
1561600025,20140603T000000,712500,3,1.5,1660,8797,1660,0
2813100100,20140714T000000,600000,4,1.5,1770,6014,1240,530
3179100755,20150330T000000,554663,3,2,1230,6802,1230,0
1422700110,20140703T000000,267000,3,1,1740,10875,1020,720
1075100090,20140924T000000,390000,3,2,1710,8910,1710,0
7338402690,20150401T000000,335000,6,2,2020,7071,1010,1010
5451210100,20150423T000000,938000,4,2.5,2410,9886,1990,420
7523900300,20150407T000000,370000,4,2.75,2310,14745,1410,900
7237300090,20150402T000000,335000,5,2.5,2400,4548,2400,0
4083303815,20150421T000000,695000,5,2,3160,3990,1870,1290
6117501015,20140606T000000,387500,3,1,1560,14333,1560,0
6700390100,20150318T000000,245000,3,2.5,1770,6187,1770,0
7334401450,20140729T000000,308550,3,2,1600,13200,1600,0
8588000315,20140624T000000,225000,3,1.75,1330,13102,1330,0
3121500100,20140903T000000,715000,4,2.5,2970,29163,2970,0
726049202,20150506T000000,335000,3,1,1020,10200,1020,0
3629760110,20140821T000000,634000,3,2.5,2490,4904,2490,0
8692800025,20140514T000000,337500,5,2,1700,7314,1000,700
4392200165,20140904T000000,440000,1,1,850,6567,850,0
1023089228,20140717T000000,350000,3,1.75,1250,13775,1250,0
7625702615,20150114T000000,400000,2,1,610,4560,610,0
8081030090,20140815T000000,1.29E+06,4,3.5,3700,13175,3700,0
2201500490,20150406T000000,435000,3,1,950,10080,950,0
7853250090,20140929T000000,681000,4,2.5,3860,5130,2930,930
7133300044,20140629T000000,397000,3,3.5,1360,1275,1240,120
293700110,20140926T000000,775000,4,2.5,3890,34513,3890,0
4038100110,20140707T000000,480000,3,2.25,1680,9090,1130,550
7697870600,20140909T000000,158000,3,2.5,1520,7200,1520,0
8847400115,20140723T000000,590000,3,2,2420,208652,2420,0
7853240100,20140902T000000,772500,5,2.75,3890,9130,3890,0
326049058,20150217T000000,464500,5,1.5,2940,13425,1470,1470
8732800090,20150424T000000,281000,3,1.75,1350,8737,1350,0
2526059086,20140722T000000,620000,3,2.25,2190,45738,2190,0
2391600165,20140617T000000,475000,3,2.25,2280,5750,1150,1130
7225000090,20141017T000000,245000,2,2,1070,4500,910,160
1868901295,20140729T000000,660000,5,2.25,2540,3750,1510,1030
6072100490,20141204T000000,527500,4,2.25,2270,8480,1310,960
2522069064,20141027T000000,135000,2,1,1220,7250,1220,0
806800090,20150506T000000,275000,3,1.75,1890,5000,1890,0
7228500375,20150210T000000,430000,4,2,1990,4740,1080,910
2891100820,20140825T000000,213500,3,1,1220,6000,1220,0
8564850300,20140912T000000,535000,3,3,2640,5978,2640,0
3861400061,20150213T000000,641000,3,1.75,1480,9603,1480,0
3343903647,20141028T000000,436300,3,2,2320,9420,2320,0
809002680,20141014T000000,1.44E+06,4,1.75,2410,6000,2410,0
5450300195,20150327T000000,830000,4,2.75,2090,13500,2090,0
1231001110,20140722T000000,380000,3,1,920,3532,920,0
6303401050,20150220T000000,132500,3,0.75,850,8573,600,250
1003400245,20141201T000000,179950,3,1,1130,9907,1130,0
7468900245,20150420T000000,188200,3,1,1260,7265,1260,0
5021900265,20140702T000000,659000,4,2,2090,10800,2090,0
8100900015,20141022T000000,317000,3,2,2020,7260,1180,840
573000490,20141124T000000,625000,3,2.25,1970,4564,1470,500
4022900837,20140613T000000,350000,3,1.75,1820,9545,1230,590
475001295,20140625T000000,750000,3,1.5,1840,5000,1340,500
5256500025,20140827T000000,457000,4,1.75,2100,10358,1280,820
2767601390,20150304T000000,632500,4,2,1770,5000,1770,0
6700400110,20140702T000000,223000,3,2,1110,7231,1110,0
8860300300,20140902T000000,610000,4,2.75,2090,8400,1240,850
3738900165,20141024T000000,385000,4,1.75,2080,8215,2080,0
1314300018,20150324T000000,367500,3,3.25,1400,1343,1160,240
3992700265,20140804T000000,385100,3,1,1060,8040,1060,0
1105000296,20141229T000000,230000,2,1,720,5913,720,0
1773100121,20140623T000000,286000,3,2.75,1100,750,780,320
7585000110,20150326T000000,201700,3,1,1010,9576,1010,0
822069112,20150423T000000,1.35E+06,4,4.75,5230,89298,5230,0
5423030300,20140519T000000,525000,4,1.75,2420,7672,1480,940
1387301730,20150202T000000,361000,3,1.5,1200,7236,1200,0
4447300008,20140923T000000,530000,3,1.5,1950,1963,1950,0
6413600123,20141008T000000,455000,3,2.25,1870,7403,1870,0
3288100100,20141120T000000,421000,4,2.25,1310,8400,1310,0
6127600110,20140502T000000,640000,4,2,1520,6200,1520,0
3423049165,20150331T000000,240000,3,1,1270,12733,1270,0
1233100601,20141024T000000,360000,2,1,840,7414,840,0
3422059085,20150324T000000,157340,2,1,900,23000,900,0
9294300600,20150415T000000,1.24E+06,4,3,3010,6139,2560,450
7282900025,20140506T000000,250000,3,1,1050,6874,1050,0
2526059076,20150225T000000,735000,6,2.75,3360,84506,2040,1320
5451100490,20150115T000000,884900,7,4.75,5370,10800,5370,0
126059097,20141023T000000,775000,3,3.5,2690,104544,2690,0
7739100015,20140502T000000,463000,3,1.75,1710,7320,1710,0
9828702251,20140623T000000,579000,3,2.5,1640,1269,1640,0
9558040820,20140709T000000,570000,6,3.75,4000,6015,3080,920
1437580600,20150331T000000,1.06E+06,5,4.5,4140,7924,4140,0
5469502460,20140909T000000,375000,4,2.75,3140,24800,2080,1060
2919701105,20141209T000000,422000,2,1.75,1320,2609,920,400
952003585,20150209T000000,866500,4,3.5,3080,4945,2010,1070
3066400750,20150413T000000,705000,3,2.5,2500,10359,2500,0
2607740100,20141029T000000,470000,4,2.5,2520,9684,2520,0
793200100,20141218T000000,360000,3,1.25,2350,6200,1320,1030
6744700900,20150429T000000,795000,4,2.5,2570,13450,1510,1060
1828300100,20150330T000000,800000,4,2.5,3100,7807,3100,0
1118000110,20140529T000000,2.45E+06,4,3.5,4730,13586,4270,460
9297301015,20150408T000000,277284,3,1.75,1030,4800,930,100
585000008,20150413T000000,460000,2,1,1020,4002,1020,0
4070700300,20150504T000000,898888,3,2.5,2080,3729,2080,0
3026079031,20140806T000000,211000,3,1,1410,47916,1410,0
2781250750,20140828T000000,222000,2,2,1360,3300,1360,0
203100625,20140529T000000,672000,3,2.5,2620,21587,2620,0
687600110,20141020T000000,778000,3,2.25,2260,33080,1690,570
2473372250,20150121T000000,312500,3,1.75,1490,9493,1490,0
7974700112,20140714T000000,650000,4,2.5,2530,6500,1720,810
2330000015,20140826T000000,740000,6,2.25,3140,10250,1570,1570
7230300100,20140826T000000,320000,3,2,1820,17600,1820,0
2133010110,20150508T000000,455000,4,2.5,1770,13168,1770,0
4389201250,20140513T000000,2.45E+06,5,4,4430,9000,4430,0
3383900057,20141203T000000,500000,3,3.25,1490,902,1220,270
2424410110,20140611T000000,325000,3,1.75,1790,27427,1130,660
3126049436,20140912T000000,416000,3,2.5,1710,1296,1510,200
9238500100,20150318T000000,495000,4,2.25,2070,20280,2070,0
9828700900,20140505T000000,549000,2,1,1140,5400,1140,0
686400930,20140825T000000,589000,5,2,3930,10150,3070,860
5515600088,20141121T000000,194820,3,1.5,1100,32700,1100,0
1254200015,20141216T000000,405000,3,2.5,2260,5500,1280,980
1254200015,20150408T000000,625000,3,2.5,2260,5500,1280,980
1523049209,20141113T000000,205000,3,1,1130,7014,1130,0
561000300,20140623T000000,345100,3,3.75,1950,8625,1360,590
399000195,20141020T000000,200000,3,1,960,7500,960,0
2540700110,20150212T000000,1.91E+06,4,3.5,4210,18564,4210,0
2523089097,20141029T000000,524500,3,1.5,3430,264844,2230,1200
3026079055,20140826T000000,598600,4,2.75,3470,212639,2070,1400
1105000011,20141209T000000,367777,5,3,2140,5937,1280,860
5113400535,20140507T000000,750000,3,2.75,2520,5401,1360,1160
3876301140,20141105T000000,575000,5,2.25,3550,7992,3550,0
1523049188,20150430T000000,84000,2,1,700,20130,700,0
5621100115,20141218T000000,255000,2,1,740,5000,740,0
4219401080,20140520T000000,1.74E+06,4,3.75,3300,4545,2600,700
2112700600,20150513T000000,415000,3,2.25,1640,5880,1240,400
3222049112,20150507T000000,449900,3,2.5,2780,8225,2780,0
622059019,20140919T000000,220000,5,1.5,1830,94960,1830,0
9348700490,20150410T000000,899000,4,2.5,3540,9349,3540,0
9259900025,20140714T000000,430000,3,2.5,1440,7320,1440,0
3022059066,20150130T000000,472500,4,2.5,2960,223462,2960,0
1777500090,20141229T000000,680000,6,2.5,3180,9375,1590,1590
3885803245,20150305T000000,1.65E+06,5,4,3310,8400,3310,0
8819901030,20141118T000000,810000,3,2,2390,8025,2390,0
2623069067,20150305T000000,605000,3,2.5,2460,138085,2460,0
8635700025,20140725T000000,522000,3,1.75,1630,15600,1630,0
98020300,20150203T000000,759000,5,2.75,3490,8230,3490,0
7243500025,20140519T000000,411000,4,2.75,2500,5257,2500,0
3329510850,20150306T000000,286950,4,2.5,2080,9846,1240,840
9521100855,20140610T000000,440000,3,1.5,1290,1286,1290,0
723049156,20140523T000000,149000,3,1,1700,8645,1700,0
723049156,20141112T000000,284700,3,1,1700,8645,1700,0
5130000090,20140909T000000,374950,3,2.5,2540,11562,1290,1250
8562400025,20140916T000000,816000,3,1.5,1180,8545,1180,0
5706201140,20141121T000000,533250,4,1.75,1520,15398,1370,150
3034200198,20140603T000000,689800,3,2.75,2390,9313,1390,1000
4077800017,20140813T000000,775000,4,2.75,2740,6200,1820,920
1245500099,20150506T000000,702000,3,2.5,2190,8528,1760,430
4435000705,20140708T000000,160000,3,1,1350,8700,1350,0
4435000705,20150309T000000,255500,3,1,1350,8700,1350,0
2225059118,20141202T000000,949000,4,2.75,2980,42253,1860,1120
5126900405,20140731T000000,169500,2,1,790,7450,790,0
5603800110,20140915T000000,586000,4,2.25,2130,9000,2130,0
2426059076,20150203T000000,680000,4,2.5,2700,37431,1600,1100
3260200110,20141208T000000,851500,3,2,3200,18184,2000,1200
4235401055,20140514T000000,582500,2,1.5,1159,4800,1159,0
1550000463,20140826T000000,637000,4,3.5,3080,118918,3080,0
1823049144,20150128T000000,225000,3,1,1000,9295,1000,0
7012200215,20141231T000000,795000,3,3.25,2260,3727,1880,380
5149300100,20140818T000000,304999,4,2.25,2270,9600,1290,980
7335400215,20150505T000000,95000,1,0.75,760,5746,760,0
7227501450,20141016T000000,240000,4,1.75,1420,5382,1040,380
8146300025,20140813T000000,772000,4,2.5,2500,8680,1250,1250
3530540090,20141113T000000,245000,2,1.5,1450,6258,1450,0
9284802215,20141205T000000,430000,5,3,2500,5750,1430,1070
1250202430,20140611T000000,799000,3,1.5,2210,6300,2210,0
1241900028,20150417T000000,880000,5,2.75,3020,9187,3020,0
8691400600,20141208T000000,750000,4,2.5,3290,7538,3290,0
1118000301,20141219T000000,2.89E+06,4,4,5780,7173,4130,1650
3905081500,20140604T000000,532000,3,2.5,1820,4910,1820,0
5611000090,20140805T000000,525000,4,2.75,2500,10330,1380,1120
2013800705,20141117T000000,239000,2,1,1210,9375,1210,0
9276200850,20140616T000000,460000,2,1.5,1090,4000,970,120
2785000110,20140605T000000,540000,4,2.25,1330,8400,1330,0
2919702655,20140606T000000,475000,2,1,890,4590,890,0
3942900115,20150421T000000,445000,3,1.75,1360,4998,1360,0
5452301810,20140905T000000,1.58E+06,5,3.75,4220,9240,3420,800
5104511730,20150409T000000,549950,4,2.5,3780,6800,3780,0
3923400123,20141017T000000,294950,4,2,2610,14321,1690,920
2249500367,20141021T000000,736000,3,2.5,1980,2975,1980,0
2916600110,20150430T000000,214946,3,1.75,1290,8688,1290,0
3629921140,20141030T000000,856000,5,3.25,3620,5500,3620,0
8682250090,20140504T000000,775000,2,2.5,2680,7392,2680,0
6929602605,20150203T000000,205000,3,1.75,1200,8631,1200,0
8550001515,20141001T000000,429592,2,2.75,1992,10946,1288,704
1775800740,20150206T000000,414250,4,1.75,1640,13566,1120,520
1773101340,20150202T000000,399950,4,2.75,1920,4400,960,960
5561710110,20141014T000000,319990,3,2.25,1840,7326,1370,470
1115800110,20150109T000000,524000,3,1.5,1310,9471,1310,0
2131701240,20150108T000000,349950,2,1,1050,6317,1050,0
8827901450,20141031T000000,889000,4,2.5,2570,4480,1580,990
4302200336,20140707T000000,300000,3,1,930,5160,930,0
7550800916,20140602T000000,395000,1,1,730,3000,730,0
534000112,20150203T000000,348000,2,2.5,1270,1242,1270,0
3885801450,20150226T000000,830000,2,1,1150,6000,710,440
522059013,20140612T000000,173000,2,1,820,10450,820,0
3342700405,20140522T000000,585000,4,1.75,3000,42200,1500,1500
9276201140,20150213T000000,576750,3,2,2220,5000,1110,1110
7972601280,20150504T000000,495000,5,3.25,2500,7620,1250,1250
2734100734,20141015T000000,216650,3,3.5,1540,1427,1360,180
4022900077,20150413T000000,615000,4,2.75,2750,15450,1800,950
1777600490,20141024T000000,675000,4,2.5,3130,12463,1620,1510
2193310300,20150401T000000,510000,3,2,1430,9250,990,440
2322069168,20140507T000000,630000,3,2.5,2680,327135,2680,0
7885800900,20140801T000000,359950,4,2.5,3010,5701,3010,0
1545800090,20141003T000000,265000,3,1.5,1530,7500,1530,0
7131300025,20140521T000000,210000,3,1,1240,4842,1240,0
3221079055,20150325T000000,367000,3,2.5,2260,93218,2260,0
9184700535,20150413T000000,1.08E+06,4,2.25,2820,5000,1800,1020
1877500090,20150211T000000,756000,3,2.5,3560,8297,1650,1910
723049476,20140724T000000,203000,3,2.25,1630,9145,1630,0
8556800100,20150121T000000,535000,4,2.5,2880,23994,2880,0
9830200475,20150323T000000,525000,3,3.25,2200,7440,1710,490
2525000690,20150309T000000,347500,3,1.75,1620,7500,1220,400
1891100090,20140505T000000,620000,3,1.75,1480,2185,1480,0
3447000100,20150422T000000,645000,4,2.5,2250,10696,2250,0
1118001295,20141203T000000,2.20E+06,4,3,3540,11098,3000,540
7968460110,20140619T000000,280000,3,2,1790,42399,1790,0
5101406489,20150501T000000,432000,3,2,1400,6380,700,700
9275702350,20141222T000000,790000,3,1.5,2390,4452,1790,600
7752000090,20150113T000000,635000,4,1.75,2400,10050,2400,0
293000165,20140819T000000,442000,3,1.5,2050,6384,1350,700
7852100110,20150422T000000,490000,4,3,2640,5267,2640,0
1311000600,20140925T000000,250000,5,1.75,2320,7700,1290,1030
1732800820,20140619T000000,1.33E+06,4,2.5,2440,3600,2440,0
7893203565,20141027T000000,120000,3,1,1260,7500,1260,0
2524049166,20140918T000000,2.95E+06,5,4.75,6240,47480,4610,1630
9406550100,20140923T000000,325000,4,2.5,1930,8458,1930,0
3327000090,20140612T000000,210000,4,1.75,1200,7680,1200,0
1220000100,20150504T000000,215000,1,1,970,7639,570,400
1066600025,20141029T000000,387000,3,1.75,1810,10800,1210,600
3626039228,20140918T000000,408000,3,1,1380,7015,1380,0
7635801032,20140710T000000,410000,3,1,1470,6500,1470,0
4364700600,20141216T000000,216000,3,1,1010,7920,1010,0
4364700600,20150330T000000,390000,3,1,1010,7920,1010,0
7774200236,20141211T000000,357000,3,1.5,1340,11744,1340,0
8025700590,20140519T000000,215000,3,1,970,7275,970,0
7129302095,20150213T000000,265000,3,1,1122,6554,1122,0
2997800076,20141209T000000,589950,3,2.75,1670,1350,1350,320
7740100015,20150206T000000,440000,3,1.75,2840,16851,1600,1240
5279100625,20150429T000000,248000,2,1,770,8600,770,0
1126059144,20140911T000000,730000,3,2.25,2040,130680,2040,0
5409800110,20150119T000000,425000,4,2.5,3052,12145,3052,0
7963900100,20140912T000000,680000,3,2.5,2620,14248,1830,790
9264910100,20150218T000000,341500,5,2.25,3120,10400,3120,0
8819900449,20150508T000000,395000,2,1,1100,3975,900,200
1525059160,20140731T000000,1.23E+06,4,2.75,3410,95396,3410,0
7526800100,20140708T000000,695500,5,2.75,2510,9180,1600,910
6385100100,20141002T000000,308000,3,1.75,1680,8629,1200,480
2085200261,20150218T000000,422500,3,2,1960,6450,1000,960
3522900061,20150421T000000,418000,2,1,1040,6900,1040,0
2570500090,20141007T000000,385000,5,1.5,1750,9780,1750,0
5482700100,20140512T000000,876650,3,3.25,2170,12508,1650,520
567000268,20140821T000000,450000,3,2.5,1639,2710,1479,160
3649100315,20140625T000000,418800,4,2.25,2100,9984,1290,810
6821102352,20141008T000000,330000,2,1,880,1753,880,0
6072300110,20150416T000000,550000,3,1.75,1940,8376,1290,650
3223049131,20141030T000000,270000,4,2.5,2490,11650,1390,1100
1068000110,20150429T000000,978500,3,2.25,2060,7080,1800,260
2600020100,20140930T000000,975000,4,2.5,2720,10455,2500,220
5422500110,20140725T000000,455000,3,2.25,2180,6850,1750,430
4055700378,20141009T000000,1.42E+06,4,3.25,3600,38016,3310,290
795000820,20150406T000000,220000,2,1,840,9000,840,0
925059113,20140813T000000,490000,3,2,2370,12196,2370,0
3275000090,20150421T000000,420000,4,2.25,2270,9100,2270,0
8946700100,20141208T000000,408500,4,2.5,2720,7043,2720,0
809002485,20150327T000000,716000,3,1.5,1140,4800,1140,0
5332200405,20140602T000000,965000,4,2.5,2460,5000,1620,840
1775950100,20150113T000000,357823,3,1.5,1240,9196,1240,0
9808700762,20140611T000000,7.06E+06,5,4.5,10040,37325,7680,2360
1133000542,20140805T000000,425000,3,2.25,1670,9500,1170,500
7905200315,20150416T000000,711777,4,1.75,2220,6731,1110,1110
3949600090,20141201T000000,335000,3,1,980,9903,980,0
9274201730,20140616T000000,825000,4,1.5,1890,6938,1890,0
7883604065,20150501T000000,210000,2,1,1100,6000,1100,0
1158700100,20140811T000000,575000,2,1.75,2770,19700,1780,990
7237500110,20150404T000000,1.21E+06,4,2.75,4250,10925,4250,0
8682280490,20140801T000000,431500,2,2,1370,4866,1370,0
224059111,20140903T000000,475000,3,1.5,1480,13457,1480,0
4141800215,20141126T000000,1.50E+06,4,3.75,3770,4000,2890,880
1822069097,20141223T000000,540000,6,3,2870,206474,2330,540
1668500100,20141210T000000,775000,3,2.5,3820,35016,3820,0
1254200615,20140716T000000,635000,3,2.5,1530,2978,1210,320
7135520300,20150407T000000,1.30E+06,3,2.75,4120,16365,4120,0
1755700090,20140801T000000,405000,3,2.25,1590,7267,1100,490
2414600195,20140721T000000,210000,3,1,1520,8600,1040,480
3592500985,20150504T000000,880000,4,2.5,2350,4675,2150,200
1003600056,20141024T000000,239000,4,2,1370,8837,1370,0
9285800755,20140714T000000,515000,3,2.5,1540,6100,770,770
1269200229,20140723T000000,1.38E+06,3,3.25,3786,38038,1934,1852
304100090,20140722T000000,215000,4,2.25,1500,5393,1500,0
7227800110,20150409T000000,315000,6,2,1750,17685,1750,0
7507500015,20140730T000000,442500,3,1.5,1800,8303,1200,600
621069146,20140818T000000,311000,2,1.75,1180,55321,1180,0
263000164,20141217T000000,425000,2,1,830,6030,830,0
263000291,20140904T000000,433500,3,1.75,1540,9450,1040,500
1566100625,20140804T000000,450000,3,2.25,1610,8296,1610,0
8861500015,20140520T000000,675000,3,2.25,1990,10260,1990,0
8961990090,20140624T000000,535000,3,2.5,2070,4132,2070,0
3584900090,20140613T000000,577000,3,1.75,1760,12874,1230,530
8902000407,20141217T000000,480000,3,1.75,1740,8528,1290,450
3026059014,20150112T000000,400000,3,1.5,1950,4473,1530,420
7304300906,20140613T000000,304000,3,1,1280,8184,1280,0
8155820110,20150325T000000,355000,3,1.75,1460,7203,1460,0
722069232,20140905T000000,998000,4,3.25,3770,982998,3770,0
1825069031,20140814T000000,550000,4,1.75,2410,8447,2060,350
1825069031,20141016T000000,550000,4,1.75,2410,8447,2060,350
3348401584,20140821T000000,210000,3,1.75,1400,7300,1400,0
8029500100,20150226T000000,317000,3,2.5,2100,7587,2100,0
7964410100,20150504T000000,700000,4,3.5,5360,25800,3270,2090
1457500026,20140616T000000,265000,3,1,1000,9150,1000,0
7215730590,20140902T000000,700000,4,3.5,3150,6175,3150,0
7525530100,20140908T000000,1.02E+06,5,3.5,4180,17841,3160,1020
1925059194,20141209T000000,1.15E+06,4,2.25,2840,20242,2240,600
5561401110,20140627T000000,460000,4,2.5,2110,35091,1290,820
7173700524,20140924T000000,410000,2,1.5,1660,4000,1000,660
9828202215,20140905T000000,665000,4,3,2160,4400,1320,840
4113800300,20150414T000000,600000,4,2.5,2420,7744,2420,0
6145600855,20150504T000000,502000,4,1.75,1920,3844,1170,750
2130702350,20140604T000000,364950,4,2.5,2310,8030,2310,0
8815400735,20140529T000000,680000,3,2.25,2330,4000,1520,810
5152600090,20140708T000000,235500,5,2.5,2340,13713,1670,670
7852090750,20140721T000000,576000,4,2.5,2590,5756,2590,0
2488200459,20140505T000000,405000,2,3,1410,1240,1140,270
8035600590,20140716T000000,335000,3,2.75,2850,8039,1540,1310
4438000165,20150420T000000,122000,2,1,730,6728,730,0
6744700423,20140606T000000,432000,3,1.75,1470,6250,1070,400
2473002100,20140827T000000,375000,4,2.25,2330,11400,2330,0
4399200245,20140625T000000,276000,4,2.25,2460,11250,2460,0
1326059085,20140721T000000,450000,3,2.25,2080,111513,1680,400
6324000090,20150511T000000,210000,2,1,990,8140,990,0
9542830600,20141121T000000,279000,3,2.5,1450,4106,1450,0
2767604580,20150223T000000,635000,3,1.75,1340,3900,1340,0
662310900,20150220T000000,350000,3,2.5,2730,7372,2730,0
1432600100,20140924T000000,218000,3,1,1140,7560,1140,0
8928100025,20150324T000000,750000,4,1.5,1950,6300,1650,300
1221039058,20150213T000000,310597,4,1.75,2000,25700,1150,850
3840700600,20150401T000000,355000,3,1,900,37800,700,200
8691410100,20140527T000000,735000,5,2.75,3390,5211,3390,0
7883607645,20140602T000000,155000,1,1,720,6000,720,0
9435300051,20140611T000000,354000,3,1,940,10368,940,0
6179900090,20150507T000000,415000,3,1.75,1770,10513,1400,370
6840700165,20140701T000000,202000,1,1,590,833,590,0
2768301217,20150506T000000,580000,3,2.5,1980,1873,1470,510
629000615,20141022T000000,1.50E+06,4,3.25,3070,10375,2180,890
7202360600,20141008T000000,790000,4,2.5,3500,7519,3500,0
7852020590,20150305T000000,499900,3,2.5,2100,5112,2100,0
2023039160,20150423T000000,525000,4,2.25,2620,98881,1820,800
2597520090,20140622T000000,810000,4,2.5,2810,10613,2810,0
8631600025,20150220T000000,425000,4,1.5,2290,8773,1330,960
8100000110,20141226T000000,241250,3,1.75,1350,7588,1350,0
5151800015,20141112T000000,318700,4,2.5,2770,19116,1600,1170
9521101055,20140827T000000,720000,4,1.75,2530,5000,2070,460
2475901105,20140715T000000,291000,3,1,1280,10500,1280,0
1726069202,20140718T000000,420000,3,1.75,1060,38644,1060,0
3530450100,20140726T000000,210000,2,1.75,1000,3554,1000,0
8941800100,20150427T000000,645000,3,3.25,3870,11000,2970,900
809002215,20140519T000000,762000,5,2,3370,5000,2140,1230
6209000165,20140724T000000,247500,4,1.75,2290,7765,2290,0
4178500100,20140723T000000,282500,3,2.25,1670,7150,1670,0
1523069086,20140605T000000,395000,3,1.75,1460,22651,1460,0
6121000090,20140616T000000,295000,3,1.75,1770,8235,1030,740
3342100785,20140826T000000,235000,2,1,820,5100,820,0
6012500100,20141001T000000,770000,3,1.75,1900,6334,1450,450
8682291720,20140508T000000,559950,2,2,1870,4950,1870,0
5041300100,20140710T000000,639000,4,2,1840,5419,920,920
2473101140,20150428T000000,314950,3,1,1590,8470,1140,450
8121100600,20150324T000000,525000,3,1,1640,6180,1640,0
724069059,20140509T000000,2.40E+06,3,2.25,3000,11665,3000,0
2755200110,20140602T000000,820000,3,1.75,2160,6272,1390,770
6169901130,20140911T000000,1.39E+06,3,3,2490,3600,1790,700
6385000025,20141017T000000,521450,3,2,1290,5700,1290,0
509000090,20141006T000000,760750,3,2.5,3190,49137,3190,0
622059031,20140604T000000,759600,4,1,1540,115434,1540,0
5358300100,20140619T000000,346150,3,2,2140,7200,1480,660
4459800100,20150422T000000,390000,2,1,980,3800,980,0
2473371780,20140924T000000,359950,5,2.25,2450,9432,2450,0
9393700110,20140603T000000,430000,3,2,1360,5120,910,450
8691360490,20150424T000000,960000,4,3.5,4610,11676,4610,0
9175600025,20141007T000000,800000,7,6.75,7480,41664,5080,2400
7605800090,20150108T000000,1.01E+06,3,2.5,2860,5805,2860,0
7334500090,20150120T000000,290000,3,2,1810,11456,1810,0
8964800930,20150317T000000,1.35E+06,4,2,2240,10296,2240,0
2260800110,20140513T000000,777000,3,3.25,3610,59677,2440,1170
7550800945,20141007T000000,526000,2,1,1450,4500,1450,0
1972205338,20150418T000000,550000,3,3.5,1450,1091,1200,250
2946000590,20141223T000000,276000,3,1.5,1820,8750,1200,620
5700003585,20141229T000000,2.50E+06,5,3.25,5620,12672,4140,1480
7129302235,20150122T000000,325000,3,1.75,2080,6554,1040,1040
3278602490,20140926T000000,365000,3,2.5,1780,1754,1780,0
685000115,20141007T000000,2.15E+06,8,6,4340,9415,4340,0
3423600025,20150305T000000,825050,4,3.25,2860,3680,1980,880
7173700518,20140721T000000,690000,3,1.5,2540,9520,1500,1040
3277801450,20150415T000000,390000,4,1,1140,6250,1140,0
1862400518,20150304T000000,385000,3,2,1320,1297,1320,0
8078350090,20150331T000000,619000,3,2.5,2040,7503,2040,0
1423089118,20150325T000000,494000,4,2.25,1790,42000,1170,620
7980900011,20150427T000000,412450,3,2,1910,13505,1910,0
5309100750,20150123T000000,580000,3,1.75,1460,2800,1460,0
322059097,20141105T000000,269900,3,1.5,1420,22100,1420,0
9834200165,20150406T000000,704300,4,1.5,1790,4080,1790,0
2420069201,20141107T000000,267000,3,2,1390,6005,1390,0
4167300300,20140813T000000,310000,4,1.75,1880,12150,1280,600
1105000745,20150123T000000,227064,3,1.5,1570,10824,1570,0
8927600100,20140528T000000,925000,3,2.5,2690,7000,1840,850
8078490090,20150508T000000,245000,3,1.75,1670,11452,1670,0
1736100090,20141214T000000,339888,3,1,1040,7490,1040,0
3876200100,20140710T000000,439000,4,2,1560,7500,1560,0
6844702290,20140527T000000,400000,2,1,1470,6120,1470,0
4022906430,20140630T000000,560000,3,2.25,2070,15002,2070,0
5040800015,20141001T000000,703011,2,1,1370,5922,1130,240
9297301055,20141209T000000,363000,2,1,1120,4800,770,350
318500300,20140919T000000,650000,4,2.75,2640,6240,2640,0
1839910300,20150106T000000,299950,3,1,1030,9916,1030,0
1446400785,20150422T000000,228950,3,1,1120,6625,1120,0
4036800015,20141001T000000,465000,4,1.75,1730,11700,880,850
8965500900,20150213T000000,725000,3,2.5,2090,9847,2090,0
3751603173,20140604T000000,212500,3,1,920,14400,920,0
3423059140,20140910T000000,526000,4,2.25,2970,54450,2970,0
114101055,20141223T000000,383000,3,2.5,1720,10031,1720,0
2475200590,20150421T000000,244000,3,1.75,1460,4692,1460,0
3856905010,20140805T000000,565000,3,1.5,1540,3570,1490,50
7226500100,20150219T000000,373000,8,3,2850,12714,2850,0
3580900090,20140902T000000,300000,3,2,1310,9855,1310,0
9558000100,20140520T000000,405000,5,2.5,2430,4781,2430,0
1872900076,20140620T000000,979000,3,1.5,1700,14133,1700,0
1221059112,20141116T000000,324888,4,1.75,2160,28750,2160,0
2877102495,20150429T000000,445000,3,1.5,860,3200,860,0
4400200057,20150221T000000,761000,3,3.5,2050,2020,1520,530
1049010300,20150427T000000,435000,4,2,1650,4745,1130,520
6802210090,20140822T000000,252000,3,2.25,1570,8410,1180,390
726049232,20140623T000000,350000,3,1.75,1660,10150,1660,0
3262300940,20141107T000000,875000,3,1,1220,8119,1220,0
3262300940,20150210T000000,940000,3,1,1220,8119,1220,0
1214700090,20140819T000000,280000,3,2,1780,11342,1780,0
8564950300,20140919T000000,450000,3,2.5,2180,4226,2180,0
3321069006,20141231T000000,905000,3,2.5,3520,237402,3520,0
3751601501,20140716T000000,382450,3,2.5,2220,20531,2220,0
1156000100,20141224T000000,246700,3,2,1610,13309,1610,0
3972900735,20140814T000000,220000,3,1.5,1070,9331,1070,0
6888900115,20150216T000000,555750,3,1,1060,4880,910,150
3031200165,20140611T000000,262500,3,1.5,1160,8906,1160,0
5683000033,20141201T000000,515000,2,1,910,4725,910,0
7230000265,20140617T000000,499500,3,2.5,2970,21907,2970,0
985001015,20140604T000000,135000,1,1,790,13062,790,0
2815600215,20141118T000000,462500,2,2,1540,7290,1540,0
3585900090,20150415T000000,937500,4,2.5,3130,21100,2530,600
5101407370,20150422T000000,458000,3,1.5,1470,9570,1280,190
871001105,20141022T000000,845000,4,2.75,3160,7143,2100,1060
424069233,20140531T000000,660000,3,2.25,2675,40910,2675,0
3830630090,20150417T000000,265000,3,2,1340,6783,1340,0
1997200215,20140507T000000,599999,9,4.5,3830,6988,2450,1380
1898310110,20141202T000000,280000,3,2.5,1800,8697,1800,0
3407700047,20141029T000000,1.06E+06,3,3.25,2990,189852,2990,0
9542100165,20141107T000000,875000,4,3,3720,14125,1930,1790
7140800100,20141014T000000,125000,3,1,920,7276,920,0
7202340930,20141209T000000,634800,4,3,3280,4904,3280,0
9262800057,20150203T000000,269950,4,1,1440,9600,1440,0
1159100100,20140620T000000,359950,3,2.25,1940,11612,1100,840
7230900100,20141215T000000,417000,3,1.75,1590,11454,1590,0
8682301910,20140722T000000,389000,2,2,1340,4122,1340,0
7701450110,20140815T000000,1.04E+06,4,2.5,3770,10893,3770,0
1725059209,20140929T000000,698000,6,2.5,2680,11250,1340,1340
4025300195,20150318T000000,685000,4,2.5,2820,10125,2820,0
985000900,20141105T000000,198500,3,1.75,1520,7137,1520,0
7140700850,20150326T000000,350000,4,2.5,2560,5428,2560,0
522079067,20150408T000000,649950,3,2.5,3310,387684,2160,1150
1387300940,20150429T000000,441000,3,1.5,1540,7200,1540,0
8562700090,20141111T000000,462600,3,1.75,1430,11761,1430,0
2122059236,20150306T000000,365070,4,2.5,2506,6232,2506,0
514500090,20140513T000000,550000,4,2,2250,7500,1200,1050
5680001095,20150428T000000,470000,5,1.75,2740,9600,1370,1370
2475900855,20140827T000000,340000,3,1.75,1540,10400,1540,0
8669400100,20140805T000000,910000,4,2.75,4190,38912,2040,2150
3824100051,20150407T000000,405000,4,1.75,1690,8392,1190,500
952004875,20140602T000000,661000,4,2.25,1990,4600,1420,570
9522350090,20141106T000000,635000,4,2.5,2410,7069,2410,0
1787600252,20150505T000000,282000,2,1,1150,6098,950,200
7148000315,20150211T000000,235000,4,1.75,1720,10137,1720,0
2180001080,20140819T000000,277500,3,2,1260,22100,1260,0
1328330590,20150420T000000,346500,5,2.5,2020,8250,1430,590
34001304,20150410T000000,480000,5,2.25,2240,5500,1490,750
1558500100,20140916T000000,360000,4,2.25,1930,6508,1930,0
2887950110,20141106T000000,245000,3,2.5,1820,6785,1420,400
6852700412,20140919T000000,625000,3,3.5,1560,1490,1240,320
1798000100,20140529T000000,750500,5,3,2170,2440,1450,720
9516500100,20150418T000000,525000,3,1.75,1600,9579,1180,420
203400090,20140729T000000,740000,4,3.5,3760,57063,2950,810
4036800805,20140513T000000,523000,3,1.5,1240,7735,1240,0
7129302615,20150304T000000,292000,3,1.75,1090,4500,1090,0
7278700100,20150121T000000,625000,4,2.5,2740,9599,1820,920
7852070090,20150116T000000,700000,3,2.5,3110,11727,3110,0
1250200552,20150312T000000,399950,3,2.5,1610,1320,1280,330
9126100608,20150225T000000,545000,4,3.5,1880,1341,1650,230
396100025,20140807T000000,339999,4,2,1740,6369,870,870
9184700600,20141201T000000,1.21E+06,4,2.25,3270,6000,2180,1090
4221250090,20141113T000000,545000,3,2.5,1990,5149,1990,0
8731901810,20150309T000000,260000,4,1.75,1960,8400,1960,0
7977201707,20140523T000000,526000,3,1.75,1680,3420,960,720
3260350090,20141112T000000,701000,4,3,2910,8540,2910,0
7399300850,20141003T000000,290000,3,2.25,1500,7482,1210,290
461002551,20141004T000000,330600,1,1,580,1799,580,0
9158100090,20150427T000000,550500,3,1.75,2540,8280,1270,1270
9358002305,20150313T000000,430000,2,1,950,6426,950,0
6447300265,20141014T000000,4.00E+06,4,5.5,7080,16573,5760,1320
2235000015,20140804T000000,260600,2,1,810,4560,810,0
9523104345,20141218T000000,825000,5,3,4080,7500,2720,1360
6139100056,20141023T000000,378950,4,2,1820,8400,1300,520
808300090,20150116T000000,435000,4,2.5,2650,9065,2650,0
8077100031,20150422T000000,631000,3,2.25,1670,1396,1250,420
1402650110,20140518T000000,415000,3,2.5,2480,8342,2480,0
7985000100,20141021T000000,222000,3,1.75,1240,7560,1070,170
1796350690,20140820T000000,245000,3,2,1390,8250,1390,0
7504110110,20150325T000000,720000,3,2.5,2880,10126,2880,0
4324500490,20141223T000000,215000,3,1,1060,9954,1060,0
1257202120,20141030T000000,579100,2,1,1070,2754,830,240
3987700115,20140728T000000,522500,4,1.75,1640,9299,870,770
9137101353,20140919T000000,489000,3,2,1510,3000,910,600
3298701066,20150506T000000,240000,3,1,1230,2353,1230,0
8682290100,20150421T000000,420250,3,2,1510,3657,1510,0
4055700778,20141114T000000,523000,4,2.5,3180,20870,2120,1060
438000025,20140513T000000,628000,4,2,2260,6000,1430,830
2474400300,20150506T000000,320000,4,2.5,1920,7277,1920,0
87000283,20141118T000000,359950,3,2.5,1980,7800,1980,0
2946001645,20140505T000000,232000,2,1,1200,8063,1200,0
9294300495,20141114T000000,810000,4,2.25,2020,5600,1210,810
492000475,20141211T000000,245000,4,1.5,2010,7561,1890,120
3876540600,20150507T000000,273000,3,2.25,1930,8192,1470,460
4122500100,20150211T000000,1.19E+06,5,2.5,2710,14989,1720,990
2461900945,20150421T000000,438000,5,1,1950,6250,1450,500
7221400495,20140717T000000,400000,3,1.75,2110,19600,2110,0
2349300090,20140516T000000,340000,3,1,1250,4800,1250,0
9523100459,20140609T000000,552000,2,2.5,1380,951,1380,0
3856904580,20141125T000000,790000,3,1.75,2050,4080,2050,0
7345600755,20140707T000000,360000,3,1.5,1800,22000,1800,0
798000457,20150302T000000,235000,3,1,1310,15022,1310,0
7986400945,20141010T000000,775000,2,1,1010,3600,1010,0
395300100,20140514T000000,489200,3,2.75,1850,9600,1850,0
2473510090,20140729T000000,341000,3,2.25,1750,8900,1750,0
1329300300,20141001T000000,335000,4,2.5,2154,6050,2154,0
952007069,20150121T000000,393500,3,1.75,1230,1441,1010,220
8073000265,20140918T000000,360000,3,2,1960,8846,980,980
952004745,20150304T000000,400800,4,1,1070,5750,870,200
1376800115,20141103T000000,585000,3,1,1450,5378,1190,260
6613000750,20141001T000000,1.60E+06,4,2.75,3680,5000,2480,1200
2303900090,20140729T000000,2.88E+06,4,2.5,5760,32033,4390,1370
6713700025,20140515T000000,300000,3,1,1220,13000,1220,0
4083304535,20141114T000000,1.05E+06,4,2.75,2950,4560,1810,1140
3626039403,20140922T000000,360000,3,1.5,1340,1110,1040,300
254000100,20140620T000000,665900,4,2.25,2870,5453,2220,650
2724049076,20140822T000000,470000,4,1,2590,18224,2000,590
8562500690,20140513T000000,581000,4,1.75,2090,8164,1070,1020
3834500195,20140707T000000,527000,6,3.5,3000,8401,1500,1500
2207100405,20150506T000000,423000,4,1.75,1730,7245,880,850
9482700475,20140927T000000,875000,4,3.5,2850,4416,2040,810
7905200386,20140729T000000,410000,3,1,1020,6903,1020,0
8680500090,20150316T000000,606000,3,2.5,2200,6005,2200,0
3424089119,20150501T000000,654000,3,2.5,3240,60840,3240,0
1437500015,20140709T000000,150000,3,0.75,490,38500,490,0
3298700110,20141109T000000,373000,3,2.5,2990,6771,1550,1440
6300000337,20140529T000000,550000,5,2,2450,9488,1240,1210
8561200110,20140521T000000,512500,3,2.5,1900,7604,1900,0
2781250110,20150428T000000,360000,4,2.5,2640,7388,2640,0
4442800008,20140926T000000,369000,3,2,1340,1480,1340,0
2619920110,20141230T000000,825000,4,2.5,3220,5262,3220,0
7334501130,20141201T000000,255000,3,2,930,11475,930,0
9471200115,20140528T000000,1.29E+06,4,2.5,3240,10800,2260,980
2597500090,20140808T000000,270000,5,2.5,2630,8470,2630,0
8665050490,20140924T000000,480680,3,2.5,1730,4924,1730,0
1736800740,20150303T000000,525000,4,1.75,2120,7725,1220,900
6163901751,20140623T000000,291500,3,1,880,9238,880,0
2323059184,20141230T000000,305000,4,2,1800,13551,1800,0
7349650490,20150507T000000,285000,3,1.75,1600,7500,1600,0
1025039086,20140916T000000,1.88E+06,3,2.5,3280,29111,3280,0
274100090,20150108T000000,329500,5,1.75,3290,8000,1790,1500
3342104046,20140708T000000,1.57E+06,4,2.25,2890,18226,2890,0
7893801862,20140811T000000,379260,3,2.5,1730,7202,1330,400
7852060490,20140709T000000,356000,3,2.5,1590,3411,1590,0
7923300115,20141201T000000,571900,4,1.75,1710,8947,1710,0
2868300115,20140821T000000,271500,3,1.75,1995,18360,1995,0
9477001270,20150316T000000,390000,3,1.75,1300,10030,1300,0
522069119,20150512T000000,550000,3,2.5,2720,62310,2040,680
2025049175,20150105T000000,755000,2,2.5,1360,2070,1360,0
2771604226,20141118T000000,509500,2,2.5,1590,1485,1300,290
2917200615,20150325T000000,486700,2,1,1200,6278,1080,120
9551201295,20140728T000000,527500,2,1,1170,3000,1170,0
7443000985,20140815T000000,475000,5,2.5,2010,3600,1510,500
3395041194,20140827T000000,268000,3,2.75,1880,1793,1810,70
1024069162,20150416T000000,562000,3,2,3250,50529,3250,0
5452800735,20140722T000000,780000,4,2.5,2270,13449,1310,960
2902200015,20150106T000000,700000,9,3,3680,4400,2830,850
1698900195,20140902T000000,710000,3,2,1880,3000,1040,840
442000015,20140612T000000,445000,3,1,1050,5664,910,140
222069058,20140915T000000,729000,3,3.25,2250,60548,2250,0
2926049449,20140618T000000,384400,3,3.25,1689,1388,1689,0
6071800100,20150327T000000,815000,6,3,2860,17853,1430,1430
4003000110,20141029T000000,865000,4,2.5,2710,4069,2710,0
925059198,20140828T000000,514000,3,2,1770,7200,1770,0
6072700110,20140520T000000,615000,4,2.75,2820,13193,1860,960
1926069143,20141016T000000,865000,4,3.25,3400,99170,2000,1400
2871000300,20141013T000000,755000,4,2.5,3110,6930,3110,0
6163900301,20150427T000000,425000,4,1,1480,8321,1080,400
4318200090,20140618T000000,375000,2,1,940,9839,940,0
9526600090,20150424T000000,750000,4,2.5,2680,4548,2680,0
629420100,20140926T000000,722000,4,2.75,3190,5408,3190,0
6905200215,20150331T000000,1.01E+06,3,2.5,1920,4480,1920,0
7202430110,20140625T000000,725000,3,2.5,2610,7510,2610,0
87000245,20140930T000000,170000,3,0.75,1040,42180,1040,0
6667400090,20150501T000000,845000,4,3.25,2880,35315,2270,610
6802200100,20150115T000000,271900,3,2,1450,8771,1450,0
913000315,20140605T000000,1.30E+06,6,4.5,3902,3880,2782,1120
8732030490,20141222T000000,261500,4,2.5,2460,7800,1500,960
3629920600,20140516T000000,619500,3,2.5,2170,5000,2170,0
1524079156,20140610T000000,435000,5,2.25,1970,15247,1450,520
6450301690,20141003T000000,210000,3,1,1000,5454,1000,0
5309101050,20141126T000000,489950,3,2,1580,4010,790,790
8857600820,20140508T000000,260000,4,1.5,2130,8800,1100,1030
3500100025,20140628T000000,300000,4,1,1370,8499,1370,0
5152100110,20150422T000000,530000,4,2,2150,14161,1330,820
3298600850,20141216T000000,235000,3,1.75,1370,14030,1370,0
3856902250,20150105T000000,593500,3,1,1370,4000,1370,0
8887001140,20140723T000000,562000,3,3,3290,80471,2330,960
2621069066,20150427T000000,585000,3,2,3190,207346,3190,0
251620090,20140530T000000,2.40E+06,4,3.25,4140,20734,3300,840
3546000090,20150224T000000,199500,3,1.75,1690,8901,1690,0
3359500755,20140902T000000,544500,5,1,1690,3240,1690,0
3579800485,20150218T000000,394900,3,1,1430,13370,1430,0
2919201335,20140731T000000,912000,4,3.75,1980,4095,1980,0
1796370930,20140710T000000,260000,3,2.5,1490,8102,1490,0
3864000090,20150219T000000,858000,5,3,3620,12778,1900,1720
8651100110,20141209T000000,1.28E+06,4,2.5,2720,16454,1870,850
8731730590,20150513T000000,242150,4,1.75,1490,8544,1490,0
1761100300,20141030T000000,220000,3,1.75,1230,7200,1230,0
9542800820,20150430T000000,235000,3,2,1900,7980,1340,560
2644900110,20141021T000000,370000,3,1.75,1530,10300,1530,0
1626069198,20141003T000000,450000,3,1.75,2290,44866,1390,900
5101408593,20140711T000000,534950,5,1.5,2240,6337,1280,960
7853270100,20150315T000000,730000,4,2.5,3470,14271,3470,0
3308030100,20140925T000000,465000,4,2.5,3050,32450,1550,1500
1330280100,20140801T000000,178000,3,1,1100,5734,1100,0
2212200090,20150209T000000,215000,3,1,1610,7140,1080,530
9264921140,20150312T000000,300000,3,2.75,1910,15508,1210,700
8902000068,20140515T000000,430000,3,2,1510,7066,1230,280
7338000850,20140731T000000,183000,3,1.5,1280,4366,1280,0
2770600853,20140612T000000,585000,3,2.5,1910,1501,1530,380
4239400740,20140716T000000,192950,3,1,1170,3330,1170,0
6184700100,20140926T000000,599000,2,1,1550,7713,1550,0
3157600615,20140708T000000,326500,3,1,1060,7920,1060,0
6145601810,20140718T000000,358803,2,1,1040,5765,1040,0
1235700042,20140528T000000,537000,3,2.5,1550,12920,1550,0
7781600025,20141023T000000,1.16E+06,3,2.5,2490,24691,1580,910
7116500705,20150129T000000,156000,2,1,920,5889,920,0
2320069206,20150325T000000,219000,3,1,1250,8276,1250,0
1794501390,20150501T000000,1.19E+06,3,1.5,2540,2700,1630,910
2122059160,20150427T000000,248000,5,1.75,2190,16788,1380,810
2421069039,20150209T000000,340000,3,1.75,1340,196020,1340,0
5452800495,20150422T000000,899100,5,2.5,2410,15300,1400,1010
4024100961,20140728T000000,346950,3,1.75,1830,10954,1830,0
7857001560,20140917T000000,330000,3,1,1850,5775,1740,110
9540100025,20140731T000000,325000,3,1,1410,8250,1410,0
2473410740,20141027T000000,315000,3,1.75,1460,7884,1460,0
2770604365,20140623T000000,649950,3,2.5,1500,1375,1200,300
173000025,20140825T000000,316000,3,1,1130,7200,1130,0
7853340490,20140617T000000,386000,2,2.5,1620,3196,1620,0
239000115,20150408T000000,535000,2,1.75,2330,7280,1450,880
9528101032,20150325T000000,600000,3,3,1520,1800,1520,0
5416100110,20141118T000000,339000,4,2.5,2840,8746,2840,0
4331000265,20140926T000000,167000,3,2,1520,7456,1520,0
5249803885,20141215T000000,430000,3,1,1740,4800,1740,0
7853301390,20140821T000000,688000,4,4,4000,9309,4000,0
1376800025,20140908T000000,834500,3,2.25,2780,6000,1670,1110
7639900025,20140628T000000,1.08E+06,4,4.25,3500,8750,2140,1360
2822059262,20141201T000000,250000,3,1,1060,52272,1060,0
8113100850,20150410T000000,402500,3,1,1290,4000,1290,0
565300110,20141216T000000,432500,3,2.5,2390,6435,1600,790
1887000100,20140814T000000,485000,5,1.75,2460,14100,1380,1080
8731990090,20140820T000000,560000,4,2.75,2930,22000,1580,1350
3432500705,20141021T000000,410000,4,2.25,2200,8292,2200,0
1015500300,20140515T000000,455000,3,2.5,1870,7344,1470,400
3972300100,20141229T000000,459500,4,2.5,2060,8968,1190,870
3876300600,20141212T000000,371000,4,1.75,1610,11305,1610,0
2111010940,20150220T000000,289500,3,2.25,2120,3400,2120,0
2771102158,20141021T000000,395000,3,3.5,1450,1263,1160,290
1498304065,20140614T000000,496752,2,1,1980,5000,1090,890
6150200375,20141001T000000,227000,2,1,860,6800,860,0
3343901340,20140804T000000,330000,3,1.75,1460,9261,1460,0
4037800015,20150123T000000,480000,5,2,2590,8610,1340,1250
1626079066,20140806T000000,290000,2,1,1120,217800,1120,0
6200017,20141112T000000,281000,3,1,1340,21336,1340,0
5249805090,20150407T000000,705000,4,1.5,1780,3120,1780,0
4217401055,20140502T000000,1.40E+06,4,2.5,2920,4000,1910,1010
7738500475,20141212T000000,485000,4,3.25,2820,6611,1410,1410
2767603250,20150309T000000,622000,3,2.25,1550,1919,1550,0
2620069113,20140902T000000,380000,3,2.25,1600,39848,1600,0
3760500336,20141126T000000,2.13E+06,4,2.75,3190,19513,3190,0
5101404563,20140627T000000,561500,3,1.75,1960,6380,980,980
9407000600,20140916T000000,242000,3,1,970,9600,970,0
9353300600,20140624T000000,348500,3,1.5,1360,10726,1360,0
9353300600,20150326T000000,370000,3,1.5,1360,10726,1360,0
993000090,20150414T000000,752000,6,3.75,3810,6663,3810,0
1796361140,20141031T000000,230000,3,1.75,1340,8250,1100,240
1112000031,20150318T000000,715000,3,2.25,1990,4977,1990,0
2822049160,20150417T000000,240415,3,1.75,1120,10187,1120,0
3856904560,20141125T000000,562000,4,1.75,2060,4080,1460,600
2492200956,20140805T000000,360000,3,1.5,1170,4080,1170,0
2770604079,20141029T000000,659950,3,2.5,1610,1246,1080,530
2719100042,20140623T000000,458500,3,2,1890,1599,1430,460
7899800864,20150305T000000,259950,2,2,1070,649,720,350
9485750110,20140918T000000,366000,3,1.75,1680,6108,1680,0
2024059058,20150428T000000,978000,4,2.75,2890,7821,2890,0
7977201865,20150421T000000,525000,2,1,1360,6120,1060,300
4232900940,20140522T000000,926300,3,1.5,1660,4800,1660,0
3364900375,20150423T000000,750000,2,1,1620,6120,1620,0
4151800375,20141204T000000,660000,2,1,960,6263,960,0
2610100015,20140813T000000,305000,4,1.75,1000,7200,1000,0
8682230590,20150426T000000,800000,2,2.5,2395,6143,2395,0
3876100940,20150427T000000,600000,4,1.75,3050,9440,1800,1250
1221079058,20140827T000000,435000,2,1,1120,88327,1120,0
2770605550,20150310T000000,1.14E+06,4,3.25,2960,4296,2190,770
4468400214,20141010T000000,318000,3,2.25,1250,1017,1250,0
2767705010,20141006T000000,639000,4,2,1940,5000,980,960
5422560930,20150316T000000,453000,3,2.5,1750,3900,1750,0
824059211,20141117T000000,800000,4,1.75,2150,9148,2150,0
6825100015,20140604T000000,437000,2,1.75,1500,6800,910,590
4166600115,20141121T000000,1.15E+06,3,2.75,3230,75889,3230,0
3574801500,20140926T000000,490000,4,2.5,3000,8645,3000,0
9477001140,20140710T000000,499950,4,1.75,1520,7700,1520,0
3384300100,20141226T000000,160134,3,1.5,1190,10116,1190,0
6123600100,20141215T000000,191000,3,1,990,8255,990,0
1311300100,20150115T000000,221000,3,1,1250,7280,1250,0
3812400854,20141028T000000,352800,4,2,2080,6360,1330,750
1326069188,20150511T000000,350000,3,2.5,1640,10424,1640,0
3131201865,20140617T000000,458000,4,1.5,1550,3000,1350,200
321059059,20140519T000000,359950,3,1,1290,189486,1290,0
223039330,20150407T000000,1.05E+06,3,3,3250,5093,3250,0
7857000900,20140724T000000,353000,3,1.75,1260,11775,1260,0
8109800110,20140801T000000,717550,3,3.5,2840,4468,2840,0
5422560900,20140807T000000,450000,3,2.25,1960,6500,1960,0
3332000195,20140924T000000,167500,3,1,760,3090,760,0
2423029245,20140617T000000,550000,3,1.75,2240,78225,2240,0
8651600110,20150421T000000,939000,4,2.25,2240,9684,2240,0
7902200015,20150429T000000,700000,3,1.75,1820,15570,1820,0
3523089019,20140519T000000,480000,4,3.5,3370,435600,3370,0
8827900015,20140829T000000,501000,3,1,1160,4360,1160,0
9237800100,20150204T000000,580000,3,2.25,1640,8625,1320,320
2724089019,20140523T000000,527550,1,0.75,820,59677,820,0
5416501030,20141124T000000,399000,4,2.5,2800,4687,2800,0
7211402305,20150415T000000,240000,3,1.75,1780,5000,1080,700
1221059176,20150311T000000,353000,4,2.75,2200,268329,1410,790
7549802600,20140528T000000,335000,4,2,1480,3132,740,740
4112100165,20150317T000000,475000,3,3,2010,2554,1860,150
7518506595,20140826T000000,660000,3,2,2880,5100,2080,800
2767602490,20140724T000000,551000,3,1,940,1948,940,0
3821000100,20150320T000000,249950,4,1.75,1620,10530,1620,0
524069019,20141120T000000,1.15E+06,4,3.25,4400,262666,4400,0
1492800296,20140703T000000,575000,3,1.75,1530,6743,1410,120
7855900110,20140718T000000,1.09E+06,4,2.75,3460,11350,1780,1680
7853290090,20141118T000000,515000,4,2.5,2890,7306,2890,0
2123049175,20141210T000000,235000,3,1.5,1980,11214,1980,0
2025049064,20140915T000000,796000,3,1,1980,3243,1980,0
6046401105,20150423T000000,450000,2,1.5,1450,2550,820,630
3505100756,20141106T000000,2.05E+06,4,3,4280,18834,2180,2100
5468730110,20140508T000000,270000,4,2.5,1810,6509,1810,0
5154200015,20150414T000000,1.71E+06,3,3,2490,27702,2490,0
9285800590,20150309T000000,565000,3,1,1610,4108,1610,0
4083304190,20140804T000000,680000,1,2.5,1820,3008,1090,730
2470100110,20140804T000000,5.57E+06,5,5.75,9200,35069,6200,3000
7574910490,20141114T000000,864500,4,2.5,3520,35991,3520,0
868001030,20140915T000000,1.15E+06,4,2.25,3740,18000,1870,1870
8108600464,20140515T000000,335000,3,2.25,2150,30476,2150,0
3295610490,20150504T000000,911000,4,3.25,3526,15958,3526,0
5013500110,20141112T000000,425000,2,1,1070,6625,830,240
3223069019,20141029T000000,299950,3,1,1410,81021,1410,0
2725069085,20141208T000000,864000,4,2.5,3190,49658,3190,0
6821600265,20150305T000000,425000,2,1,1270,6000,1270,0
1471701780,20140814T000000,374950,4,1.5,1970,14490,1970,0
9835800750,20141203T000000,247000,3,2.25,1640,7630,1180,460
8835900015,20141212T000000,475000,3,1,1600,7161,1600,0
806800110,20140801T000000,275000,3,2.5,3020,5868,3020,0
826069002,20141029T000000,355000,2,1,1350,368517,1350,0
2222059064,20150318T000000,285000,4,1.75,1870,22072,1070,800
7781600100,20140905T000000,1.34E+06,3,2.75,2730,38869,1940,790
4047200265,20140811T000000,325000,2,1,1100,17817,620,480
2125059013,20150420T000000,1.67E+06,5,3.5,4320,40816,4320,0
2011400583,20140606T000000,402000,3,2.5,2700,9994,1350,1350
3526039160,20140814T000000,1.10E+06,3,3,3700,16857,2170,1530
8718500495,20140730T000000,375000,4,1.75,2190,9225,1250,940
3815500165,20140911T000000,396000,5,2.75,2840,12253,1420,1420
5104450690,20140716T000000,320000,4,2.75,2610,9077,1310,1300
7202260300,20140709T000000,610000,3,2.5,2630,5827,2630,0
1423600300,20141117T000000,249950,3,1.5,1090,7698,1090,0
1796100015,20150423T000000,675000,4,3.5,3090,100835,3090,0
3874900090,20150326T000000,448000,2,2,1670,7772,860,810
4232902615,20150428T000000,819000,3,1,1300,3600,1300,0
3585900495,20141110T000000,1.25E+06,3,2.5,3670,18505,2530,1140
3790700110,20141201T000000,225000,4,2.5,1700,6031,1700,0
3626079040,20140730T000000,790000,2,3,2560,982278,2560,0
2461900375,20150414T000000,685000,4,2.5,2770,6000,2400,370
8651611690,20140620T000000,812000,3,3.25,3240,8338,3240,0
8682301050,20141202T000000,705000,2,2.5,2300,6400,2300,0
1858600042,20150429T000000,360000,4,3,2483,6870,2483,0
2767604252,20150112T000000,344000,1,1.5,760,779,760,0
1954700615,20141022T000000,825000,4,1.5,2040,6900,2040,0
6844702690,20150427T000000,476500,3,1,1200,6120,950,250
2695600195,20141124T000000,379500,2,1,960,5096,960,0
426059055,20141003T000000,620000,3,1.75,2410,35236,2410,0
1769600147,20140731T000000,477590,3,3.25,2260,7701,1760,500
9268200300,20140520T000000,490000,3,1,1910,8190,1010,900
3052700855,20140628T000000,470000,3,1.5,1500,5000,1140,360
9828702262,20140724T000000,500000,3,2.25,1360,1236,1140,220
1568100386,20140630T000000,370000,3,1,1320,7341,1320,0
4385700735,20150311T000000,790000,2,1.5,1940,4400,970,970
3425059206,20140624T000000,725000,4,2.5,2650,18295,2650,0
6848200018,20140528T000000,840000,4,2.75,3040,2800,2100,940
3023049256,20140604T000000,390000,3,1,1240,11108,1240,0
4019301500,20140828T000000,507000,3,2.25,2210,11585,1510,700
402000115,20141122T000000,263500,3,1.75,1540,6273,770,770
9206950110,20140712T000000,369000,3,2.5,1320,1683,1270,50
8106300820,20140814T000000,500000,3,2.5,3040,5326,3040,0
8082400011,20150406T000000,570000,2,1,910,4301,910,0
7137960110,20150306T000000,284000,4,3,2040,7145,1490,550
546000820,20141110T000000,415000,2,1,980,4108,980,0
3330500705,20140515T000000,197500,3,1,980,3090,980,0
1454600266,20141027T000000,925000,4,3.75,4420,9492,3420,1000
3335000025,20141112T000000,468000,3,2,1570,6300,820,750
1454100056,20140715T000000,355000,3,1,1600,5001,1080,520
5035300090,20140812T000000,639000,4,1.75,1830,6000,930,900
7504050090,20150412T000000,720000,3,2.5,2820,14250,2820,0
408100110,20140612T000000,381000,3,1.75,1800,6000,900,900
5701700011,20140523T000000,1.05E+06,3,4,4380,42769,4380,0
3629970930,20141111T000000,670000,3,3,2980,3730,2980,0
7017200110,20141028T000000,400000,3,1,1690,6658,1690,0
4054500590,20140626T000000,910000,4,3.5,4040,50479,4040,0
2126059048,20150402T000000,294000,3,1,1250,9427,1250,0
984200590,20150310T000000,315001,3,1.75,1500,10230,1500,0
9353300090,20140731T000000,360000,3,2,1630,10723,1630,0
7600057,20140805T000000,520000,3,2,1410,2700,1410,0
2919701944,20141010T000000,474000,3,1,1140,4560,770,370
7202341110,20150313T000000,702000,4,2.5,3280,5876,3280,0
1122069019,20140826T000000,728000,4,3.5,3490,87497,3490,0
1565950090,20150305T000000,308000,4,2.5,2020,7277,2020,0
1724069059,20140524T000000,2.00E+06,5,4,4580,4443,4580,0
4137000110,20140725T000000,340000,3,2.5,2270,7917,2270,0
7849200945,20150401T000000,306500,2,1.75,1310,10200,1310,0
2397101270,20150126T000000,716000,3,2,1420,3600,1420,0
2726059100,20140909T000000,950000,4,3,2980,44431,2640,340
7202331500,20140829T000000,673200,5,3,4180,8561,4180,0
439000090,20150323T000000,564500,4,2.25,1950,6000,1350,600
7788000100,20150206T000000,393000,4,1.75,1790,11801,1790,0
8658300315,20150312T000000,425000,5,1.75,1400,5071,1400,0
1723049567,20140730T000000,150000,3,1,1320,24684,1320,0
621069039,20150220T000000,327000,4,2.25,1620,106722,1200,420
6806300750,20150318T000000,444900,4,2.5,3120,7448,3120,0
1898900100,20140722T000000,305000,4,2.5,2100,14773,2100,0
2767603931,20140818T000000,469000,3,3.25,1370,1194,1370,0
6072400820,20140926T000000,525000,3,1.75,1520,7875,1520,0
1922059396,20150404T000000,330000,3,2.5,2410,17424,1630,780
8818900300,20141002T000000,618000,4,1,1260,4080,1260,0
9264910900,20141117T000000,295500,4,2.5,2830,7350,1690,1140
3223039013,20140718T000000,567035,3,2,2064,46173,2064,0
5561300750,20140725T000000,518000,4,2.25,2640,34870,1770,870
9407111220,20150504T000000,303000,2,1,1020,9200,1020,0
1332200110,20140708T000000,300000,4,2.5,2200,8065,2200,0
2207200820,20141015T000000,413107,3,1.5,1420,7520,1420,0
3362400615,20140820T000000,400000,3,1,1350,3090,1350,0
3013300017,20150408T000000,535000,3,1,1290,6859,1290,0
1982200015,20140919T000000,555000,4,2,1680,2600,840,840
7140700300,20141119T000000,312000,3,2.5,2280,6386,2280,0
9363600457,20140603T000000,785200,3,2.25,1840,3500,1540,300
1245001220,20141016T000000,749000,4,2,2040,11850,1020,1020
723049333,20150405T000000,285000,3,1.5,1490,10367,1010,480
7853301220,20140910T000000,425000,4,2.5,2440,5088,2440,0
8665900336,20140717T000000,360000,3,2,1930,15540,1260,670
1591000015,20150505T000000,260000,3,1,1200,6615,1200,0
7972601270,20140530T000000,369000,3,2,1550,8509,1150,400
1221039156,20140815T000000,275000,4,2.5,2180,11132,1620,560
993001332,20140903T000000,407000,3,2.25,1430,1448,1430,0
7748000025,20150412T000000,575000,2,1.75,1230,5418,990,240
7871500485,20150427T000000,1.24E+06,3,1.5,1670,3852,1670,0
1370802540,20150108T000000,875000,2,2.5,2720,4913,1700,1020
1839500115,20140712T000000,320000,4,1.5,2220,6811,1270,950
4389201064,20140703T000000,810000,3,1.5,1520,9041,1520,0
1545805820,20150414T000000,274000,3,1.75,1590,7620,1090,500
273800100,20141219T000000,239900,4,1.75,1480,9523,1120,360
7663700654,20141214T000000,450000,4,1.5,1860,7808,1080,780
3751606513,20140630T000000,263400,4,2,1360,60548,960,400
399000025,20150415T000000,265000,3,1,1360,5967,1360,0
7130300785,20140616T000000,418000,4,3,2360,6250,1460,900
3818700123,20140813T000000,390000,3,2,2360,5737,2360,0
7891600245,20150422T000000,430000,3,2,1860,7500,930,930
5556300076,20150423T000000,1.44E+06,3,2.25,2630,9705,2630,0
3421069118,20141120T000000,297000,2,1.75,1280,37373,1280,0
7280300042,20150401T000000,650000,4,2.25,2330,7220,1600,730
9368700031,20140509T000000,195000,2,1,720,18000,720,0
3223069118,20140616T000000,554000,3,3.5,3380,108900,2700,680
2522029039,20140929T000000,550000,3,2,3650,843309,3650,0
7977200590,20150219T000000,700000,3,1.75,1640,4590,1640,0
3124089086,20141002T000000,300000,4,1,1730,177657,1730,0
1568100215,20141007T000000,315000,2,1,1030,8576,1030,0
5364200649,20141008T000000,603000,3,1,1790,5250,1400,390
2771601730,20140629T000000,530000,2,1,840,3400,840,0
7201800300,20140909T000000,397500,3,1.75,1300,8480,1300,0
7224500300,20150325T000000,221000,3,1,1240,5250,1240,0
3876312350,20141202T000000,466000,4,2.25,2170,8050,1220,950
853000261,20140619T000000,197500,3,1,1330,5412,1330,0
7165700110,20150507T000000,280000,3,3,1390,1080,1140,250
5708500208,20141003T000000,412000,2,1.5,1240,3873,860,380
5014000215,20140818T000000,454000,2,1,880,6731,880,0
2126079014,20140512T000000,540000,4,2.25,2540,228254,1450,1090
5595900090,20140609T000000,250000,5,1.5,2520,5753,1510,1010
1445500100,20150511T000000,900000,5,2.25,2510,35691,2510,0
4270600025,20140513T000000,245000,5,1.75,2020,7902,1220,800
3546000490,20141007T000000,290000,3,1.75,2060,7251,1350,710
423049067,20150205T000000,160000,2,1,930,7742,930,0
9272201250,20150330T000000,1.26E+06,2,1.5,2700,7225,1660,1040
3226049184,20150327T000000,325000,2,1,1060,6050,940,120
5381000082,20150108T000000,185000,2,1,670,6750,670,0
475000750,20140925T000000,477000,3,2,1750,4990,950,800
1900000195,20140630T000000,100000,2,1,930,7623,930,0
5162100820,20150504T000000,345000,4,2.5,2420,11481,1370,1050
6113400047,20150331T000000,530000,4,2.25,2410,14985,1950,460
7460000015,20140620T000000,203000,3,1,1150,7156,1150,0
7202340820,20141028T000000,599000,4,2.5,2480,5000,2480,0
5393601690,20140720T000000,370000,4,1,1310,6000,1310,0
7686203275,20150227T000000,140000,3,1,1240,8000,1040,200
2490200165,20140623T000000,500000,3,1,1150,5100,1150,0
597000195,20150203T000000,527200,3,1.75,1460,4000,730,730
5119010090,20140510T000000,549900,5,2.75,3060,7015,1600,1460
1873100490,20150502T000000,760000,4,2.5,3520,8095,3520,0
3336001911,20140728T000000,319000,2,1,960,4400,960,0
1922059445,20140623T000000,362300,3,2.5,2430,15264,2430,0
7203600750,20150427T000000,421000,3,2.5,1930,4505,1440,490
6021503740,20150304T000000,690000,3,1,1090,4000,1090,0
3324069058,20140828T000000,640000,3,2.5,2790,31798,1650,1140
7345310100,20141208T000000,238000,4,1.75,1650,6900,910,740
6398000011,20140602T000000,789000,3,3,3740,39640,3740,0
5460600110,20150423T000000,1.05E+06,6,4,5310,12741,3600,1710
9478500590,20150408T000000,302500,3,2.5,1690,4476,1690,0
8645501091,20150311T000000,259950,4,1.75,1400,7920,1400,0
8099800590,20140620T000000,456000,3,1.5,1440,28516,1440,0
339600090,20140925T000000,369950,3,2.5,1360,3718,1360,0
3522029031,20140516T000000,363750,3,1.75,1726,197326,1726,0
725079058,20140811T000000,585000,3,1.75,2220,216493,2220,0
104530110,20141008T000000,268000,3,2.5,1850,6676,1850,0
6852700246,20140923T000000,1.20E+06,5,2.5,2860,4000,2160,700
2124700015,20140716T000000,345000,3,1,1120,10176,920,200
8665900291,20150225T000000,539000,4,2.5,2340,19850,2340,0
8965500820,20140702T000000,851000,5,3.25,3760,9792,2550,1210
1024000100,20150408T000000,900000,3,2.5,1920,7200,1780,140
6132600165,20140703T000000,850000,3,2.5,3230,5000,2430,800
4040800090,20140506T000000,390000,3,1.75,1260,6500,1260,0
3432500215,20140610T000000,345000,3,1.75,1540,6909,920,620
3630030110,20140616T000000,534500,3,2.5,1700,3150,1700,0
9297300740,20141118T000000,643500,6,5.25,3600,3960,2400,1200
3592500866,20150402T000000,1.21E+06,3,2.75,3150,5520,2130,1020
5019500215,20150115T000000,495000,2,1.75,1280,4000,730,550
3290800215,20140730T000000,535000,2,1,980,4120,830,150
7853230590,20141029T000000,435000,4,2.5,2190,6578,2190,0
1221000490,20141113T000000,305000,4,2,2470,1831,1970,500
5210200077,20140619T000000,799000,4,2.5,2590,7910,2590,0
3275880100,20141113T000000,700000,4,2.5,2580,15031,2580,0
2767704345,20140520T000000,467000,3,2.25,1270,1213,1040,230
1432701380,20150407T000000,263000,3,1,1250,7560,1250,0
1564000740,20140820T000000,760000,4,2.5,4660,7157,3020,1640
8141300300,20150207T000000,293000,4,2.5,2019,4435,2019,0
1388600110,20140821T000000,245000,3,2,1490,7929,1490,0
3523029059,20140731T000000,181000,2,1.5,1560,10807,1560,0
1061500110,20150423T000000,240000,3,1,1030,15264,1030,0
7555210100,20141117T000000,880000,4,2.75,2560,7961,1450,1110
9407150100,20140625T000000,285000,3,2,1460,6377,1460,0
6414100721,20150416T000000,407500,2,1,770,6017,770,0
4307340490,20140812T000000,325000,4,2.5,1960,3543,1960,0
4022900569,20141017T000000,405000,3,1.75,1900,10454,1390,510
2114700115,20150407T000000,291700,3,2.5,1970,4120,1230,740
2320069364,20141016T000000,370000,3,2.5,2490,18525,2490,0
4331400090,20140528T000000,270000,3,1.5,1430,8960,1430,0
3886902870,20140527T000000,800000,4,2.5,2680,7200,1380,1300
9136102680,20140923T000000,626500,3,1.75,1610,3210,910,700
2581900165,20141021T000000,1.13E+06,4,3.5,4300,8406,3580,720
3793501050,20140822T000000,399950,4,2.5,3200,7545,3200,0
619000100,20140724T000000,419000,3,1.75,2140,15030,1570,570
4178700100,20140715T000000,1.16E+06,4,2.5,4240,43995,4240,0
3225059223,20140519T000000,1.41E+06,4,3.5,3410,10769,3410,0
3885805325,20140731T000000,710000,4,2.75,2090,8064,2090,0
4151800195,20150330T000000,650000,3,1,1410,4840,1230,180
1137300690,20150220T000000,369900,4,2.5,2820,33750,2820,0
203600590,20140627T000000,641000,4,2.5,2770,63118,2770,0
7745500015,20150318T000000,403000,3,1,1400,6879,1400,0
1370802600,20140703T000000,1.02E+06,3,3.25,3620,4000,2730,890
5452800645,20140922T000000,865000,4,2.5,2260,13600,1770,490
1324049015,20141111T000000,2.49E+06,4,2.5,3440,23954,2260,1180
7645900165,20141016T000000,810000,4,1,2150,3588,1850,300
6798100652,20140715T000000,316750,3,2.5,1256,1154,1256,0
1023079147,20140820T000000,652500,4,2.25,2220,130244,2220,0
7972601250,20150204T000000,360000,6,2.75,2850,15240,1850,1000
421000215,20150416T000000,208000,2,1,700,5100,700,0
4054520100,20150210T000000,898000,4,2.5,3700,63991,3700,0
3579700015,20150227T000000,295000,4,1.75,1400,11934,1050,350
9310300215,20150506T000000,652500,4,1.75,3130,18253,3130,0
3905081800,20140725T000000,560000,4,3,2170,5764,2170,0
7236100025,20150504T000000,280000,3,1,1020,8400,1020,0
2023049206,20140630T000000,289950,3,2.5,1760,8584,1760,0
3223059015,20150410T000000,397500,3,2.5,1860,44093,1860,0
1726069064,20150324T000000,380000,2,1,1140,75132,1140,0
1423089162,20141031T000000,415900,3,2.5,1670,22703,1310,360
8024201503,20140716T000000,475000,2,1.75,1710,8645,1510,200
859000110,20141002T000000,125000,1,1,500,7440,500,0
2322059039,20140821T000000,238000,3,1,1470,32670,1020,450
2023049245,20140820T000000,296000,4,1.5,1370,9750,1070,300
114100745,20140506T000000,475000,6,3,3470,117612,3470,0
2391601380,20150223T000000,390000,3,2.25,1650,6250,1650,0
2313900740,20141119T000000,425000,3,1,1180,3750,1030,150
9521101015,20140626T000000,725000,6,3,3110,5000,1810,1300
1036400110,20140702T000000,605000,3,2.25,2080,12134,1530,550
2572400100,20141105T000000,302000,3,1,1600,1950,1600,0
6821600300,20150318T000000,886000,3,2.25,2380,6000,1650,730
9547205225,20140814T000000,540000,4,1.75,1630,6120,980,650
3876312490,20150414T000000,435000,4,2.25,1910,8400,1910,0
1591600044,20141010T000000,409000,4,3.25,3140,10752,2300,840
7201800090,20150106T000000,405000,3,1,1250,7280,1250,0
4221270100,20140611T000000,560200,3,2.5,1990,3984,1990,0
2473410690,20140623T000000,324000,4,1.75,2110,7208,1170,940
7300410110,20140519T000000,390000,4,2.5,2490,8290,2490,0
7224500090,20150407T000000,414000,2,1,800,5000,800,0
7852000110,20140903T000000,441500,3,2.5,2360,4670,2360,0
4302200590,20150309T000000,375000,3,2.5,1770,5146,1770,0
8635750090,20140602T000000,668500,4,2.5,2710,5500,2710,0
1133000100,20141007T000000,540000,5,1.5,1940,10202,1940,0
7631800025,20140606T000000,1.04E+06,4,3.25,3450,11240,2430,1020
2998800110,20150325T000000,1.35E+06,4,3.25,3440,4920,2520,920
2432000110,20140507T000000,758000,4,2.75,2410,9549,1780,630
824059140,20140527T000000,949880,4,2.25,2290,10687,2290,0
4229400015,20150507T000000,570000,3,1,1030,4089,1030,0
7805450110,20140506T000000,736000,4,2.5,2290,12047,2290,0
9839301055,20140626T000000,670000,3,1.5,1490,4400,1490,0
9471201110,20150406T000000,1.13E+06,4,1.75,2370,8400,1270,1100
1189000645,20141022T000000,650000,4,2,1930,3976,1930,0
6788201015,20140616T000000,690000,2,1.75,1600,4000,850,750
425069147,20150313T000000,610000,4,2.25,2240,45738,2240,0
9268200600,20140519T000000,413500,2,1,770,4000,770,0
9201000100,20150414T000000,765000,3,2.5,2300,9752,2300,0
4140930110,20141210T000000,828200,4,2.75,3400,7081,3400,0
7226000110,20140726T000000,205000,2,1,900,4397,900,0
4358700100,20141202T000000,465000,3,2.5,1450,5175,1030,420
2228900195,20150311T000000,556000,4,2.5,2240,5402,2240,0
3905100740,20140608T000000,540000,4,2.5,1780,4169,1780,0
3295900490,20140729T000000,423000,4,2.5,2320,4254,2320,0
7379700051,20150410T000000,375000,3,1.75,1590,14766,1590,0
7348200195,20141209T000000,173250,3,1,990,12696,990,0
4047200300,20150205T000000,599900,3,1.5,2605,12030,1355,1250
4242900215,20140618T000000,646000,5,2.75,2870,4461,1650,1220
7851980100,20140605T000000,1.08E+06,5,4.75,5180,17811,4070,1110
9126101645,20140610T000000,558000,4,2,2180,3870,1020,1160
2695600375,20141110T000000,354000,2,1,850,5225,850,0
6648150090,20150108T000000,1.20E+06,4,4,4050,9517,3360,690
1189000245,20150331T000000,670000,4,2,2250,4200,1650,600
1169000057,20141006T000000,1.13E+06,6,4.25,3100,9378,3100,0
4013800131,20140807T000000,267500,2,1,1747,12250,1747,0
1787270090,20150225T000000,299800,4,2.5,2410,4708,2410,0
4037200735,20150414T000000,430000,4,1.75,2070,9120,1250,820
4083302370,20150313T000000,775000,5,1,1860,3040,1530,330
4319200820,20150122T000000,333000,3,1,950,5214,830,120
7663700551,20150407T000000,336000,3,2,1060,11765,1060,0
6821102350,20150109T000000,323000,2,1,880,1712,880,0
723069089,20140715T000000,575000,4,2.5,2550,56628,2550,0
8165500110,20141205T000000,328000,2,2.25,1550,2079,1550,0
8081900195,20141210T000000,572500,3,1,1590,4600,1290,300
2878601425,20140522T000000,600000,3,1.75,1650,5100,1040,610
5104512070,20150420T000000,412000,4,3,2430,7242,2430,0
3885802970,20141203T000000,827500,3,2.5,1810,7200,1310,500
3021049140,20150325T000000,300000,4,2.5,2890,17349,2890,0
5249801720,20141113T000000,415000,3,2.5,1280,5040,1280,0
2025049006,20141112T000000,750000,7,2.75,3410,4056,2130,1280
7575700015,20140710T000000,800000,3,2.75,2220,4000,1700,520
2724049146,20150317T000000,420000,3,1,1060,6000,1060,0
8074200100,20141015T000000,266000,3,1.5,1120,8250,1120,0
1517900100,20141021T000000,499000,4,2.5,2680,10590,2680,0
2391602250,20140626T000000,440000,4,1.5,1770,5750,1770,0
7635801311,20140623T000000,495000,3,2,2950,12196,2310,640
3362401295,20150330T000000,630000,2,1.75,1260,5300,840,420
3303230110,20140804T000000,424000,3,1.75,1430,6818,1430,0
1522600100,20140604T000000,760000,4,2.5,2730,36183,2730,0
6646200090,20140819T000000,650000,4,3.5,3270,15704,2110,1160
2522059112,20140507T000000,248500,4,1.75,1720,10018,1720,0
3205100110,20150421T000000,379600,3,1.75,1270,12420,1270,0
6414100025,20140721T000000,538000,4,2.5,3260,10032,1960,1300
3529000930,20140616T000000,530000,4,2.5,2050,6360,2050,0
4141400100,20150120T000000,545000,4,2.25,2050,9720,2050,0
9562200090,20140624T000000,925000,4,3,3580,35261,3580,0
7399800110,20141209T000000,565000,4,2.75,1960,48787,1960,0
6917700356,20140514T000000,405100,2,1,840,3522,840,0
4040800600,20140609T000000,502000,3,1.75,1300,8800,1300,0
3629920300,20141103T000000,425000,3,2.25,1260,3000,1260,0
8944290090,20140623T000000,233500,3,2.25,1650,2958,1650,0
8091410930,20150323T000000,287000,3,2.5,1710,10341,1710,0
3313600266,20150213T000000,190000,3,1,1180,8775,1180,0
9508850100,20141103T000000,666000,3,2.25,2780,31510,2780,0
3330501545,20141201T000000,330000,2,1,950,3090,950,0
31000165,20140911T000000,1.49E+06,5,3.5,3620,7821,2790,830
4123810090,20140909T000000,393000,3,2.25,2140,10256,2140,0
1180500100,20140924T000000,353000,4,2.75,1920,4627,1010,910
7549801140,20141020T000000,260000,2,1,750,6720,750,0
7254000100,20141215T000000,680000,3,2.5,2060,2551,1900,160
644200090,20140715T000000,921000,3,2.25,2380,11200,2380,0
5101407305,20141218T000000,319000,2,1,750,6380,750,0
6817801030,20150422T000000,280000,3,1,1160,10881,920,240
7454001280,20140611T000000,220000,3,1,1050,6300,1050,0
8651440740,20150121T000000,219000,3,1.5,1740,5200,1060,680
1954430190,20140808T000000,528000,4,2.75,2050,7171,1540,510
4292300010,20140527T000000,405000,3,1.75,1980,8100,1310,670
8929000290,20140514T000000,372977,3,2.5,1690,1618,1150,540
1250201680,20150507T000000,934550,4,3.25,2320,5900,2320,0
868001705,20150206T000000,1.47E+06,3,1.5,2480,9900,2130,350
1370801585,20140603T000000,975000,4,2.25,2290,5350,2120,170
7501000130,20140505T000000,800866,5,2.5,3180,13806,3180,0
4178300130,20150413T000000,950000,7,3.5,3470,16264,3470,0
7550801206,20140904T000000,624000,4,3,1540,4140,1540,0
9201300050,20140814T000000,1.85E+06,5,2.25,2800,8442,2800,0
3816300095,20140514T000000,310000,3,1,1050,9876,1050,0
7399301100,20141204T000000,315000,3,1.75,1480,6800,1480,0
4151800470,20140820T000000,675000,3,2,1010,5973,1010,0
7811000020,20141113T000000,490000,3,1.75,1660,8208,1660,0
5166700050,20150211T000000,600000,5,2.25,2760,6350,1380,1380
4045500130,20140909T000000,154000,2,1,1040,20524,1040,0
2927600675,20140609T000000,480000,4,1.75,2220,6500,2220,0
7686202580,20150213T000000,196900,3,1,1270,7500,1270,0
5690500095,20140826T000000,735000,3,3.25,2960,39370,2960,0
3876540630,20150227T000000,205500,3,2,1330,8748,1330,0
8929000170,20140616T000000,357186,2,1.75,1210,1040,1210,0
2621400080,20150128T000000,275000,4,2.5,2120,6754,2120,0
8154100020,20140906T000000,248500,3,1.75,2090,12026,2090,0
8097000190,20140602T000000,350000,3,2.5,2680,7836,2680,0
2624089181,20140812T000000,390000,4,2.75,1790,47250,1220,570
8718500275,20140715T000000,390000,3,2.75,1950,12240,1250,700
3575305495,20150413T000000,660000,5,2.25,3740,14913,3740,0
411100020,20141117T000000,310000,3,1.75,1140,8263,1140,0
9113200020,20140612T000000,717000,3,2.5,2480,5137,2480,0
2011400019,20141230T000000,260000,5,2.5,2580,11250,1410,1170
3912000020,20150430T000000,745000,3,2,2290,5001,1490,800
8078370010,20150218T000000,470000,4,2.5,2320,12042,1320,1000
5104650020,20150505T000000,429000,3,2.5,2530,8820,2530,0
7417700664,20150408T000000,220000,4,2,1400,7140,1400,0
2770604920,20140903T000000,497000,3,3,2060,1850,1400,660
1930300190,20140714T000000,716100,3,1,1640,4000,1640,0
3024079069,20140911T000000,371000,4,1,1960,94525,1960,0
723069049,20140724T000000,379000,5,2.75,3000,25175,1500,1500
2210500019,20150324T000000,937500,3,1,1320,8500,1320,0
3856901435,20141027T000000,720000,4,2,1760,4500,1760,0
3948900050,20150427T000000,616000,3,3.25,2130,2306,1420,710
5412400170,20150414T000000,259000,3,2,1390,7120,1390,0
2856102280,20140514T000000,538000,3,1.75,1400,3825,1100,300
3288100290,20150507T000000,605000,3,2.75,3230,9576,3230,0
5145000190,20141103T000000,369950,3,1,1110,7603,1110,0
6679000170,20150414T000000,310000,3,2.5,1670,4220,1670,0
9536601045,20150428T000000,227500,3,1,1540,9450,1540,0
8731981410,20141121T000000,274000,4,2.25,2090,7400,1670,420
3574801350,20141120T000000,410000,3,2,1410,8088,1410,0
1922069099,20140523T000000,354800,3,2,1370,78408,1370,0
871001735,20140911T000000,650000,4,2.25,1910,5120,1300,610
2022059308,20150505T000000,353000,3,2,1678,13862,1678,0
2525300480,20150304T000000,224975,3,1,960,12745,960,0
7979900440,20150512T000000,600000,2,1.75,2080,13054,2080,0
2558660290,20150218T000000,437500,3,2.25,1790,7700,1340,450
8650300190,20140521T000000,567000,3,2.5,2540,6093,2540,0
8643000225,20150506T000000,225000,5,1.5,1790,11656,1790,0
1105000233,20140906T000000,255000,2,1,940,9330,940,0
9831200500,20150304T000000,2.48E+06,5,3.75,6810,7500,6110,700
945000250,20140613T000000,370000,2,1,900,4600,900,0
4101410050,20150421T000000,675000,4,1.75,1900,8800,1140,760
1571100130,20140904T000000,285000,3,1,1440,4268,1040,400
7932000078,20140507T000000,310000,3,1.75,2070,37904,1420,650
2592400170,20141202T000000,475000,4,2.5,2240,7245,1140,1100
2517010630,20150508T000000,410000,4,2.5,3320,5034,3320,0
6926700225,20140702T000000,895000,4,2.25,1950,5950,1330,620
8820902905,20140822T000000,375000,3,1.5,1240,7733,790,450
5104510190,20150427T000000,349000,4,2.5,1830,4694,1830,0
9839301060,20150406T000000,650500,3,1.75,1740,4400,1740,0
2425700005,20150428T000000,760000,3,1.75,1410,15120,1410,0
9276201190,20140520T000000,480000,4,2.75,2050,3960,1180,870
8644210050,20140926T000000,689000,4,2.75,3220,16145,3220,0
2741100280,20140513T000000,415000,3,1.75,1960,5000,980,980
2891000680,20150427T000000,195000,3,1.75,1070,6110,1070,0
7366100080,20140731T000000,318000,5,2.5,2820,9956,1410,1410
3211270170,20140523T000000,404000,4,3,4060,35621,2030,2030
3330500920,20141030T000000,339950,2,1,800,3090,800,0
5437820080,20141124T000000,215000,3,1,1260,7897,1260,0
8097000380,20140818T000000,339900,3,2.5,2420,7423,2420,0
2591010290,20140519T000000,285000,1,1.5,810,3211,810,0
1324300380,20140716T000000,550000,3,1,1600,5000,1110,490
3226049478,20140725T000000,430000,4,1,1350,9000,1350,0
7941500170,20141202T000000,219000,3,1,970,7790,970,0
7522500005,20140815T000000,555000,2,1.5,1780,4750,1080,700
1545801630,20140721T000000,233000,3,2,1350,7686,1350,0
5151600480,20150402T000000,248000,3,1.75,1840,19501,1270,570
2731600080,20150422T000000,454000,5,2.25,2550,9200,1580,970
2804600010,20150331T000000,950000,4,2.5,1700,4418,1700,0
8899210680,20140915T000000,359000,3,2.5,2430,7857,1730,700
6649300190,20140903T000000,407500,5,2,2740,8230,2210,530
1312200080,20140528T000000,224000,3,1.5,1560,7300,1040,520
1721801025,20140718T000000,210000,2,1,1040,4590,1040,0
7942200050,20150123T000000,261000,4,1.75,1820,9824,1820,0
9528100963,20140806T000000,719000,3,3,1833,1706,1833,0
9297301495,20150203T000000,440000,3,2.5,2160,3738,2160,0
192300020,20140521T000000,525000,3,2.75,2100,10362,1510,590
9477100170,20140721T000000,375000,3,1.5,1370,9720,1370,0
6705120280,20150331T000000,428000,2,2.5,1414,1960,1414,0
7203220050,20141118T000000,988830,5,3.25,4115,7910,4115,0
6858700225,20141004T000000,199950,3,1.75,1550,6225,1550,0
8712100605,20141028T000000,840000,4,2.25,2100,3671,1750,350
5702380500,20140908T000000,285000,3,1.75,1160,7006,1160,0
6181430280,20140915T000000,330000,5,2.5,3597,4972,3597,0
7138000170,20150102T000000,147500,3,1.5,1230,10125,1230,0
6669010290,20141107T000000,320000,4,2.5,2190,7125,2190,0
5706200280,20140701T000000,382500,3,1.75,1040,9000,1040,0
1338300170,20150324T000000,2.05E+06,5,4,4690,8208,3040,1650
8562800250,20140814T000000,596000,4,2.25,2270,10000,1720,550
109210280,20141111T000000,220000,4,2.25,1950,7280,1950,0
3216900080,20140925T000000,325000,3,2.5,1880,6818,1880,0
629500170,20150326T000000,679950,4,2.5,2850,5664,2850,0
5272200005,20150218T000000,175000,2,1,1160,6911,1160,0
7205000080,20141201T000000,268000,3,1.75,1370,10050,1370,0
1117200170,20140919T000000,715000,4,3.5,3260,110579,3260,0
5561300480,20150408T000000,600000,7,2.25,3170,36384,3170,0
6896300380,20141002T000000,228000,0,1,390,5900,390,0
3293400010,20150304T000000,950000,5,2.5,3450,35880,3450,0
3421059049,20140610T000000,475000,2,1.75,1490,224334,1490,0
524069049,20150402T000000,700000,3,1.5,1460,78408,1460,0
1524079093,20140827T000000,275000,3,1.75,1300,20700,1300,0
1524079093,20150318T000000,369500,3,1.75,1300,20700,1300,0
3832710680,20140721T000000,215000,4,2,1540,7575,1040,500
686200840,20150422T000000,593450,4,2.25,2130,7172,2130,0
8682310460,20140709T000000,498800,2,1.75,1350,4614,1350,0
446000190,20141208T000000,849000,5,3.25,2450,6534,1770,680
8805900430,20141229T000000,1.15E+06,4,2.5,1940,4875,1940,0
3629921060,20140715T000000,825000,5,2.5,2890,5110,2890,0
8856890020,20150224T000000,265000,3,1.75,1680,9769,1340,340
2115510470,20141223T000000,285000,4,2.25,1960,10400,1220,740
1545803890,20141231T000000,240000,3,1.75,1590,7931,1190,400
3322049126,20140721T000000,261000,4,1,1390,17739,1390,0
6669020500,20140627T000000,330000,4,1.75,2440,7350,1610,830
3832710840,20140602T000000,250000,4,2,1850,7560,1540,310
7212651950,20140710T000000,350000,4,2.5,2800,9538,2800,0
1331900020,20140925T000000,930000,3,2.5,3780,35273,3780,0
7140200380,20141030T000000,275000,3,2,1910,8050,1000,910
7972601235,20150223T000000,325000,4,2.25,2460,7620,1230,1230
2848700585,20150424T000000,255000,1,1,810,5000,590,220
6132600380,20150320T000000,562200,3,1.5,1900,5250,1500,400
2424059127,20140820T000000,952000,2,1.75,3490,88909,2320,1170
2591830130,20140504T000000,365000,3,2.5,2200,7350,1570,630
1771100130,20150316T000000,332900,3,1.5,1190,11996,1190,0
8856700190,20150423T000000,721000,3,2.25,2040,18360,2040,0
7852040080,20150421T000000,487275,4,2.5,2400,3986,2400,0
5648600190,20150429T000000,310000,3,2.5,1670,5791,1670,0
4154300275,20150115T000000,245000,2,1,990,4800,990,0
5438000280,20150415T000000,325000,3,1.75,2920,10573,2920,0
9201000480,20141112T000000,550000,3,1.75,1840,9401,1840,0
1604600660,20140512T000000,350000,2,1,910,4500,910,0
522069022,20140714T000000,599000,5,2.5,2950,72309,2950,0
4331400190,20141112T000000,259950,3,1.5,1240,9500,1240,0
9407150130,20141201T000000,240000,4,2.5,1980,7264,1980,0
2212900470,20150211T000000,186000,3,1,1200,10080,1200,0
6600220080,20150204T000000,395000,3,1.5,1280,15028,1280,0
9558050020,20140915T000000,475000,4,2.5,3150,5757,3150,0
8691300420,20140804T000000,815000,5,3.5,3500,10794,3500,0
5450300010,20140902T000000,572000,3,1.5,1680,13751,1680,0
339600460,20141017T000000,419500,3,2.5,1360,3188,1360,0
9264910920,20140903T000000,298700,3,2.25,2110,7350,1530,580
121029034,20140624T000000,549000,2,1,2034,13392,1159,875
2123049420,20150422T000000,278000,3,1.5,1900,9994,1120,780
7950302890,20141230T000000,455000,4,2,2380,4500,1470,910
6117500430,20140819T000000,925000,5,3.5,4050,13495,2230,1820
1972200660,20150415T000000,465000,2,1.5,1120,1201,1120,0
3629830050,20141001T000000,620000,4,4,2850,2970,2120,730
9257900010,20150422T000000,499900,4,2.25,2360,7650,1640,720
6072000440,20150206T000000,620000,5,3,2540,11422,1270,1270
6844702630,20141108T000000,450000,3,1.75,1160,6120,1040,120
3630090050,20150220T000000,690000,4,3.5,2710,2147,2220,490
9809000020,20140513T000000,1.90E+06,5,2.25,3120,16672,3120,0
9809000020,20150313T000000,1.94E+06,5,2.25,3120,16672,3120,0
5021900050,20140818T000000,832500,3,2,1870,9527,1870,0
1003600080,20141107T000000,245000,3,1,1010,9678,1010,0
7701960130,20141017T000000,820000,3,2.5,2980,18935,2980,0
2395710020,20140807T000000,369000,4,2.75,2420,6495,2420,0
7203230010,20141015T000000,1.05E+06,4,3.25,3830,8331,3830,0
9830200380,20140917T000000,653000,3,3,3040,5067,3040,0
9407111100,20150422T000000,220650,2,1.75,1460,10500,1460,0
9572000080,20140616T000000,300000,5,3,1940,6355,1200,740
3629870420,20140912T000000,970000,4,3.5,3780,20023,3780,0
2459970020,20141124T000000,360000,4,2.5,1950,5451,1950,0
5547700190,20150330T000000,672500,3,2.5,2450,5760,2450,0
421000285,20150423T000000,268000,4,1.5,1730,7020,1730,0
3277801640,20141202T000000,440000,4,1.5,1690,3245,1690,0
1250203070,20140514T000000,1.40E+06,3,2.5,2550,7200,2550,0
8077200470,20140718T000000,590000,4,2.5,2290,11072,2290,0
302000545,20150127T000000,359000,4,2.25,2710,22860,1850,860
9542801990,20140529T000000,266500,4,1.75,1880,7632,1180,700
3343901403,20141216T000000,635000,4,2.5,2930,8679,2930,0
1121059030,20141013T000000,559000,3,2.5,3110,217800,3110,0
9290850950,20141218T000000,895000,4,2.5,3480,38985,3480,0
1136100006,20150127T000000,625000,2,1.5,1110,118047,1110,0
7923300285,20150312T000000,650000,4,2.25,2440,9320,1880,560
1823059028,20150224T000000,312500,4,1.75,2280,7840,1280,1000
8864000440,20140925T000000,225000,3,1,900,6099,790,110
9512500680,20141119T000000,425000,4,1.75,1980,8400,1330,650
3421069120,20150219T000000,329999,3,2.75,3360,41250,1820,1540
4376700430,20140716T000000,572000,5,2.25,2340,9225,2340,0
8562890430,20150407T000000,386500,4,2.5,3110,5048,3110,0
452002005,20150121T000000,452000,2,1,980,5000,980,0
7228500094,20141212T000000,278000,4,2,1480,6324,1480,0
8078700020,20140603T000000,474900,3,2.25,1800,43647,1800,0
5035300255,20150414T000000,450000,2,1.75,2130,6574,1500,630
9528104985,20141104T000000,611000,2,1,1270,5100,1100,170
7237590010,20140605T000000,214100,2,2.5,1150,2064,1150,0
3158500250,20140514T000000,317000,3,2.5,1840,5011,1840,0
868001402,20150305T000000,1.00E+06,4,3.5,3180,12528,2060,1120
5606000233,20150424T000000,1.00E+06,5,2.75,1510,5700,1510,0
5214500660,20150505T000000,525000,4,2.5,3070,7200,3070,0
3578110020,20141001T000000,436000,3,2.25,1800,6680,1800,0
3578401330,20140718T000000,450000,3,1.75,1540,9154,1540,0
7525000080,20140502T000000,588500,3,1.75,2330,14892,1970,360
4273000095,20150511T000000,340000,4,1.75,1400,8374,1400,0
4014400190,20140714T000000,482000,4,2.5,2846,85377,1976,870
8678500020,20141213T000000,1.58E+06,4,3.5,5830,131116,5830,0
6918700130,20140811T000000,749000,3,2.5,3380,7126,3380,0
2473350470,20150511T000000,330000,3,1.5,1440,7875,1440,0
9274200314,20140821T000000,568000,3,2.5,1740,1279,1740,0
2938100010,20140924T000000,239000,3,1.75,1470,8925,1470,0
8564950250,20150107T000000,528000,3,2.5,2810,4932,2810,0
3438502715,20140730T000000,385000,4,3,2090,5102,1350,740
280610020,20140902T000000,825000,4,3.25,4110,14219,2570,1540
2487200938,20141126T000000,815000,5,3.25,3230,5000,2350,880
1775500362,20141013T000000,625000,4,2.5,2601,34335,2601,0
2483200010,20141007T000000,690000,3,1.75,2070,6000,1340,730
4365700130,20150325T000000,210000,3,1,1660,7440,1270,390
9136101271,20150416T000000,599000,4,1,1590,4280,1590,0
1370804295,20150212T000000,860000,3,1.75,1860,5584,1310,550
422049178,20150212T000000,147200,3,1,1420,9600,1420,0
9161100795,20150506T000000,476900,3,1,1240,5758,960,280
5561300380,20140807T000000,450000,4,2.5,2500,36254,1590,910
1443550020,20150506T000000,570000,4,2.5,2640,11816,2640,0
9547201155,20141016T000000,567500,3,1,1440,3060,1440,0
3625059120,20141023T000000,790000,5,3.25,3030,20446,2130,900
644000185,20140707T000000,875000,3,1.5,1820,12686,1820,0
5710500010,20140610T000000,490000,3,2,2220,10275,1640,580
2482410130,20140610T000000,335000,3,1.75,2430,9133,1410,1020
6071900130,20150415T000000,550000,3,1.75,1670,10798,1670,0
6817800630,20140516T000000,385000,3,1.75,1180,10541,940,240
6204400130,20140718T000000,395000,3,1.75,1620,8085,1210,410
9274203190,20140611T000000,650000,2,1,1030,5750,1030,0
293610020,20150304T000000,637000,4,2.75,2900,5803,2900,0
3583400130,20141014T000000,692500,3,2.25,3420,9900,1710,1710
7230400430,20140930T000000,322400,3,1.75,1710,15844,1710,0
7140600190,20140905T000000,233500,3,1.5,1580,10517,1580,0
6817801410,20140624T000000,400000,3,2,1230,11413,990,240
6430500010,20140620T000000,547000,5,2.5,2200,4080,1420,780
3023049215,20140702T000000,519000,5,2.25,2570,13054,1470,1100
3625710080,20140626T000000,1.03E+06,4,3.5,3320,19850,2040,1280
3390600010,20140502T000000,365000,3,1,1090,6435,1090,0
9238480020,20150319T000000,699000,5,2.75,2970,36817,2970,0
1036000080,20141009T000000,525000,3,1.75,1970,8000,1970,0
1561930020,20140522T000000,430000,4,3,3220,8936,2450,770
3876100080,20141215T000000,325000,3,1,1600,7500,1600,0
7454000605,20140710T000000,279000,2,1,670,6300,670,0
1870400635,20150311T000000,805000,4,1.75,2360,4750,1660,700
8820900299,20150204T000000,419950,3,3,2150,3962,1540,610
8132700185,20150416T000000,425000,2,1,620,4455,620,0
6413600275,20140724T000000,446000,4,1.75,1730,5922,1730,0
2888000020,20150302T000000,455000,5,2,2500,7860,1040,1460
3298700426,20140709T000000,226550,3,1,990,4440,990,0
3362401815,20140930T000000,764000,3,2,1420,4080,1420,0
5469500020,20150505T000000,439950,3,2.25,2170,15000,2170,0
6430000280,20141216T000000,453000,4,2,1880,5100,1880,0
1140000190,20150206T000000,219950,3,1,1300,9620,1300,0
8021700715,20140514T000000,702500,3,1.5,2360,6750,1930,430
5151600170,20141016T000000,285000,3,1.5,1780,12231,1780,0
8129700255,20150213T000000,798750,2,2.25,2160,2578,2160,0
9285800345,20140626T000000,320000,2,1,950,5316,950,0
5706200170,20141216T000000,425000,3,1.75,1680,14630,1680,0
5536500020,20140716T000000,540000,4,2.5,2290,4450,2290,0
98000950,20141210T000000,1.06E+06,4,5.25,4140,14757,4140,0
3362401611,20150325T000000,1.17E+06,4,3.75,3920,4500,3920,0
6205500280,20150421T000000,576000,3,1.75,1500,13891,1500,0
7199330010,20150417T000000,525000,3,1.75,1720,7200,1140,580
1332200130,20140822T000000,324950,4,2.5,2641,8615,2641,0
3244500078,20140822T000000,600000,3,2.5,4930,77536,3930,1000
3342102880,20140811T000000,464000,3,2.5,2460,5400,1520,940
2557000630,20140707T000000,266000,4,2.25,1995,7102,1995,0
1117200190,20140804T000000,775000,3,2.5,3010,74390,3010,0
8122100130,20140618T000000,415000,3,1.75,1270,4800,1270,0
9558040050,20140919T000000,550000,4,2.75,3080,6731,3080,0
5702380630,20150114T000000,235000,3,2.25,1670,7606,1670,0
3300790670,20140620T000000,280000,3,2,1470,8089,1470,0
2558660190,20141030T000000,459000,3,1.75,1730,7807,1260,470
4388000460,20141014T000000,195000,3,1,1070,7615,1070,0
3224800010,20141112T000000,235000,3,1.5,1660,8738,1080,580
1672000020,20141126T000000,711800,4,2.25,2410,16650,2410,0
2767701416,20150116T000000,440000,3,2.5,1040,1032,1040,0
7821200307,20150217T000000,515000,2,1,970,3300,970,0
4219400290,20140502T000000,1.20E+06,5,2.75,2910,9480,2910,0
6072650290,20150406T000000,560000,3,1.75,2340,12443,2340,0
5647900670,20140620T000000,340000,3,1.75,1880,11249,1330,550
1965200010,20141110T000000,600000,2,1,1110,3500,970,140
319500080,20140618T000000,764000,4,2.5,2790,7938,2790,0
9526500080,20140729T000000,337000,4,2,1590,8779,1590,0
7856410430,20140530T000000,1.39E+06,6,2.75,5700,20000,2850,2850
8128700005,20141119T000000,249000,4,1,1200,7552,1060,140
3444910020,20140715T000000,350000,3,3,3200,35782,2360,840
2025700130,20150129T000000,269950,3,2.25,1510,6000,1150,360
224069134,20150225T000000,735000,3,1.75,1880,108900,1880,0
4217400305,20150331T000000,1.30E+06,4,2.5,3070,4000,2070,1000
3288301410,20140911T000000,475000,4,2.25,2110,7560,2110,0
9264950660,20150310T000000,339000,3,2,2350,8459,2350,0
6744700285,20150311T000000,600000,4,3.5,3270,15160,1660,1610
7750500275,20140807T000000,397500,4,1.75,2220,4760,1320,900
1125069153,20140822T000000,1.53E+06,4,3.5,5990,111078,5990,0
1425059178,20140507T000000,460000,3,2,1760,9055,1760,0
6671900130,20141216T000000,370000,4,2.75,2200,5207,1120,1080
3172600151,20150325T000000,250000,4,1,1550,7296,1550,0
7237550020,20140703T000000,1.10E+06,4,3.75,5070,60123,5070,0
1934800078,20140930T000000,430000,2,2.25,1040,1516,1040,0
4385700660,20140807T000000,1.09E+06,3,1.5,2560,4000,1660,900
923000414,20150419T000000,670000,3,1.75,1850,8160,1850,0
2624049167,20150423T000000,461550,3,1.5,2090,11895,1790,300
8929000380,20140805T000000,479990,3,2.5,2010,2386,1390,620
4221250010,20150414T000000,643000,4,2.5,2518,4663,2518,0
8861500080,20140930T000000,607000,3,2.75,2810,12813,2040,770
1592000780,20140523T000000,625000,3,2.5,2600,10092,2600,0
2484200080,20140729T000000,731100,3,2.5,2060,8778,1160,900
2322059136,20150309T000000,859000,3,2.5,2920,434728,2920,0
2591820080,20141103T000000,435000,4,2.5,2130,10375,2130,0
5729000080,20141029T000000,465000,3,3,2290,15600,1420,870
5100402764,20150415T000000,740000,3,1,1230,6380,1230,0
5454000010,20141210T000000,740000,3,1.75,2020,9478,2020,0
5412300130,20141119T000000,250000,3,2,1430,7280,990,440
6873000190,20150311T000000,656000,2,2.5,2270,1763,1820,450
9485300190,20141009T000000,300000,4,2.5,1910,8058,1910,0
326069132,20150220T000000,643000,3,1.5,1780,214315,1780,0
3832061060,20140807T000000,311000,4,2.5,2690,6124,2690,0
6918730130,20140721T000000,360000,3,1.75,1330,7482,1330,0
7952800010,20140519T000000,475000,4,2.5,3060,10043,1700,1360
3834500417,20140809T000000,469950,3,3.25,1760,1778,1760,0
5071700020,20140703T000000,240000,3,1.75,1570,8750,1570,0
3826000470,20140929T000000,232000,2,1,960,8100,810,150
921059132,20140813T000000,350000,3,2,1680,81893,1680,0
1926059027,20150109T000000,803000,2,1,1440,33747,1440,0
1328320440,20141210T000000,355000,3,2.25,1960,7000,1600,360
1972202005,20140521T000000,475000,4,2,1790,2250,840,950
2592201350,20150324T000000,823000,3,2.5,2560,9825,2560,0
6430500293,20141112T000000,395000,2,1.5,1010,3060,1010,0
6450300840,20150427T000000,499000,4,3.75,2560,5250,1900,660
1189000225,20150402T000000,420000,2,1.75,1200,3136,800,400
7804700020,20140812T000000,961500,3,2.5,3910,14000,3910,0
9542300430,20150331T000000,833000,4,1.75,2260,12238,2260,0
1775930440,20140623T000000,479000,3,2.25,2110,11319,2110,0
1725059182,20140701T000000,1.15E+06,4,2.5,3340,10422,3340,0
3992700130,20140708T000000,267000,3,1,1400,8100,1400,0
824069193,20140911T000000,555000,4,1.75,1760,94525,1760,0
3904910480,20140731T000000,490000,3,2.5,2010,9725,2010,0
2877102651,20140529T000000,619000,4,2,2300,3400,1550,750
9289100170,20141031T000000,569950,5,2.75,2510,28185,1600,910
3797000680,20141125T000000,549000,3,2,1340,3000,1340,0
3378900020,20141023T000000,422500,3,1.75,1560,7245,1560,0
4180300050,20140801T000000,400000,4,3.5,3350,9681,2140,1210
7852010670,20140709T000000,692500,4,2.75,3710,7984,3710,0
8562890280,20140626T000000,310000,4,2.5,2430,5499,2430,0
3991400080,20141216T000000,499900,3,1.75,2430,8820,1630,800
8651510020,20140827T000000,492000,3,2.25,2100,7335,2100,0
3924500130,20150506T000000,460000,2,2.5,1880,40575,1880,0
2533300130,20140716T000000,800000,3,2.5,1630,2640,1630,0
510002995,20150407T000000,832600,4,1,1640,4200,1640,0
3825500080,20150318T000000,470000,4,2.75,2310,7350,1670,640
8682231190,20141021T000000,542000,2,2,1930,4500,1930,0
9412400185,20140619T000000,1.31E+06,4,4.5,4750,13912,3600,1150
7893804790,20141010T000000,308130,4,2.5,2300,7500,1650,650
3630070010,20150311T000000,310000,2,1,1050,2699,1050,0
723049132,20141022T000000,235000,2,1,1500,8015,1500,0
1432600415,20140919T000000,215000,3,1,1150,7560,1150,0
3306200010,20140605T000000,210000,4,1.5,1920,10403,1370,550
425069102,20141126T000000,730000,4,2.75,3660,150282,3660,0
1683600130,20141210T000000,245000,3,1.75,1720,9342,1140,580
3741600020,20140915T000000,540000,3,2.25,2100,20018,1470,630
5412101150,20150203T000000,299000,4,2.5,2400,6078,2400,0
509000020,20141118T000000,510000,3,2.5,2540,40106,2540,0
1311500020,20140703T000000,198000,4,1.75,2080,7200,1050,1030
662350050,20140523T000000,950000,5,3.25,3400,7452,3400,0
3327020290,20150220T000000,300000,4,1.75,2200,7600,2200,0
1086100130,20140904T000000,528000,5,1.75,2140,8580,1200,940
2111011060,20140618T000000,507000,5,3.25,3850,16249,3030,820
7852090280,20150219T000000,770000,4,3.25,4270,6384,3060,1210
2873000780,20150220T000000,255000,3,1.75,1340,7210,1340,0
3530470190,20150505T000000,220000,1,1.5,1100,3451,1100,0
5014600440,20150223T000000,690700,5,2.75,2870,5349,2870,0
5049800005,20140627T000000,447000,2,1,1320,8380,1320,0
7443001470,20140520T000000,755000,6,2,2150,4505,1270,880
2771604640,20150313T000000,700000,4,1.5,2470,6000,1480,990
7140200280,20140715T000000,250000,4,2.75,1910,7700,1000,910
3793500780,20140510T000000,320000,3,2.5,2130,6969,2130,0
5525400420,20140514T000000,565000,4,2.5,2240,14667,2240,0
7986400305,20150424T000000,754300,5,2.75,1800,4500,1680,120
3619600143,20140505T000000,650000,3,1.5,2160,9000,1400,760
7787890050,20150218T000000,529888,4,2.5,3140,8455,3140,0
2780700050,20141106T000000,432000,3,2.5,1920,9812,1920,0
5595900280,20150318T000000,235000,3,1,1050,7670,1050,0
7203220130,20150127T000000,994900,4,3.5,3695,6556,3695,0
9406540130,20150403T000000,489000,4,2.5,3910,8442,2710,1200
9526600250,20150420T000000,800000,4,2.75,3010,7427,3010,0
9542900190,20140516T000000,370000,4,1.5,1370,9957,900,470
3840700653,20141212T000000,436000,4,2.75,2080,9600,1240,840
6084200080,20140528T000000,395000,3,2.5,2250,3757,2250,0
3705900130,20140523T000000,377691,5,1.75,2120,8399,1320,800
3333002385,20150417T000000,370000,5,3,2220,5185,2220,0
3904910050,20141023T000000,515000,3,2.5,1440,4394,1440,0
5556900080,20140926T000000,169000,3,1,910,7686,910,0
4443800415,20150321T000000,475000,3,1,1270,4268,1270,0
3791400250,20150425T000000,420000,3,2.5,2480,6180,2480,0
9551201585,20140701T000000,1.30E+06,6,2.75,2630,9420,2510,120
7856620050,20150225T000000,822000,3,2,2410,13300,1840,570
9320200050,20141216T000000,1.50E+06,4,2.75,2930,25697,2310,620
1954420380,20150330T000000,485000,3,2.25,1570,6810,1180,390
740500010,20140807T000000,270000,4,1,1900,8505,1200,700
6673050020,20150401T000000,300000,6,2.5,2590,11250,1390,1200
1853081060,20150416T000000,878000,4,2.5,3810,7728,3810,0
6308000020,20150403T000000,590000,3,2.5,2290,4203,2290,0
1720800305,20141119T000000,611900,1,2.25,1220,2100,1220,0
1682000280,20150319T000000,240000,3,1.75,1100,7373,1100,0
3814800280,20150417T000000,395000,4,2.5,2810,10951,2810,0
3352402195,20140716T000000,169000,3,1,890,7110,890,0
9320600170,20150324T000000,200500,3,2,1280,14972,1280,0
5205000250,20150410T000000,308000,3,2.5,2320,7140,2320,0
9264920250,20140710T000000,290256,3,2.25,1720,7885,1720,0
2473101190,20150427T000000,279950,3,1.75,1530,8800,1040,490
5437820020,20140807T000000,195000,3,1.75,1580,7875,1580,0
4067600275,20140826T000000,630000,3,1,1360,13000,1360,0
6447300345,20150406T000000,1.16E+06,4,3,2680,15438,2680,0
3905100280,20140701T000000,478000,3,2.25,1640,3896,1640,0
9285800275,20140814T000000,835000,3,2.25,2520,6690,1700,820
1891100130,20150417T000000,639000,3,2.25,1400,2421,1400,0
1592000250,20141013T000000,623000,4,2.75,2300,12633,2300,0
2328800130,20141217T000000,220000,3,1.75,1900,7680,1260,640
6067910130,20150325T000000,526000,3,2.25,2000,18099,1250,750
3333002790,20150123T000000,243500,2,1,900,5016,900,0
9478400080,20140512T000000,750000,4,2.5,2980,4930,2890,90
3450300020,20150318T000000,329000,4,2,1850,9126,1850,0
2663000050,20140926T000000,525000,4,1,1570,4000,1570,0
3145600250,20150317T000000,190000,2,1,670,3101,670,0
6206100130,20140626T000000,772650,4,2.5,2660,10800,2660,0
8944320420,20140710T000000,355000,3,2.5,2110,4038,2110,0
224069145,20150401T000000,650000,3,1.75,1970,54450,1570,400
3363900280,20150311T000000,678500,3,2.75,1210,3600,1210,0
7504110050,20140626T000000,669950,4,2.5,2670,11877,2670,0
624100950,20150311T000000,850000,3,2.25,3000,18450,3000,0
9416400020,20140827T000000,572000,3,2.75,2200,3885,2200,0
3578400950,20140801T000000,492450,3,1.75,1540,13002,1200,340
4100000050,20141030T000000,813000,3,1.75,2080,11866,2080,0
3475000080,20140828T000000,710000,3,2,1780,9732,1780,0
7871500345,20141202T000000,792500,3,1.5,1960,2400,1330,630
8857600680,20150313T000000,285900,5,1.5,1690,7725,1690,0
2817100430,20150511T000000,389000,3,2,2080,12972,1250,830
7649400170,20141205T000000,675000,3,2.25,2070,2833,1490,580
4048400185,20141022T000000,352000,2,0.75,760,33801,760,0
3303960250,20150507T000000,1.05E+06,4,3.25,4020,11588,4020,0
2785000480,20150108T000000,768500,4,1.75,3620,10400,1820,1800
2926049400,20141226T000000,500000,4,2,2330,7778,1230,1100
5452302195,20141230T000000,685000,3,2.5,1460,8800,1460,0
3528900980,20140523T000000,648475,4,2.75,2250,5700,1200,1050
3886901795,20150422T000000,655000,6,5,2850,6600,2850,0
1868900675,20140912T000000,895000,4,2.75,2640,4000,1730,910
4031000290,20150408T000000,195000,3,1,1310,9554,960,350
9264960480,20141208T000000,368000,4,2.5,2720,7350,2720,0
3303980680,20150228T000000,997000,4,3.5,3430,13609,3430,0
1775930010,20141222T000000,335000,3,2.75,1990,19991,1340,650
3329520170,20140521T000000,250000,3,2,1170,7258,1170,0
9321010130,20150312T000000,278500,3,1.75,1390,8980,1390,0
7696600020,20150128T000000,260000,4,1.5,1540,7300,1540,0
2690600005,20141001T000000,162500,2,1,760,6141,760,0
923049323,20140714T000000,239000,4,1,1280,8316,1280,0
6705870080,20141121T000000,600000,4,2.5,2990,5122,2990,0
3797710010,20150428T000000,350000,4,2.25,1770,7778,1770,0
98030630,20141215T000000,852500,5,3.75,3830,8131,3830,0
8106300840,20140721T000000,485000,3,2.5,2870,5490,2870,0
1074100020,20141007T000000,299000,3,1,1520,8320,1520,0
418000010,20150422T000000,227450,2,1,660,6509,660,0
1782000130,20140523T000000,383000,3,1,1800,5612,1200,600
2124079093,20150112T000000,835000,2,3.25,3570,392475,2370,1200
9828702890,20150211T000000,760000,5,1.5,3050,2992,1920,1130
3797001815,20150217T000000,532500,2,1,820,3000,820,0
6979900080,20141125T000000,635000,3,2.5,3610,26359,1950,1660
7319900345,20140825T000000,438500,3,2,1490,3072,770,720
4346300010,20140618T000000,545500,3,2.5,1560,9361,1360,200
2432000130,20150414T000000,675000,3,1.75,1660,9549,1660,0
9165100130,20140618T000000,450000,3,1.75,1180,4080,760,420
844000425,20141223T000000,199999,3,1,960,10815,960,0
6076500364,20140910T000000,375000,3,1.5,1630,16170,1630,0
9238430430,20150430T000000,600000,4,2.25,2260,43847,2260,0
2854800095,20140708T000000,292600,3,1.5,1520,7123,1520,0
31200020,20150319T000000,1.04E+06,5,2.75,3050,8904,1650,1400
5364200381,20141010T000000,610000,3,1,1000,4959,1000,0
1515910290,20140825T000000,397450,4,2.5,2650,9451,2650,0
3459000020,20150414T000000,382000,3,2.25,1750,15528,1270,480
3303000130,20150116T000000,370000,3,2.25,1770,7667,1270,500
3303000130,20150428T000000,520000,3,2.25,1770,7667,1270,500
3235100080,20140701T000000,260000,2,1,770,7906,770,0
7284900460,20141120T000000,890000,4,2.5,3370,7200,3370,0
6332940020,20140826T000000,344000,5,2,2130,8412,1440,690
8802400415,20140625T000000,205000,3,1,1050,8498,1050,0
4131500190,20150507T000000,379000,5,2.5,2803,8550,2803,0
7524400250,20140822T000000,424240,3,2,2080,12094,2080,0
7524400250,20141124T000000,589950,3,2,2080,12094,2080,0
4441300440,20140512T000000,582000,4,1.75,2120,4650,1190,930
1898200080,20150312T000000,349000,3,2.5,2550,7709,2550,0
1245003375,20150408T000000,658000,3,1,1290,12005,1290,0
3574300250,20141029T000000,294000,5,2.75,1790,5000,1060,730
5071400104,20140626T000000,690000,5,3.5,2720,7598,1860,860
9287801150,20150423T000000,600000,3,1,1040,5000,1040,0
8651431100,20150116T000000,199990,3,1,840,5200,840,0
236500010,20141209T000000,220000,3,1.75,1650,8850,1650,0
1441800250,20150126T000000,440000,4,2.25,2080,15750,1460,620
8929000050,20140904T000000,439990,4,2.5,1540,1994,1540,0
98030660,20150311T000000,815000,4,2.5,3880,7208,3880,0
3905100380,20150421T000000,535000,4,2.25,1860,3766,1860,0
1140000050,20141126T000000,215000,3,1.75,1280,10016,1280,0
5561000010,20150223T000000,605000,3,2.5,3200,35012,2100,1100
8856920250,20140530T000000,349900,3,2.5,2200,7278,2200,0
5100402668,20150218T000000,495000,3,1,1570,5510,1070,500
2426049180,20141014T000000,515100,3,2.5,2074,4900,2074,0
205000010,20140624T000000,620000,4,2.5,2450,55387,2450,0
7504060020,20150122T000000,657500,4,2.25,2520,10370,2520,0
4204400098,20150119T000000,250000,5,1.75,2190,8250,1190,1000
4204400098,20150421T000000,385000,5,1.75,2190,8250,1190,1000
2131200766,20140522T000000,307000,3,1.5,2320,7500,2320,0
7760400480,20150513T000000,288000,3,2.5,1370,9253,1090,280
1863900225,20141028T000000,226450,3,1.75,1730,7200,1730,0
1787600224,20150310T000000,390000,3,2.5,1640,6991,1110,530
323089134,20140930T000000,350000,3,1,1300,10236,1300,0
7663700759,20141201T000000,368000,3,1.5,1560,7884,1060,500
3856904970,20140818T000000,469000,2,1,1120,4284,730,390
1126059007,20150323T000000,865000,3,2.25,2670,150270,2670,0
2473002850,20150113T000000,515000,5,2.5,3810,15916,3810,0
1112700130,20150123T000000,410000,3,1.75,1440,8560,1440,0
121059007,20140808T000000,210000,4,1,1200,43560,1200,0
2896600020,20150325T000000,460000,3,1.75,1520,7700,820,700
9264900660,20140919T000000,241500,4,2.5,2500,9654,1830,670
7754900280,20140623T000000,322200,4,2.25,2010,19000,2010,0
9282801950,20140818T000000,279000,4,1,1210,6000,1210,0
3123039063,20140908T000000,303000,2,1,1100,27007,1100,0
2770606915,20141020T000000,420000,3,1.5,1050,6615,800,250
5379804690,20140813T000000,249000,3,1.75,2120,18335,1380,740
6855700080,20140714T000000,294950,3,1,1240,8840,1240,0
3856900507,20140512T000000,1.32E+06,4,3.5,3460,3997,2560,900
3501600185,20140915T000000,335000,3,1.75,1270,4800,1270,0
1068000235,20140605T000000,1.16E+06,4,2.25,2980,8051,2020,960
7519000585,20150311T000000,520000,2,1,1250,3708,1250,0
1562200380,20140916T000000,560000,4,1.75,1740,8800,1740,0
7523700305,20141012T000000,243400,4,1.5,1730,7464,1730,0
8807810050,20140529T000000,405000,3,2,1240,14404,1240,0
3699100130,20141002T000000,495000,2,1,1670,14695,1670,0
2215901650,20150402T000000,350000,4,2.5,2140,7095,2140,0
1099900020,20141211T000000,368500,5,2.75,2530,7601,1520,1010
5128000010,20150105T000000,99000,2,1,960,8236,960,0
3303980660,20140603T000000,1.07E+06,4,3.75,4130,12320,4130,0
1155640050,20140826T000000,430000,4,1.75,1710,7724,1710,0
8087800020,20140515T000000,412500,3,1.5,1490,8475,1490,0
3293200190,20141213T000000,1.12E+06,4,3.25,4750,62365,4750,0
1862000010,20140828T000000,915000,4,2.5,3400,35062,3400,0
5711200170,20140523T000000,535000,3,2.5,2210,7620,2210,0
8690800130,20141104T000000,390000,3,1.5,1650,8676,1130,520
2768100545,20140908T000000,499000,3,1.5,1260,3135,780,480
2596400050,20140730T000000,375000,3,1,1960,7955,1260,700
2641400290,20141028T000000,349000,4,2.5,1800,7620,1800,0
3210600010,20141031T000000,635000,3,2.25,1940,7482,1240,700
8691370290,20141215T000000,682000,4,2.75,2820,8009,2820,0
1790000080,20150203T000000,321027,4,2.25,2820,16770,1920,900
7116000425,20141125T000000,150000,2,1,720,4120,720,0
8143100500,20141213T000000,410000,3,1.75,1640,17583,1110,530
3735900545,20140523T000000,449950,3,2,1560,4080,1560,0
1443500305,20141013T000000,194990,6,2.5,1560,7144,1060,500
3649100103,20150102T000000,475000,4,1.75,1910,8775,1210,700
6746700605,20150128T000000,530000,5,1.75,1570,3000,1570,0
7999950020,20140722T000000,319950,4,2.5,2038,7643,2038,0
9211500010,20150327T000000,210000,3,2.25,1720,9435,1220,500
1324300290,20141226T000000,485000,3,2.75,1670,3330,1670,0
8691310380,20150128T000000,774000,4,2.75,2830,10240,2830,0
4037400430,20141015T000000,478000,4,2,1690,8208,1210,480
254000545,20141023T000000,385000,4,2.5,1620,5280,1620,0
7214780020,20150417T000000,595000,4,2.5,2360,43017,2360,0
114100314,20150318T000000,285000,3,1.5,1480,7117,1170,310
3629930170,20140514T000000,723000,4,2.5,2700,4004,2700,0
2946002140,20140812T000000,279000,3,1.5,1780,16000,1240,540
1432400525,20150306T000000,195000,3,1.5,1430,7560,1430,0
7011201470,20141015T000000,625000,2,1,2160,2192,1170,990
7697800170,20150428T000000,270000,3,1.75,1800,9314,1800,0
8682291630,20141007T000000,559000,2,2,1930,5520,1930,0
1775800420,20150202T000000,474000,4,2.25,1960,14834,1330,630
2215901310,20141114T000000,303500,4,2.5,1920,7345,1920,0
1440500020,20141226T000000,350000,3,1.75,1470,8645,1470,0
6632900574,20140806T000000,367500,5,3,2980,10064,1680,1300
6632900574,20150225T000000,595000,5,3,2980,10064,1680,1300
7933510080,20141006T000000,589000,3,2,2360,118483,2360,0
1926069063,20150306T000000,585000,3,1.75,1790,87213,1790,0
973600020,20141002T000000,482975,3,2.25,2130,8801,1370,760
9558010190,20141119T000000,365500,4,2.5,2030,4499,2030,0
267010020,20140711T000000,570000,4,2,1790,7800,1790,0
8097000170,20150202T000000,335000,3,2.5,2260,8040,2260,0
9136100420,20150408T000000,767500,4,2,2350,4815,1450,900
8929000280,20140519T000000,386591,3,2.5,1690,1613,1150,540
7883603190,20140722T000000,279000,3,1,1320,5750,1320,0
203600470,20150409T000000,620000,4,2.5,2690,32780,2690,0
8643200020,20140506T000000,407000,4,2.25,2810,23400,1710,1100
322069153,20140827T000000,364250,3,2.5,2280,213879,2280,0
2473450430,20140527T000000,399000,4,2.5,2870,9292,2540,330
7574910780,20140514T000000,766950,3,2.5,3030,30007,3030,0
3629980780,20140918T000000,710000,4,2.75,2940,4232,2940,0
3332000091,20150224T000000,320000,3,1,1190,4120,1190,0
3395041236,20141023T000000,300000,3,2.5,1800,3253,1800,0
2310030500,20140710T000000,263000,3,1.75,1580,9187,1180,400
8665050080,20141010T000000,445000,3,2.5,1730,4408,1730,0
4037000840,20150406T000000,554000,3,2,1910,9001,1910,0
2856101845,20140724T000000,335000,2,1.75,1000,5100,940,60
8078550250,20141229T000000,307000,4,2.75,2520,6964,1260,1260
1837000010,20150302T000000,404000,3,1,1420,8160,970,450
8691390280,20140731T000000,775000,4,3.5,3080,5250,3080,0
2372800050,20140521T000000,220000,3,1,1060,9126,1060,0
6600250050,20140903T000000,518000,4,2.5,2160,9750,2160,0
7215900020,20141209T000000,1.60E+06,4,3.5,4060,9486,4060,0
6450304600,20141023T000000,315000,1,2.25,1940,2550,1100,840
2541100050,20140731T000000,572650,4,2.5,2250,11349,2250,0
1853200080,20140619T000000,350000,2,1,1620,9205,850,770
3058600050,20140919T000000,285000,2,1,920,5850,920,0
3148750050,20150325T000000,231000,3,2.5,1370,7247,1370,0
8651400680,20140813T000000,179000,3,1,920,5200,920,0
4359100050,20150330T000000,244000,3,1.5,1360,9625,1360,0
5379806185,20150306T000000,185850,3,1.5,1630,11662,1630,0
1737300130,20141222T000000,610000,6,2.5,3610,12033,3210,400
2781200010,20141010T000000,419000,4,2.5,3010,9155,3010,0
269000221,20140826T000000,779000,3,1.75,2320,6400,1420,900
6421100502,20140915T000000,695000,5,3,3290,14134,1870,1420
4136900190,20150320T000000,319900,3,2.5,2040,7580,2040,0
8731980680,20150112T000000,329000,3,2.75,1920,7700,1320,600
2095800250,20140827T000000,475226,3,2.5,2120,4512,2120,0
3629920630,20150325T000000,638000,3,2.5,2170,5000,2170,0
6817800840,20150325T000000,440000,2,1.5,1330,15873,900,430
7520000440,20150209T000000,214000,3,2,1580,5080,800,780
587550470,20150429T000000,600000,3,2.75,3580,14217,2210,1370
6851700381,20150414T000000,935000,4,2,2580,4500,1850,730
4077800029,20141027T000000,630000,4,1.75,1930,10210,1670,260
7202350480,20140930T000000,575000,3,2.5,2120,4780,2120,0
1021079099,20141106T000000,345000,3,2.5,1990,20466,1410,580
6075000050,20140716T000000,323000,4,1.75,1310,9690,1310,0
5467910020,20140516T000000,425000,3,2.5,2670,13218,2670,0
322069109,20150505T000000,411000,2,2.25,1910,108900,1010,900
8658300480,20140721T000000,299800,4,1.5,1530,9000,1530,0
9187200285,20140505T000000,823000,6,1.75,2920,5000,2780,140
3670500605,20140908T000000,200000,3,1,1010,8108,1010,0
2141330050,20140520T000000,760000,4,1.75,2450,13300,1630,820
3820350020,20150428T000000,359950,4,2.5,1820,3899,1820,0
3291800780,20150203T000000,375000,4,2.5,2090,8325,1470,620
2423069120,20140508T000000,295000,2,1.75,2200,89298,1100,1100
6918100170,20150319T000000,250000,4,3,2250,7882,1570,680
7169200221,20141023T000000,497000,3,2.25,1450,1387,1450,0
3579000440,20140813T000000,520000,4,2.5,2280,8798,2280,0
8860500130,20140717T000000,365000,4,3.5,2720,6781,2100,620
1441800010,20141208T000000,459900,3,2.25,2250,8000,1460,790
7129300595,20150506T000000,158000,3,2,1090,6090,940,150
4322300010,20140606T000000,294700,3,2,1970,9600,1300,670
7229800066,20140819T000000,439950,4,2.25,2780,15075,2780,0
3625059071,20150108T000000,899000,4,2.25,2290,40946,1550,740
9517200480,20140702T000000,535000,3,1.75,2330,12141,1390,940
240000269,20150124T000000,530000,4,4.5,4060,10800,4060,0
9835800840,20150204T000000,215000,4,2,1470,7000,1470,0
8058500005,20150203T000000,290000,2,1,1620,5400,920,700
2568200170,20150311T000000,798000,5,2.75,3220,5934,3220,0
9545250010,20141107T000000,785000,4,2.5,3270,9578,3270,0
4140090420,20150318T000000,433000,3,1.75,2160,8565,1730,430
3334000050,20140721T000000,425000,2,1,1150,6835,1010,140
5101404144,20140724T000000,654000,4,2.5,2240,7540,1540,700
7338001190,20141017T000000,215000,3,1.5,1280,5065,1280,0
1865810290,20150318T000000,232000,3,1,840,6540,840,0
2785000290,20140507T000000,675000,3,1.75,1680,10500,1680,0
7955040080,20141104T000000,665000,5,2.75,2330,8000,1550,780
5480900010,20140623T000000,835000,4,2.5,3030,29163,3030,0
6362900080,20140814T000000,525000,6,3,2880,7560,2880,0
4078300050,20150504T000000,780000,3,2.75,2910,3094,2010,900
3528000545,20140815T000000,844000,4,3.25,3090,67518,3090,0
710300010,20150127T000000,680000,4,2.75,2720,54048,2720,0
3764800630,20140825T000000,290000,3,1.5,1310,8100,1310,0
6383000825,20150325T000000,560000,2,1,1790,15783,1360,430
9465900500,20140617T000000,605500,3,2.5,2830,6536,2830,0
2568200290,20140826T000000,762500,4,2.5,3150,5979,3150,0
3885808005,20150305T000000,1.74E+06,5,3.25,3930,5500,2910,1020
3723800086,20140624T000000,665000,6,2.75,2840,8346,1420,1420
6840701150,20150311T000000,540000,5,1,2480,4400,1640,840
7301300050,20141119T000000,375000,3,2.5,1930,6180,1330,600
6381500635,20140516T000000,342000,3,1,1260,6826,720,540
3980300020,20150310T000000,340000,3,1,670,23522,670,0
1923000050,20150330T000000,1.25E+06,5,3.25,3930,12719,2540,1390
7215720250,20141210T000000,693000,4,2.5,3160,13063,3160,0
3123049230,20150420T000000,638500,4,1.75,1770,12462,1770,0
8163000020,20150126T000000,805000,5,3,2240,18265,2240,0
7893808220,20140709T000000,250000,3,1,990,8062,990,0
538000440,20150501T000000,325000,3,2.5,1580,4698,1580,0
7883603390,20150401T000000,270000,4,1.75,1560,4290,1560,0
7645900235,20140710T000000,880000,6,2.5,2640,3680,1760,880
9232900050,20140806T000000,300000,2,1.75,2120,6350,1440,680
7305300500,20141215T000000,290000,2,1,1200,8750,1200,0
6065300840,20150501T000000,2.85E+06,4,4,5040,17208,2870,2170
7227500020,20150123T000000,259950,3,1,1460,5825,1260,200
7237501190,20141010T000000,1.78E+06,4,3.25,4890,13402,4890,0
422000010,20141106T000000,299950,3,1,1580,5250,1580,0
826069127,20150406T000000,483000,3,2.25,2100,43560,1330,770
9413600420,20140612T000000,890000,3,2.25,2060,8640,2060,0
9151600541,20140508T000000,719000,3,2.5,1690,4500,1690,0
3423059153,20141008T000000,785000,4,3,3370,100681,1920,1450
3630120190,20150326T000000,660000,3,2.5,2330,3995,2330,0
2787320430,20140618T000000,264000,4,1.75,1820,8118,1080,740
1672000170,20140908T000000,575000,3,1.75,1890,11141,1890,0
2050000020,20140624T000000,1.22E+06,4,3.75,3820,53574,3820,0
3221079069,20140815T000000,475000,3,2.5,2770,98881,2770,0
7501000080,20141121T000000,845800,4,3.5,3020,12750,3020,0
3500100078,20140611T000000,352500,3,1.75,1170,8182,1170,0
9493200010,20140623T000000,347000,3,1,1270,8400,1270,0
3905081350,20150109T000000,560000,4,2.75,1950,6192,1950,0
6061000010,20150504T000000,323000,4,2.75,2230,50094,1330,900
7635801350,20150306T000000,595000,3,1.75,2220,22081,2220,0
7806210380,20150220T000000,257500,4,2,2060,6400,1170,890
7577700440,20140528T000000,450000,3,1,1100,4600,1100,0
3876810190,20141113T000000,410000,4,1,1140,7208,900,240
1224059049,20140613T000000,810000,3,1.75,1980,13503,1320,660
3348401319,20140512T000000,372500,5,3,2480,10090,1300,1180
5589300585,20141203T000000,325000,3,1,1050,9083,1050,0
3293700221,20141021T000000,280000,3,1,1260,7660,1260,0
2013300050,20140711T000000,258000,3,2,1680,19978,880,800
408100050,20140827T000000,329950,4,1,1360,5900,1360,0
4178300080,20141212T000000,836000,4,2.5,2450,12987,2030,420
2310040020,20150409T000000,365000,5,2.5,2260,7040,2260,0
8698100170,20150211T000000,111300,2,1,1060,6000,1060,0
1330910280,20150427T000000,864000,4,2.5,3720,105850,3720,0
9413600670,20140623T000000,725000,3,1.75,1610,8613,1610,0
3825500020,20150218T000000,550000,4,2.5,3350,6605,2670,680
2500600289,20150416T000000,130000,2,1,790,7500,790,0
4385701440,20140926T000000,765000,2,1.75,1660,4000,990,670
8645501330,20150421T000000,255000,3,1.5,1420,7480,1420,0
2323069073,20140622T000000,439500,3,2.5,2050,40003,1570,480
2475200080,20140908T000000,268000,3,1.75,1250,5546,1250,0
9533600185,20150401T000000,985000,3,1.75,1700,8534,1700,0
4139440460,20141118T000000,751305,4,2.5,2660,8469,2660,0
1443500725,20150423T000000,280000,3,1,1350,7553,1350,0
984000780,20140616T000000,304000,4,2,1810,8750,1110,700
7575610170,20150423T000000,200000,4,2.75,2210,13235,1730,480
2025800080,20150220T000000,325000,3,1.5,2120,41325,1420,700
1425059180,20150324T000000,736000,3,2.25,2470,11603,1540,930
1310440280,20140710T000000,426500,4,2.5,2700,6515,2700,0
2264500425,20140620T000000,640000,2,1.75,1760,4400,880,880
1721800470,20140521T000000,230000,5,2,1930,6120,1930,0
2589300170,20150324T000000,366350,4,1,1680,5043,1680,0
2338800161,20150106T000000,365000,2,1,1390,8336,910,480
855700170,20150225T000000,482000,4,2.25,2240,8322,2240,0
1431700250,20140516T000000,345000,4,1,1980,7991,1980,0
7942601410,20140514T000000,682000,3,1.75,1830,5120,1830,0
4151800420,20140815T000000,657500,3,1.75,980,6002,980,0
5700003280,20150419T000000,895000,6,2.5,3550,6533,3550,0
1105000780,20150403T000000,425000,3,1.5,1660,5665,920,740
4046400440,20140806T000000,532500,4,2.5,2490,8750,2040,450
1089700010,20141008T000000,540000,4,2.5,2329,9436,2329,0
2600040130,20140711T000000,578000,3,2.25,1790,9580,1790,0
8121100715,20150209T000000,1.09E+06,3,3,2830,6041,1840,990
1771000440,20140904T000000,322500,3,1,1160,9750,1160,0
7875200005,20150115T000000,140000,3,1,1000,10560,1000,0
1822069109,20140910T000000,485000,3,2.5,2540,51836,1820,720
9283800050,20140819T000000,575000,2,1.5,1750,19709,1440,310
238000244,20140617T000000,421000,3,2.5,2890,21780,2890,0
7972600430,20150311T000000,355000,4,2,1870,3497,1200,670
6204200470,20150318T000000,515000,4,2.25,2200,6967,2200,0
123039420,20150428T000000,309000,3,1,1300,7200,1300,0
1525059215,20150224T000000,815000,5,2.25,3410,35536,2530,880
1787600094,20141106T000000,285000,3,1,1160,7875,1160,0
2877101100,20141110T000000,700000,3,1.75,2100,5000,2100,0
9406550050,20150330T000000,289000,3,2.5,1490,8628,1490,0
826069016,20141212T000000,458000,4,3,3280,62726,3280,0
8732030080,20140818T000000,230000,3,1.75,1450,8378,1450,0
2231000020,20140812T000000,432500,3,2.5,1930,7120,1420,510
9407000840,20140731T000000,288000,3,1.75,1660,10440,1040,620
1775800290,20140801T000000,354000,3,1.75,1260,12330,1260,0
3821200050,20140604T000000,119500,3,1,1170,11000,1170,0
3224510080,20141120T000000,805000,4,3,3350,23781,2020,1330
3626039415,20140611T000000,435000,3,2.5,1420,2581,1420,0
9262800294,20140922T000000,260000,3,1.75,2170,10018,1630,540
127100005,20150401T000000,377000,4,1.75,1800,8385,900,900
3905040170,20150320T000000,602000,4,2.5,2000,7376,2000,0
148000680,20141027T000000,530000,3,1.75,1660,4800,960,700
458000235,20150325T000000,525000,4,2,1540,3740,770,770
1445200050,20141110T000000,250000,2,1.5,1160,1086,890,270
7950300005,20140528T000000,681000,3,1,1700,6356,1700,0
2726049169,20140905T000000,625000,3,1.75,1580,20588,1580,0
8944550050,20150508T000000,448500,3,2.5,2080,3920,2080,0
623049341,20141022T000000,260000,3,2,1030,7260,1030,0
7922900380,20141030T000000,538000,3,1.75,1770,8050,1020,750
2248000080,20140521T000000,385500,3,2,1540,7947,1120,420
9406540050,20140905T000000,428400,4,2.5,2650,6000,2650,0
5416100190,20140729T000000,346290,4,2.75,2690,9240,2690,0
7215720680,20150203T000000,587000,4,2.75,2210,8430,2210,0
4307330280,20140820T000000,355000,4,2.5,2390,6775,2390,0
1562000050,20150428T000000,650000,5,2.75,2580,7865,1480,1100
4307320280,20140730T000000,340000,4,2.5,2160,5455,2160,0
569000050,20140703T000000,565000,4,2.5,2230,8624,1430,800
5700000595,20150219T000000,630000,4,2,2000,5000,2000,0
8029200190,20141107T000000,227000,3,1,1280,7198,1280,0
2896000680,20140729T000000,600000,4,2.75,2810,17674,1640,1170
9328500680,20150202T000000,540400,4,1.75,1680,6758,1680,0
3295730050,20141001T000000,569000,3,2.5,2150,8060,2150,0
3629970130,20140710T000000,735000,3,2.5,2820,8159,2820,0
3574801310,20141216T000000,434000,3,2.25,1750,9353,1210,540
4083802195,20150319T000000,578888,2,2,1060,4000,1000,60
9238500480,20140523T000000,465425,4,2.75,2430,20720,2430,0
9264910280,20150422T000000,280500,4,2.75,2660,7754,1590,1070
3630120380,20150205T000000,539950,2,2,1670,3507,1670,0
424069088,20140904T000000,406430,3,2,1380,15426,1380,0
2954400020,20150205T000000,1.15E+06,4,3.75,4160,35000,4160,0
2154550020,20141111T000000,250000,3,2.5,1790,6191,1790,0
5420800010,20140508T000000,266000,3,2.5,1940,8547,1460,480
2459950010,20140722T000000,258000,3,2,1390,7200,1390,0
4019301300,20141223T000000,472000,3,2,2200,21890,1200,1000
3179100480,20140806T000000,530000,3,2.25,1264,1536,1264,0
7942601155,20140722T000000,302282,2,1,1095,5120,1095,0
2493200235,20150311T000000,370000,2,1,850,6213,750,100
6338000014,20141013T000000,625000,4,2,1760,5307,1170,590
1735800050,20150409T000000,142500,1,1,690,6825,690,0
2783100050,20150121T000000,334000,3,1.75,1400,7405,1400,0
1604600095,20140708T000000,362000,5,3,1810,3000,1810,0
3080000005,20150417T000000,181000,2,1,1310,4000,950,360
2268000470,20141231T000000,241500,3,1,1400,10425,1400,0
807800190,20150204T000000,245000,3,1.75,2350,12720,1180,1170
1274500170,20150506T000000,227500,3,1,1150,8848,1150,0
8857600780,20141003T000000,158550,5,1.5,1710,8100,1710,0
5145000130,20140925T000000,450000,3,2.25,1660,10247,1130,530
3288200470,20150204T000000,485000,3,1.75,1950,10080,1950,0
1771000950,20141106T000000,353000,4,1.75,1780,9794,1780,0
3818400050,20150406T000000,500000,4,3,2450,4668,2450,0
537000130,20140908T000000,360000,1,2.25,2060,10600,1560,500
5127000420,20150223T000000,357500,3,1.5,1540,11858,1540,0
8656300380,20140506T000000,272000,3,2.5,1650,13816,1650,0
6632300161,20150428T000000,422000,3,1,1160,7854,1160,0
622100130,20140917T000000,365000,2,2,1440,15000,1440,0
4028900048,20140821T000000,450000,3,1.75,2150,13789,1610,540
411100005,20140922T000000,275053,2,1,1060,6504,1060,0
6447300225,20141106T000000,1.88E+06,3,2.75,2620,17919,2620,0
5739600427,20150311T000000,725000,3,1.75,1630,9000,960,670
5412310080,20140612T000000,235000,3,1.75,1840,9697,1500,340
2726049071,20141211T000000,510000,2,1,820,4206,820,0
2726049071,20150408T000000,489950,2,1,820,4206,820,0
3764650050,20140730T000000,463000,3,2.5,2010,4195,2010,0
3905030480,20140617T000000,536000,4,2.25,1990,5948,1990,0
2345700500,20141021T000000,375000,4,2.5,2990,6145,2990,0
8650300130,20140908T000000,630000,4,2.5,2540,4727,2540,0
2923049372,20140506T000000,362000,3,2.25,1640,14374,1140,500
5437200080,20150204T000000,350000,4,2.75,2500,11659,1490,1010
9808100185,20141003T000000,1.69E+06,4,3.5,4020,13515,4020,0
4337000285,20150224T000000,255000,3,2,1500,8775,1390,110
2891000010,20140806T000000,269000,4,2.5,1594,7665,1088,506
7224000545,20140825T000000,370000,4,3,2130,4838,2130,0
3243100080,20150501T000000,270000,3,1,1130,7920,1130,0
3925000020,20150224T000000,265000,3,2,1690,9516,1690,0
546000020,20150429T000000,487000,2,1,1440,4046,960,480
8651611060,20140804T000000,835000,4,3.25,3270,6027,3270,0
3024079063,20140701T000000,850000,4,3.25,4350,112750,2200,2150
3039000050,20141201T000000,575000,4,2.75,1610,11201,1020,590
1839900080,20140712T000000,335000,3,1,950,8000,950,0
4024101434,20140808T000000,318000,3,1,1010,7200,1010,0
2824069142,20150409T000000,510000,3,2,1420,11325,1420,0
2618300080,20140502T000000,242500,3,1.5,1200,9720,1200,0
7785000010,20141204T000000,750000,5,2.25,2020,8400,1010,1010
4307330050,20140721T000000,439900,5,3.5,3390,7950,3390,0
2867100005,20150407T000000,710000,2,1,1700,3040,1460,240
3880900010,20140604T000000,2.40E+06,5,3.25,3410,9088,2760,650
5255710010,20141215T000000,435000,3,1.75,2030,13700,1630,400
3213200314,20141226T000000,874000,4,2.75,2860,6867,1560,1300
9834200950,20140616T000000,385000,4,1.75,1690,4080,870,820
3806000005,20141030T000000,110000,2,1,760,4746,760,0
6204400170,20140620T000000,477000,3,1.75,1780,8085,1210,570
2491200675,20140912T000000,500000,3,2,1550,6394,1550,0
98020480,20140828T000000,885000,4,2.5,4090,11225,4090,0
8068000585,20140827T000000,235000,2,1,880,5600,880,0
4345000170,20150504T000000,210000,3,2.75,1320,15236,880,440
3101500010,20150420T000000,320000,2,1,950,4000,950,0
3291800660,20150313T000000,406000,3,1.75,1390,7904,1390,0
3541600235,20141028T000000,350000,3,1.75,1900,10225,1220,680
2923039217,20140610T000000,350000,2,0.75,1392,43710,1392,0
7852010290,20140710T000000,720000,4,2.5,3340,8930,3340,0
7695450010,20140522T000000,604700,4,2.75,2750,14982,1720,1030
3424069145,20140925T000000,343000,3,1,1400,5662,1400,0
3578400500,20141209T000000,558000,3,2.25,2220,15757,1280,940
4365200895,20150417T000000,364000,4,1,1210,7740,1210,0
4027700321,20141028T000000,420000,3,1.75,2390,11242,1290,1100
7923600250,20150515T000000,450000,5,2,1870,7344,1870,0
8122100290,20140813T000000,392000,2,1.5,940,5000,810,130
7224000980,20140610T000000,100000,4,1,1120,2685,860,260
9521100280,20140612T000000,480000,3,2.5,1250,1103,1250,0
7875400050,20140827T000000,212000,3,1.5,1060,9225,1060,0
6204420290,20141203T000000,560000,5,2.5,2410,8960,1600,810
1041440050,20150428T000000,359950,5,2.75,2844,3990,2844,0
1626069178,20140910T000000,535000,4,2.5,2200,110642,1330,870
3342101937,20150410T000000,980000,5,4,3460,5400,2830,630
9178601630,20141113T000000,720000,2,1,1580,2199,1580,0
5273200080,20140929T000000,619950,2,1,1520,5400,920,600
7701930010,20140530T000000,489000,3,2.5,2260,19821,2260,0
6820100010,20140616T000000,415000,4,2,1800,2970,1000,800
3066400130,20150415T000000,672500,4,2.5,2650,11108,2650,0
339600010,20141017T000000,352500,3,1,1000,4171,1000,0
3391900130,20140903T000000,258750,4,2,2300,8400,1150,1150
7283900010,20150223T000000,350000,3,1,1080,7000,1080,0
1113000430,20140729T000000,152000,3,1,902,10464,902,0
5101405276,20140609T000000,378500,2,1,730,7528,730,0
7796100050,20140730T000000,1.02E+06,4,1.75,2600,41041,2600,0
2207200675,20140502T000000,419000,3,1.5,1570,6700,1570,0
3622910190,20140521T000000,895000,5,3,2876,13927,1970,906
9346930250,20140926T000000,668500,4,2.25,2290,9546,1780,510
3886000010,20140821T000000,487000,2,2.5,1470,2533,1470,0
6326000130,20141202T000000,538000,3,3.5,2620,10137,1970,650
686900010,20140528T000000,898000,5,1.5,2680,28014,1450,1230
1310000130,20140924T000000,315000,4,2,2020,7767,2020,0
139000185,20150428T000000,800000,3,2.5,2100,4440,2100,0
4039000050,20140714T000000,516130,3,1.75,1510,8250,1510,0
9253900417,20150128T000000,1.60E+06,3,2.5,2850,19593,1790,1060
4128500380,20150427T000000,1.20E+06,4,2.5,4280,12796,3400,880
8159300050,20150312T000000,355425,4,2.5,3238,9112,1678,1560
1338600185,20140624T000000,1.16E+06,3,2.5,2740,5925,2740,0
7625703900,20140926T000000,689000,4,2.5,2020,9600,2020,0
2767700022,20150113T000000,500000,3,3.25,1520,1500,1520,0
3914000095,20140718T000000,430000,5,2.5,3860,42733,2300,1560
7334501410,20141121T000000,299500,4,2.25,1600,15312,1080,520
2597710050,20140624T000000,349950,4,2.5,2090,5289,2090,0
7933250050,20141028T000000,1.42E+06,5,3.25,4020,4500,3120,900
2600140500,20141216T000000,998000,4,2.25,2910,10189,2910,0
3876810170,20150505T000000,329000,3,1,900,9600,900,0
3740000010,20141009T000000,575000,3,1.75,1720,5956,1720,0
6895300050,20141002T000000,529900,5,2.25,3030,9430,2600,430
6645900010,20141120T000000,1.47E+06,4,2.5,3030,10189,2380,650
9413600380,20140801T000000,725000,4,1.75,2190,9400,1450,740
2115720500,20141023T000000,286000,3,2.5,1680,5000,1680,0
2202500255,20150305T000000,335000,3,2,1210,9926,1210,0
2207100255,20140515T000000,395300,3,1.5,1120,7000,1120,0
8035350010,20140715T000000,510000,4,2.75,3180,13348,3020,160
1555300010,20150206T000000,203000,3,1,920,7500,920,0
6135300010,20141204T000000,248000,2,1,700,8301,700,0
1321730470,20150127T000000,265000,3,2.25,2540,7216,2540,0
4083306345,20150504T000000,1.00E+06,4,1.5,2100,4560,2100,0
1453602360,20150406T000000,1.00E+06,3,1,1540,24500,1540,0
2025600280,20150406T000000,241400,3,2,1420,9828,1420,0
1423800380,20150312T000000,309950,4,1.75,1450,10074,1450,0
2113701100,20140826T000000,294010,3,1.75,1550,4057,830,720
3578401060,20141216T000000,345000,3,2.25,1920,9672,1920,0
3578401060,20150504T000000,625000,3,2.25,1920,9672,1920,0
7691800020,20140709T000000,660000,4,2.5,2510,4543,2510,0
8682230950,20150317T000000,559000,2,2,1660,4500,1660,0
7202360010,20140707T000000,866000,4,3.25,3990,9786,3990,0
2125049120,20140505T000000,770000,3,2,2350,5700,1810,540
5540000010,20140815T000000,259950,3,1.5,1350,7827,1350,0
1552800010,20150311T000000,352000,5,2.75,2980,9838,1710,1270
1118002000,20140624T000000,2.47E+06,5,4.75,6390,13180,4560,1830
8564600080,20141106T000000,395000,3,2,1590,10229,1590,0
1446800660,20150316T000000,276500,4,1.75,1400,6650,1400,0
2624079022,20141020T000000,530000,3,2.25,1880,100623,1880,0
5051800130,20140724T000000,798000,4,3.25,3500,10260,3500,0
7940700190,20140813T000000,380000,2,2,1370,5756,1370,0
5422810010,20140819T000000,350000,4,2.5,2810,10433,2810,0
3529200190,20140514T000000,325000,3,2.5,2220,6049,2220,0
8944320280,20150402T000000,336000,3,2.5,2110,4549,2110,0
3222069153,20141024T000000,286900,3,2.25,1720,17235,1440,280
7211300050,20140930T000000,472000,5,2.25,1780,7245,1330,450
1545806980,20140630T000000,263000,3,1.75,1410,8100,1410,0
9297300255,20140716T000000,565000,3,3,2110,4000,1110,1000
4139400280,20141008T000000,765000,3,2.5,2700,8444,2700,0
9201300020,20140811T000000,1.52E+06,3,2.25,2610,9409,2610,0
8663280080,20141223T000000,405000,3,2,1660,8174,830,830
98000980,20150427T000000,1.10E+06,4,3.5,4570,16219,4570,0
1796100010,20140911T000000,555000,3,3,3760,188760,2640,1120
2781280290,20150427T000000,305000,3,2.5,1610,3516,1610,0
1448800010,20140901T000000,289950,3,2.25,1740,9370,1390,350
1526079026,20140813T000000,487500,5,3.5,3530,218472,2380,1150
1788800630,20141029T000000,96500,3,1,840,12091,840,0
1788800630,20150225T000000,185000,3,1,840,12091,840,0
8864000250,20140827T000000,150550,4,1,1470,6061,1470,0
7972600670,20140624T000000,339000,4,2,2470,5080,1970,500
4077800094,20150202T000000,675000,4,1.75,2220,7230,1280,940
9834200440,20140624T000000,615000,3,1.75,1720,4080,960,760
1245002125,20140604T000000,837500,4,2.5,2700,9320,2700,0
5634500170,20140819T000000,250000,2,1,950,11835,950,0
1954400500,20140625T000000,583000,3,2.5,1790,8144,1790,0
9528102771,20140904T000000,499000,3,2.5,1610,1728,1610,0
2895600095,20140716T000000,550000,3,2.5,2290,6328,2290,0
2921079027,20140924T000000,400000,4,2.5,2170,204296,2170,0
524059323,20150219T000000,990400,3,2.5,2100,4097,2100,0
824069173,20140821T000000,600000,3,2.5,2320,52272,2320,0
2678100005,20150212T000000,325000,2,1,1120,6236,1120,0
2025700080,20140710T000000,265000,3,2.5,1530,6000,1530,0
6613000585,20150108T000000,1.62E+06,3,2.5,3490,9362,1770,1720
2597000006,20150309T000000,347500,3,1.5,1180,8353,1180,0
1923300170,20150109T000000,629000,5,2,2050,3000,1470,580
1224049005,20140708T000000,1.09E+06,2,2,2360,11340,2360,0
4123840050,20140630T000000,397500,4,2.5,2570,7859,2570,0
1937300280,20141030T000000,404500,2,1,1270,3700,1270,0
9183703376,20140513T000000,225000,3,1.5,1250,7500,1250,0
9542801310,20150513T000000,267000,3,2.25,2510,9900,1610,900
2771104830,20140611T000000,800000,4,3.75,2690,4000,2120,570
7967650010,20150210T000000,339000,4,2.5,2900,6918,2900,0
6744701310,20150415T000000,1.85E+06,4,2.5,3830,11972,2370,1460
3131201310,20140930T000000,525000,5,1,1280,3876,1280,0
3630180500,20141006T000000,1.15E+06,5,3.5,4350,6218,3520,830
7624700050,20141223T000000,565000,1,1,1370,6250,1370,0
3274800460,20140520T000000,387000,2,2.25,1230,1280,960,270
1939000010,20140619T000000,720000,4,2.5,2440,34290,2440,0
4139490190,20140711T000000,1.50E+06,4,3.5,4410,12426,3420,990
6381500170,20140826T000000,235000,2,1,910,7617,910,0
6381500170,20150116T000000,365000,2,1,910,7617,910,0
1954420170,20140521T000000,368250,3,2.5,2150,7484,2150,0
1954420170,20141113T000000,580000,3,2.5,2150,7484,2150,0
623059016,20140717T000000,1.10E+06,4,3.25,3190,11774,2610,580
6181400470,20150127T000000,215000,4,2.5,2130,4496,2130,0
3904920980,20140909T000000,648000,4,2.5,2740,9959,2740,0
7215730430,20140903T000000,705000,4,3,3150,9318,3150,0
475000190,20150109T000000,465000,3,2.25,1450,1540,1180,270
2877100235,20141222T000000,650000,5,2,2400,3500,1900,500
7893202340,20140721T000000,335000,4,2.25,2280,7500,1140,1140
9238430190,20150428T000000,640000,4,2,2310,31850,2310,0
1939120050,20150303T000000,638250,4,2.5,2460,8029,2460,0
9197800010,20141017T000000,1.46E+06,4,3.5,4200,14353,3640,560
5248800250,20150427T000000,375000,4,2,1620,4600,1620,0
4457300630,20140716T000000,842000,4,1.75,2170,9525,2170,0
2228900161,20141008T000000,499950,3,2.25,2880,7200,1710,1170
6817850050,20150217T000000,810000,4,2.5,3280,25211,3280,0
1775800280,20150226T000000,310000,5,2,2900,11970,2900,0
263000050,20141031T000000,730000,3,2.5,2160,8809,1540,620
1870400470,20141113T000000,637800,4,1.75,2250,4750,1420,830
7839300185,20150206T000000,225000,3,1,1340,4800,1340,0
2426039130,20140610T000000,417500,4,1,1390,10800,1390,0
2938200170,20150320T000000,265000,4,2,1600,10160,1600,0
1954440050,20140725T000000,550000,4,2.5,2050,8683,2050,0
2224079001,20150126T000000,625700,3,2,2570,159865,2570,0
200520080,20140801T000000,595000,3,2.5,2660,10637,2660,0
2195900010,20140714T000000,270000,3,1.5,1540,13475,1540,0
5707500050,20140718T000000,739375,5,3,2640,3200,2140,500
8929000130,20140708T000000,357562,2,1.75,1210,1032,1210,0
2944000170,20140611T000000,1.01E+06,4,2.5,3760,29224,3760,0
8682262330,20140930T000000,455000,2,1.75,1350,4286,1350,0
4167800130,20150501T000000,310000,5,2.25,2600,9600,1810,790
1624079088,20140811T000000,415000,3,2.75,3900,111514,3460,440
7370600050,20140819T000000,452000,2,1,1340,8100,1340,0
2025059134,20150113T000000,810000,3,2,1760,16928,1760,0
7522500020,20140527T000000,730001,3,2,1840,4750,1010,830
1125069134,20150430T000000,825000,3,2.25,2980,86636,2230,750
8032700010,20140716T000000,665000,3,2.5,1730,3000,1730,0
2473370050,20140604T000000,327500,4,1.75,1650,7800,1650,0
3276930050,20140728T000000,699950,3,2.5,3370,36218,3370,0
3211230080,20140728T000000,424000,3,2.5,2200,34680,2200,0
7519000471,20140625T000000,657000,4,2.5,2180,3375,1420,760
8563000130,20140717T000000,445000,3,1.75,1490,10844,1210,280
2770604103,20140731T000000,450000,3,2.5,1530,762,1050,480
3581000020,20140926T000000,350000,3,1,1180,7455,1180,0
9432750190,20141112T000000,460000,4,2.5,2080,17532,2080,0
1622059088,20140626T000000,385000,4,2.5,3200,22651,1610,1590
5559900080,20141104T000000,272000,4,2.25,1880,6160,1880,0
7202260780,20150120T000000,535000,3,2.5,2510,5544,2510,0
8651410950,20150430T000000,216500,2,1,1060,5200,1060,0
7843500080,20150225T000000,325000,3,2.5,2130,12245,2130,0
3205400290,20150406T000000,420200,3,1.75,1320,7280,1320,0
7129300420,20141202T000000,258000,3,1.75,1040,5650,1040,0
263000280,20141202T000000,450000,3,2,1150,4500,1150,0
2919200280,20141208T000000,720168,4,2.25,2120,3794,1420,700
2769602880,20141002T000000,652000,3,2,2130,5000,1330,800
8078440050,20140730T000000,569500,4,2.5,2340,8248,2340,0
1922069071,20150424T000000,411000,4,1.75,2250,292288,2250,0
7518502945,20140519T000000,524950,3,1.75,1890,3825,1290,600
7568700480,20150323T000000,153000,2,1,1140,10152,760,380
9577800005,20141022T000000,775000,3,2.5,2780,5467,2780,0
7436050170,20150112T000000,338500,4,2.5,2390,6111,2390,0
7200001259,20150501T000000,570000,3,1.75,2390,9000,1500,890
4127000095,20141029T000000,653000,3,2,2680,8429,1880,800
1934800086,20141120T000000,435000,2,2.5,1560,1222,1080,480
3361401025,20141126T000000,207000,2,1,1130,8160,1130,0
7430500415,20140725T000000,540000,2,1,1120,7500,1120,0
1622049182,20140625T000000,386000,4,2.25,2050,9583,1770,280
7749500250,20140827T000000,265000,5,2.25,2600,8075,2600,0
1773101159,20150107T000000,250000,3,2.25,1050,572,740,310
9829200250,20150105T000000,1.70E+06,3,2,2600,6600,1930,670
3303860130,20141203T000000,455000,4,2.5,2811,7251,2811,0
9359100500,20140527T000000,1.80E+06,4,3.25,4060,13000,4060,0
1250203860,20141030T000000,759000,3,2,2260,7200,1130,1130
2386000170,20150326T000000,970000,4,2.75,4430,74358,4430,0
5702500050,20141104T000000,280000,1,0,600,24501,600,0
2600000050,20140827T000000,690000,3,2.25,2430,8327,1430,1000
7856640170,20140708T000000,789900,3,2.5,3420,25150,1750,1670
5540800130,20150318T000000,447500,2,1,1180,5100,1180,0
7955060010,20140613T000000,440000,4,2.25,2010,7575,1220,790
7760400470,20150414T000000,278000,3,2,1230,7789,1230,0
9551202130,20140714T000000,980000,5,2.5,2750,6000,1750,1000
4345000050,20140630T000000,245000,3,2.75,1300,14197,860,440
7334501440,20141021T000000,287000,3,1.5,1150,11475,1150,0
1523069215,20140603T000000,435000,3,1.75,2220,132858,1110,1110
5525400430,20140715T000000,585000,3,2.5,2050,11690,2050,0
871001611,20140701T000000,616000,4,1.75,1700,5846,1700,0
1685200190,20150115T000000,203000,3,1.75,1610,9000,1100,510
1982200675,20150506T000000,860000,4,2.75,2720,3840,1790,930
1201500010,20150330T000000,833000,4,2.5,2190,12690,1170,1020
1822360080,20141211T000000,565000,4,2.75,2730,6856,2730,0
4113800500,20150212T000000,572500,3,2.5,2490,7589,2490,0
4299700095,20140516T000000,254000,4,2,1510,4235,1510,0
3585900500,20150402T000000,1.53E+06,4,4.25,4720,21000,4720,0
326069026,20150121T000000,900000,4,3,3810,217800,3810,0
4070700290,20150226T000000,899000,3,2.5,1950,3730,1950,0
7625703800,20150424T000000,560000,3,2,1300,6000,1300,0
643400130,20150304T000000,512500,3,1.75,1610,7200,1180,430
2877103070,20150223T000000,775000,4,2.5,2040,5000,1180,860
421000185,20140611T000000,200000,2,1,700,4700,700,0
2113700825,20140731T000000,172000,3,1,970,4700,720,250
623049093,20140522T000000,219900,3,1,910,6000,910,0
4348800080,20140711T000000,641200,3,1,1060,9123,1060,0
3762900010,20140715T000000,473000,5,3.25,2180,7200,2180,0
3578401700,20140701T000000,540000,3,1.75,2050,9580,1400,650
1211000280,20150504T000000,295000,2,1,750,4500,750,0
1324300091,20140528T000000,370000,3,1,800,2296,800,0
4141800285,20140714T000000,1.73E+06,4,2.25,3470,8000,2360,1110
1524079088,20140509T000000,275000,3,1.5,1390,48257,1390,0
9320900420,20141014T000000,89000,3,1,900,4750,900,0
7349800780,20140805T000000,175000,2,1.75,1050,9800,1050,0
1196002948,20150218T000000,490000,3,2.5,2410,11900,1600,810
5631500213,20140515T000000,342400,3,2.25,1180,9630,1180,0
3416601045,20140623T000000,345000,3,1,1140,4200,1140,0
9828701650,20141125T000000,399000,2,1,700,3400,700,0
6071300500,20140815T000000,550000,4,2.5,2060,9719,1320,740
6072760670,20141203T000000,652450,3,2.25,2230,11835,1630,600
9141100255,20150429T000000,438000,2,2.25,1950,29347,1350,600
2824600290,20150403T000000,605000,3,1.75,2100,5058,1340,760
2787720170,20140929T000000,395000,4,2.5,2130,11733,1330,800
9826701735,20141112T000000,449950,3,2,1880,3048,1880,0
1703050420,20150330T000000,651100,4,2.5,2310,5526,2310,0
4060000440,20150204T000000,241000,3,1,880,6050,880,0
2525049148,20141007T000000,3.42E+06,5,5,5450,20412,5450,0
8857310010,20141219T000000,268500,2,1.5,1290,1749,660,630
1823049178,20150123T000000,200000,2,1,1010,7200,1010,0
4364200250,20141201T000000,400375,4,1.75,1690,7680,890,800
8682260480,20140528T000000,429000,2,1.75,1350,6315,1350,0
1250200345,20141024T000000,230000,3,1,680,2400,680,0
9808590460,20150218T000000,1.20E+06,4,2.25,2860,10702,2860,0
7818700480,20150409T000000,314200,1,1,610,6000,610,0
2792000010,20150423T000000,513000,4,2.5,2660,8887,1880,780
1705400244,20150402T000000,535000,2,1,1390,5346,960,430
9358002375,20150305T000000,420000,6,3,2290,6344,2290,0
8944320470,20140623T000000,345950,3,2.5,2110,4118,2110,0
6372000101,20140820T000000,483500,3,2,1200,2016,600,600
2877100655,20141208T000000,695000,4,2.25,2360,2500,1520,840
9378500050,20141006T000000,295000,4,2.5,2350,8906,2350,0
3790600080,20150408T000000,434975,3,2.25,1590,9960,1060,530
8944360080,20140708T000000,513000,3,2.5,1810,4592,1810,0
7979900225,20150323T000000,360000,3,1.75,1900,11407,1900,0
3163600130,20150317T000000,234900,3,1,1250,8000,1250,0
4139380050,20140616T000000,963000,4,3.5,3280,6603,3280,0
2749600095,20140819T000000,595000,2,1.5,870,4800,870,0
7852160250,20141024T000000,942500,4,3.25,3570,14408,3570,0
3303980500,20140905T000000,1.03E+06,4,3.25,3780,11200,3780,0
1250200605,20150325T000000,350000,3,1,1190,3600,1190,0
8887001640,20141106T000000,416500,4,2,2280,39848,2280,0
2122059127,20140916T000000,209900,3,1,1030,60720,1030,0
5700001045,20140622T000000,802000,3,1.75,2870,5000,1840,1030
7331900290,20140731T000000,230000,4,1.5,1520,8800,1520,0
7844200415,20140702T000000,489000,3,3,3700,10375,3700,0
4055700345,20140714T000000,497000,3,1.5,2240,28750,1620,620
2923049421,20140702T000000,250000,3,2.25,1920,7738,1520,400
1860600840,20140815T000000,925000,3,3,2560,3600,2110,450
5095400460,20140723T000000,390000,4,2.5,1840,15496,1840,0
3819750170,20150310T000000,415000,3,2.75,2080,9600,2080,0
5021900779,20150404T000000,785000,3,2,1600,9638,1600,0
4206901155,20140924T000000,575000,3,2,2168,4000,2168,0
6303400290,20150126T000000,170000,2,1,860,8636,860,0
7871500440,20141014T000000,750000,4,1.75,2100,3400,1100,1000
6085000130,20150321T000000,230000,3,1,1140,9639,1140,0
1896700080,20150105T000000,855000,4,3,3090,35074,3090,0
6197800101,20140805T000000,235000,3,1,1330,45738,1330,0
7802900380,20140908T000000,335000,2,1,1360,69260,1360,0
3024059126,20140703T000000,1.20E+06,5,3,3420,18129,2540,880
7128300630,20150330T000000,677000,4,2,2180,6000,2060,120
7626200305,20141022T000000,575000,3,2,1800,5000,1600,200
7950300670,20150218T000000,450000,2,1,1120,4590,1120,0
1233100321,20150327T000000,817250,3,2.5,2980,7202,2980,0
9238500190,20141202T000000,440000,4,2.25,2600,28600,1810,790
1972201856,20140507T000000,526000,2,2,1550,2400,1550,0
624110920,20140725T000000,762500,3,2.25,3330,15258,3330,0
5003600080,20150414T000000,325000,4,2.5,2200,7719,2200,0
853600020,20140710T000000,840000,4,3.5,3840,85728,3840,0
7625704317,20150503T000000,377500,2,1,840,4500,840,0
2946000912,20140923T000000,212500,3,1.5,1270,7128,1270,0
4188000670,20140515T000000,749400,4,2.5,3240,20301,3240,0
5215200010,20140626T000000,663000,3,2.5,2480,37843,2480,0
2911700020,20140721T000000,1.48E+06,3,2.25,4470,22518,3240,1230
185000161,20141015T000000,261000,3,1,1780,7800,1060,720
2140700190,20150410T000000,515000,4,2.5,1850,9248,1850,0
9406600050,20140512T000000,410000,3,2.25,2200,16921,2200,0
2473000470,20140708T000000,336000,3,2.25,2760,10160,2760,0
5100403952,20150225T000000,440000,2,1,1090,4128,1090,0
2024059127,20150109T000000,908950,4,2.75,3090,6200,3090,0
1483300430,20141125T000000,554000,2,1,820,3700,820,0
291300170,20140509T000000,387000,3,2.25,1445,1606,1300,145
9117000170,20150505T000000,268643,4,2.25,1810,9240,1810,0
461004095,20140721T000000,514000,3,1.75,1620,5000,920,700
9547201850,20140723T000000,420000,2,1.75,1060,4182,1060,0
7942100290,20140910T000000,199000,3,1.75,1050,9871,1050,0
4336000050,20150317T000000,225000,3,1,1010,15701,1010,0
2571910420,20140819T000000,320000,4,2.5,2050,8424,2050,0
8802400896,20141023T000000,204995,2,1,970,8185,970,0
3630010020,20141229T000000,376000,3,2,1540,1827,1540,0
6793300010,20141215T000000,705000,4,2.75,3000,6222,3000,0
7852020250,20140602T000000,725995,4,2.5,3190,7869,3190,0
2473400290,20150126T000000,285000,4,2.5,1870,8190,1100,770
3328500250,20140502T000000,285000,4,2.5,2200,9397,2200,0
629420080,20140820T000000,731000,4,2.5,3070,5936,3070,0
2524049215,20150501T000000,1.56E+06,4,3.75,3730,17000,2820,910
8663310050,20141006T000000,510000,4,2.5,2440,10423,2440,0
4083304835,20141023T000000,620000,2,1,990,4332,990,0
8155800050,20150422T000000,1.11E+06,3,4,4160,31796,4160,0
4403200255,20140722T000000,796000,4,3.5,3670,4960,2870,800
5379800500,20140930T000000,255000,3,1.5,910,25500,910,0
7010700660,20150428T000000,807000,3,2.5,1940,4000,1940,0
9406540190,20141110T000000,315000,4,2.5,1780,6000,1780,0
1795920250,20150227T000000,637000,3,2.25,2200,7355,2200,0
5249800010,20141203T000000,2.73E+06,4,4.25,6410,43838,5610,800
8651510420,20141211T000000,490000,3,2,2070,10023,1220,850
1422700080,20140610T000000,253000,3,1.75,2040,7281,1020,1020
5468780250,20140508T000000,325900,4,2.5,2320,6270,2320,0
3723800415,20141015T000000,425000,2,2,1440,6677,870,570
1545800290,20140905T000000,215000,4,2.5,1700,6675,1700,0
1545800290,20150408T000000,315000,4,2.5,1700,6675,1700,0
2804100095,20140516T000000,724800,3,2,2050,3933,1180,870
7282300095,20140709T000000,295000,2,1,800,6500,800,0
930000289,20150316T000000,509007,3,1.75,1800,7620,1350,450
2822059181,20150413T000000,306000,5,2,1460,169448,1460,0
1761100080,20140717T000000,205000,3,1.75,1290,7210,1290,0
2953000250,20140731T000000,275000,3,1.5,1900,9737,1200,700
3416600185,20141106T000000,685000,3,1.75,1480,7000,1480,0
927200380,20150420T000000,465000,4,2.5,2090,12833,1220,870
7922750020,20140708T000000,560000,4,2.25,1950,9800,1330,620
259600050,20150223T000000,458500,3,1.75,1250,9605,1250,0
3298300420,20150331T000000,354000,3,1,990,7590,990,0
1310440470,20150113T000000,441000,3,2.5,2740,7923,2740,0
3438502668,20140829T000000,194000,3,1.75,1260,10488,1110,150
5591700290,20140515T000000,316500,4,2.5,2150,6807,2150,0
4172100050,20140825T000000,524950,3,1.75,1750,3250,1230,520
9275700005,20150427T000000,1.05E+06,3,2.25,2880,6092,1920,960
1089000190,20150412T000000,925000,4,2.25,2590,13894,2590,0
9523103000,20141020T000000,780000,3,1.75,2430,4524,1830,600
2781270440,20140519T000000,241000,2,2,1470,3128,1470,0
2105200050,20140619T000000,519000,3,2.75,2020,10744,1270,750
7625703637,20140828T000000,286000,2,1,610,4000,610,0
2926049408,20141009T000000,400000,3,2,3000,17800,1500,1500
3224079005,20141009T000000,255000,2,1,920,43560,920,0
5147600095,20150121T000000,152000,3,1.75,1070,7754,1070,0
2413900050,20141201T000000,599000,4,2,3410,15143,3410,0
3820350050,20141024T000000,330000,4,2.5,1820,3905,1820,0
8910500675,20140519T000000,461000,2,1,1060,7193,1060,0
1461200020,20150310T000000,620000,5,2.5,3070,34991,3070,0
722079056,20141006T000000,352500,4,2.5,2300,219106,1840,460
8663370020,20140806T000000,435000,3,2,1610,6911,1260,350
2568200130,20140516T000000,725000,5,2.75,2830,5310,2830,0
8947800080,20141105T000000,300000,3,1,970,12300,970,0
1545803390,20141111T000000,252000,3,2.5,1680,8284,1680,0
1088030010,20141005T000000,464625,4,2.75,2040,8996,1260,780
1829700080,20141212T000000,340000,3,1,1450,9586,1450,0
2125049024,20140620T000000,1.33E+06,4,2.25,2870,6280,1980,890
5706200020,20150206T000000,455000,5,2,1870,13970,1120,750
2316400285,20150513T000000,495000,4,3.5,2490,18042,2490,0
7588700080,20150421T000000,925000,4,2.5,3350,4501,2640,710
7853310380,20141211T000000,587000,4,2.75,3190,8737,3190,0
6821101870,20140505T000000,524000,3,1.75,1560,5520,780,780
9551201660,20140613T000000,1.03E+06,4,2.5,2750,4800,1960,790
3530500010,20140930T000000,176000,2,1,920,2332,920,0
7387500185,20140521T000000,249900,2,1,1140,5500,1140,0
1626079132,20140605T000000,499500,3,2.5,2520,53143,2520,0
8854100130,20140911T000000,600000,5,3.5,3150,10542,1620,1530
2123049142,20140814T000000,294000,4,2.5,2040,7800,2040,0
3423059109,20150415T000000,272000,4,2,1780,19843,1780,0
5631500992,20140515T000000,390000,3,2.5,2240,10800,2240,0
6641800020,20150109T000000,700000,4,2.5,3270,9650,2320,950
7853301700,20150420T000000,635000,5,2.75,3110,6621,3110,0
2158900290,20150416T000000,920000,4,1.5,1850,3600,1660,190
2273600250,20140804T000000,500000,3,1.75,1570,8530,1190,380
3298700840,20140821T000000,263500,2,1,750,4515,750,0
5450500010,20150313T000000,975000,4,2.25,2240,9990,2240,0
3629870020,20141114T000000,575000,3,2.5,1870,3485,1870,0
8856700130,20140612T000000,822000,4,2.5,2683,40386,2683,0
6381502155,20150116T000000,300000,3,1,1490,7200,1490,0
1443550080,20150330T000000,487600,4,2.5,2340,12080,2340,0
2205700345,20140707T000000,500000,4,2,1700,8640,850,850
6926700660,20140911T000000,680000,2,2,1450,989,1450,0
3279050130,20140910T000000,419000,3,2.5,3310,21096,3310,0
2770606890,20140807T000000,450000,4,1.75,1520,5250,1520,0
2867100190,20140618T000000,650000,5,1.75,1260,4500,1260,0
8562600190,20140623T000000,550000,3,1.75,1840,8086,1840,0
5680000545,20141203T000000,330000,4,2,1750,5202,1070,680
1922059027,20150123T000000,282510,4,1,1450,32234,1450,0
1725059316,20141120T000000,2.39E+06,4,4,6330,13296,4900,1430
3275300440,20141120T000000,230000,2,2,1260,10200,1020,240
952001735,20141004T000000,750000,4,1.75,2100,6613,2100,0
1402950190,20140916T000000,321000,4,2.5,2430,5366,2430,0
4045100190,20141027T000000,2.20E+06,4,3.25,4250,18000,3350,900
1207200010,20150318T000000,245000,4,2,1830,10416,1370,460
6815100095,20141223T000000,510000,2,1,1310,4000,1310,0
3825310130,20140624T000000,751000,4,3.25,3090,9571,2370,720
3276930380,20140523T000000,675000,4,2.5,2560,36601,2560,0
8937600080,20150126T000000,295000,3,1.75,1930,13350,1930,0
8024200010,20141028T000000,312000,2,1,1460,6000,1260,200
624110020,20140925T000000,730000,3,3,3460,13129,2560,900
6192410280,20150102T000000,762500,5,3.5,3290,5880,2670,620
4302201045,20140528T000000,150000,3,1,820,7680,820,0
507100020,20150309T000000,270000,3,1,1480,7374,760,720
259600280,20150406T000000,400000,4,2,1420,9301,1420,0
7691800130,20140826T000000,650000,3,2.5,2790,6720,2790,0
2056100275,20141006T000000,530000,2,1.5,1390,5000,970,420
2202500080,20140630T000000,248000,3,1,950,9400,950,0
3179102155,20150108T000000,760000,4,3.5,3000,5300,1780,1220
937000280,20150220T000000,199000,4,1,1280,10521,1280,0
5379805253,20141020T000000,240000,2,1,870,8400,870,0
6821102340,20150504T000000,415000,3,1.5,1360,1795,1360,0
7229900250,20141202T000000,228000,3,1,1000,16376,1000,0
7287100177,20150225T000000,525000,4,2.5,2740,12106,1980,760
8820900670,20140623T000000,399950,3,1.75,1560,5223,810,750
3275850020,20150413T000000,781000,4,2.5,2590,8571,2590,0
9528100899,20150428T000000,827000,3,2.5,1850,1330,1560,290
7016000440,20140716T000000,525000,5,2.25,2500,8621,2500,0
7202340010,20150224T000000,671300,4,2.5,3280,5232,3280,0
6911700066,20140604T000000,175000,2,1,670,2378,670,0
7511000050,20150302T000000,1.10E+06,5,2.75,2890,22547,2150,740
2925059260,20150506T000000,800000,5,2.5,3000,10560,1500,1500
3558000170,20140711T000000,329950,4,2.5,1920,4600,1920,0
8651730290,20140805T000000,445000,4,3.25,1960,7200,1960,0
9197100263,20140819T000000,237000,3,1.75,2000,12208,1140,860
8941100095,20140923T000000,1.11E+06,6,4,3600,6224,2610,990
2781100080,20141210T000000,438900,4,2.5,2740,5700,2740,0
9822700190,20140808T000000,1.28E+06,9,4.5,3650,5000,2530,1120
3630030290,20141017T000000,600000,4,2.5,2310,3866,2310,0
9510910250,20150120T000000,670000,4,2.5,2095,4569,2095,0
8682231330,20150504T000000,519000,2,2,1560,4823,1560,0
2473480780,20150311T000000,320000,3,2.25,1880,7350,1390,490
8641500280,20140522T000000,270000,2,1.5,840,867,840,0
7605800050,20140602T000000,1.00E+06,3,2.5,2730,5832,2730,0
9828200525,20140815T000000,330000,1,1,860,4800,860,0
7971300050,20140710T000000,657500,3,2,2320,10960,1510,810
126049169,20140828T000000,450000,3,1.75,1540,61419,1540,0
5062300280,20150416T000000,150000,3,1,890,6488,890,0
7167000020,20140616T000000,792500,4,2.5,4290,175421,4290,0
3303910010,20150220T000000,540000,3,2.5,1950,13227,1950,0
2268000050,20140721T000000,229900,3,1,1010,8848,1010,0
8857640170,20150506T000000,533000,4,2.5,2830,6536,2830,0
7806210190,20141222T000000,239000,4,1.75,1500,12560,1000,500
9206700190,20150306T000000,713900,3,2.5,3370,167706,3370,0
4136930190,20141028T000000,427500,4,2.5,3160,8726,3160,0
5666300010,20140722T000000,302000,3,1,1110,7000,1110,0
1424059022,20140708T000000,1.15E+06,3,2.5,3830,48743,3830,0
6204050080,20140528T000000,555000,3,2.5,3160,4270,2650,510
7128300500,20141230T000000,495000,3,2.25,2100,3000,2100,0
1233100642,20140722T000000,495000,3,1.5,2240,13288,2240,0
222029026,20140917T000000,340000,2,0.75,1060,48292,560,500
9485940290,20150512T000000,464950,4,2.25,2350,36116,2350,0
4136890280,20150327T000000,320000,4,2.5,1940,7040,1940,0
1775500050,20150129T000000,440000,1,1,1160,64469,1160,0
7611200086,20140602T000000,686000,3,1.5,1840,9990,1840,0
3376600010,20141201T000000,555000,4,1.75,2260,11000,1620,640
7519001990,20141027T000000,361500,2,1,840,3860,840,0
7613700950,20140610T000000,1.24E+06,5,3,2830,7500,2460,370
3802000020,20140709T000000,154950,4,1,1600,10183,1600,0
1796360470,20140617T000000,247200,3,1.75,1370,8719,1370,0
8732160050,20140822T000000,250000,3,2.25,1960,7414,1490,470
5249800345,20140619T000000,590300,3,1.5,1470,7200,1470,0
6071200545,20140505T000000,541125,5,2.75,2740,8426,1370,1370
291300280,20150218T000000,310000,2,2.5,1090,923,1090,0
3261000080,20150310T000000,704111,4,2.75,2460,9520,1680,780
321049127,20141028T000000,277500,3,2.25,1820,19602,1820,0
5379804393,20150217T000000,325000,4,2.75,1960,8937,980,980
1559900080,20141121T000000,289200,3,2.25,1760,7023,1760,0
7135300275,20140904T000000,185000,1,1,720,5000,720,0
1377300005,20150401T000000,1.45E+06,4,3.5,3470,8580,2500,970
6668900020,20150318T000000,420550,4,2,1370,8100,1370,0
326049024,20150410T000000,603000,4,2.25,2370,11310,1550,820
7942600006,20141126T000000,345000,3,1,1390,2640,1230,160
6430500233,20150416T000000,650000,3,2,1840,3075,920,920
7701800050,20140625T000000,589950,5,3,2790,19439,1500,1290
8165501640,20140819T000000,309950,2,2.25,1460,1607,1460,0
2623069069,20140911T000000,775000,3,2.5,2620,241200,2620,0
8024201870,20141029T000000,590000,4,1.5,2230,5109,1330,900
9126101511,20150428T000000,863500,4,3,3250,2760,2420,830
1377800010,20141119T000000,517500,3,1,1190,7000,1190,0
6813600380,20141224T000000,700000,3,3,2090,7440,1290,800
923000280,20140722T000000,699000,3,2.5,2580,8154,2090,490
255550190,20140722T000000,350000,3,2.5,2100,3574,1690,410
1829300130,20140717T000000,795000,4,2.5,3160,16564,3160,0
3645500050,20140514T000000,543000,3,2.5,2090,7640,1360,730
1518000080,20150223T000000,325000,3,2.5,1570,3143,1570,0
7883605915,20150508T000000,337500,3,1,1020,6000,1020,0
1112700170,20150227T000000,425000,2,1,1300,11080,1300,0
8965500020,20150317T000000,780000,3,2.5,2110,9773,2110,0
323059167,20140723T000000,259000,2,1,1210,17389,1210,0
1951700480,20140813T000000,524400,4,1.75,1990,12950,1850,140
2005950050,20140527T000000,260000,3,2,1630,8018,1630,0
9406500480,20150420T000000,273000,2,2,1384,1822,1384,0
3522049063,20150402T000000,639900,4,2.5,3380,75794,3380,0
2085700050,20140826T000000,420000,4,2.5,2480,8626,2480,0
6751300130,20140813T000000,510500,3,1,1270,8000,1270,0
2610100020,20150408T000000,290000,4,1,1010,7200,1010,0
9476200680,20150428T000000,226000,3,1.75,1490,6269,990,500
6145600285,20140529T000000,300000,2,1,820,3844,820,0
203900460,20140728T000000,407450,3,2,1810,10860,1810,0
7878400022,20150506T000000,390000,4,2.25,3060,7920,1530,1530
3585900460,20150501T000000,1.06E+06,6,2.75,2980,20000,2130,850
1321720170,20140817T000000,610000,3,2.5,3440,18167,3440,0
236400130,20150123T000000,239975,3,2.5,1820,7242,1220,600
4141680190,20140807T000000,375000,3,2.5,2320,5760,1480,840
3629980440,20150428T000000,742500,4,2.5,2620,4400,2620,0
1223039173,20150429T000000,450000,4,1.75,2190,11625,2020,170
2473000130,20140626T000000,300000,3,2.25,1780,10395,1780,0
2893000280,20150501T000000,216600,3,1.75,2200,7700,1240,960
7977201845,20140514T000000,525000,3,1.75,1600,6120,1600,0
4197400005,20140620T000000,455000,4,2.25,2450,21000,1650,800
5561200980,20141003T000000,390000,4,2.25,2680,35218,2680,0
3039000020,20140916T000000,450000,3,1.75,1850,8667,880,970
6840701100,20141202T000000,382000,4,1,1740,4400,1740,0
2130410050,20140513T000000,287000,3,2.25,1490,9600,1170,320
1924079091,20150113T000000,460000,4,2,1960,190357,1960,0
3570300080,20141028T000000,435000,3,2.25,1380,3015,1380,0
2321300351,20140612T000000,575000,2,1,1510,4032,1310,200
2652501630,20150504T000000,626700,3,1.5,1410,3600,1410,0
3810000020,20150318T000000,352000,4,1.5,1440,8680,1440,0
8084400010,20150316T000000,650000,3,1,920,6750,920,0
304000380,20141006T000000,197000,3,1,1090,17630,1090,0
1873400020,20140703T000000,340000,8,2.75,2790,6695,1470,1320
4359700080,20140721T000000,560000,3,2,1840,14985,1840,0
1727500010,20150107T000000,354000,3,1.75,1340,6300,1340,0
8651610680,20140801T000000,670000,4,2.5,2570,9086,2570,0
3629970190,20150126T000000,769000,4,3.5,3010,6202,3010,0
9136102057,20140905T000000,650000,4,2.5,2160,3139,1080,1080
1266200130,20140615T000000,650000,3,1.75,2140,9484,1290,850
2787310130,20141212T000000,289950,4,1.75,2090,7416,1050,1040
8645511350,20141201T000000,300000,3,1.75,1810,21138,1240,570
9284801435,20141203T000000,471000,4,1.75,1760,5750,1070,690
3905010010,20140718T000000,639000,4,2.5,2500,8540,2500,0
4058801310,20141009T000000,287000,2,1,930,6900,930,0
6705850020,20150401T000000,740000,4,2.5,3030,8335,3030,0
1623800440,20150417T000000,499922,3,2,1460,3000,940,520
3904902500,20141219T000000,675000,4,2.5,2940,14071,2940,0
7308600050,20140909T000000,738515,5,2.75,3360,9200,3360,0
5679501310,20141030T000000,445000,3,1.75,2110,4800,1210,900
3935900005,20150501T000000,1.04E+06,4,2.25,2740,11343,1980,760
3726800285,20141001T000000,346000,2,1,1070,2196,880,190
1183000005,20150408T000000,450000,3,2,1680,4886,1180,500
5469502780,20140812T000000,350000,4,2.5,2260,13755,2260,0
9185700440,20140728T000000,2.40E+06,4,3.5,5860,7200,3690,2170
629600130,20140801T000000,594950,4,2.25,2380,35008,2380,0
9178601660,20150514T000000,1.70E+06,5,3,3320,5354,3320,0
2191600780,20141010T000000,219000,2,1,1050,9000,1050,0
7852180430,20150409T000000,450000,4,2.5,2070,3982,2070,0
8155820080,20150415T000000,402000,4,2.25,1790,7311,1790,0
5248800440,20150217T000000,275000,2,1,840,4000,840,0
9818700430,20141001T000000,421500,3,1.5,990,4500,990,0
425079099,20140507T000000,560000,3,3,4120,60392,3180,940
5127000670,20150318T000000,314000,3,1.75,1620,9600,1620,0
6341000221,20150423T000000,287000,4,2,1340,8190,1340,0
7231501665,20150403T000000,277000,4,1,1500,5750,1500,0
5014000225,20141222T000000,337500,2,1,1300,6731,1300,0
4401200130,20140819T000000,792000,4,2.75,3100,10245,3100,0
1558500050,20141113T000000,435000,3,2.5,3380,7074,2200,1180
8899000050,20150325T000000,313100,4,2.5,2660,9030,1450,1210
2877102846,20140625T000000,575000,3,2.25,1700,3333,1100,600
7280300080,20150202T000000,510000,4,2.5,1840,7800,1240,600
3624039073,20150319T000000,299950,2,1,890,5200,890,0
3271300345,20150323T000000,1.03E+06,3,3,2800,5800,1580,1220
6190701483,20140514T000000,364000,4,1.75,2010,8625,1340,670
414100630,20140729T000000,335000,3,1,1380,7470,1380,0
7686202275,20141209T000000,219950,3,1,1210,8000,1210,0
5113260170,20150113T000000,215000,3,2,1280,6994,1280,0
2421059090,20150511T000000,640000,4,2.5,4090,215186,3670,420
2770601734,20140630T000000,535000,3,1,1580,6300,1180,400
4222310290,20140819T000000,253000,4,2,1910,7826,1140,770
5016001060,20140530T000000,650000,2,2.5,1740,2500,1210,530
5445300050,20150408T000000,672000,3,2.25,1130,4445,1130,0
7370600020,20141007T000000,606000,3,1.75,1970,8540,1130,840
5127000470,20150305T000000,292000,3,2.25,1780,9720,1280,500
1330250010,20140604T000000,289950,3,2,1670,7757,1670,0
1898600050,20140722T000000,257500,4,1.5,1360,9323,1360,0
9561100010,20141104T000000,380000,3,2.5,1840,6985,1290,550
9524100050,20141222T000000,360000,3,1.75,1255,1113,1255,0
2212200500,20140623T000000,269500,3,1.75,1840,7412,1240,600
5416500680,20140630T000000,449000,4,2.5,2960,6031,2960,0
6412600005,20141003T000000,375000,4,1.5,1430,7232,1430,0
2024069008,20140619T000000,2.20E+06,5,4.75,5990,10450,4050,1940
2195700050,20140519T000000,810000,4,2.5,3480,59242,3480,0
1437580480,20140918T000000,994000,5,3.25,4260,7861,4260,0
2796100680,20150225T000000,275000,5,2.25,1820,10500,1080,740
7203102140,20150429T000000,300000,2,1,1290,2482,1290,0
40000235,20150414T000000,380000,5,2.5,2130,8428,2130,0
2946000285,20150302T000000,200000,3,2,1170,10051,1170,0
6848200221,20140902T000000,635000,3,3.5,1730,1349,1350,380
952004725,20141106T000000,280000,2,1,880,5750,880,0
7852110050,20140625T000000,574000,3,2.5,2380,6832,2380,0
5536100010,20150204T000000,1.05E+06,4,1,1330,9729,1330,0
5703000050,20140508T000000,545000,3,2.25,1780,191228,1780,0
6071800480,20150327T000000,271950,3,1.5,1220,8400,1220,0
1954600050,20140716T000000,630000,5,1.75,2490,24969,1540,950
3819800280,20140819T000000,400000,2,1,1180,10800,1180,0
7300400170,20140910T000000,334000,4,2.5,2310,6200,2310,0
9834201100,20141222T000000,332500,4,2,1440,4855,1440,0
8850000509,20140923T000000,525000,2,1.5,1620,1444,1080,540
4123840470,20150224T000000,408000,3,2.5,2620,8403,2620,0
1150900080,20150427T000000,846450,4,2.5,3710,7491,3710,0
514500235,20141020T000000,411100,3,1.5,1040,10323,1040,0
1522059120,20140709T000000,409124,5,3.25,3320,11340,2480,840
2895600680,20140707T000000,335950,2,1.5,800,5192,800,0
8087800480,20150331T000000,480000,5,2.5,2040,9597,1240,800
7931000066,20141224T000000,280000,2,1.75,1960,30144,980,980
5406500480,20140721T000000,668000,4,2.5,2670,4410,2670,0
2540820010,20150427T000000,750000,4,2.5,2930,8641,2930,0
3300700470,20140514T000000,394475,2,1,830,4000,830,0
8823902005,20150326T000000,848000,5,1.75,2290,4320,1980,310
6003001760,20140924T000000,675000,3,1.5,2510,3600,2510,0
1432400095,20141106T000000,175000,3,1,1280,7572,1280,0
2483700095,20141106T000000,560000,4,1.5,1810,6000,1350,460
6600220380,20140531T000000,538888,5,2.75,2080,13189,2080,0
3990200020,20140908T000000,359000,4,1.75,1680,9244,1680,0
112900020,20140701T000000,300000,3,2.25,1660,5128,1660,0
8700110020,20140917T000000,273000,3,2.5,1650,5994,1650,0
9831200221,20140710T000000,670000,3,2.5,1420,1438,1280,140
8078400010,20141118T000000,530000,4,2.25,2240,8376,1740,500
9550200225,20140711T000000,625000,3,1.5,1230,3060,910,320
2946001950,20150505T000000,248000,3,1,1260,6000,1260,0
3905050280,20140819T000000,533000,3,2.5,2060,4812,2060,0
3026059341,20141211T000000,549950,4,3.5,3090,10510,2190,900
7292700005,20141014T000000,485000,4,1.75,3220,7392,2010,1210
8856970440,20150506T000000,353500,3,2.5,2020,4845,2020,0
7504001440,20140915T000000,435000,2,1.75,1910,12142,1910,0
8068000305,20141104T000000,241000,3,1,1150,10000,1000,150
1681400010,20140519T000000,885000,4,2.75,2730,3560,1550,1180
6850700670,20140513T000000,799200,6,3,2890,2370,2290,600
1546600020,20150114T000000,760000,3,2.5,2280,12746,1490,790
8071000050,20141113T000000,270000,2,1,1040,5700,1040,0
1036000280,20150217T000000,675000,4,1.75,2440,7475,2040,400
5422560380,20141222T000000,499000,3,2.5,1720,5940,1000,720
1762600280,20140714T000000,1.20E+06,3,2.5,3430,28718,3430,0
5416500840,20140627T000000,320000,4,2.5,2570,4865,2570,0
3523069008,20150505T000000,890000,4,3.25,4360,210254,2320,2040
8001210170,20140822T000000,275000,4,2.75,2060,7350,1210,850
6806300920,20140610T000000,490000,4,2.5,3020,8302,3020,0
9826701665,20140725T000000,550000,3,2.5,2340,4200,1540,800
2253200010,20150507T000000,390000,5,2,2400,9537,1210,1190
1941400080,20141020T000000,277000,3,2.25,1610,11920,1110,500
3317010130,20150317T000000,236000,3,1.75,1090,7647,1090,0
1721059230,20150304T000000,265953,3,1.75,1470,13068,1470,0
9328500630,20150302T000000,545000,3,2.25,1670,6240,1240,430
6301800020,20140506T000000,535000,3,2.5,1850,10109,1850,0
7855000460,20141007T000000,1.45E+06,3,2.75,3940,9671,2140,1800
9320350020,20140630T000000,490000,4,3,2330,3497,1920,410
7849201061,20150408T000000,319950,4,2.5,2020,7200,2020,0
3885805640,20140704T000000,625000,3,1.5,1300,7200,1300,0
8960200630,20150220T000000,248000,3,1,1180,6947,1180,0
1736800920,20150421T000000,475000,3,1.75,1320,7840,1320,0
6152900402,20140619T000000,410000,6,2.75,2520,9324,1320,1200
9822700255,20140505T000000,670000,3,2.5,1680,2000,1680,0
1423069102,20150331T000000,430000,3,2.5,2000,35438,2000,0
5279100675,20141028T000000,313000,2,1,1180,4900,1180,0
2524049056,20140714T000000,950000,3,3.25,3330,15093,3330,0
4232400470,20140527T000000,751750,2,2,1880,5400,1880,0
8562740440,20140909T000000,760000,4,2.5,2990,5280,2210,780
8114000020,20150128T000000,310650,3,1.75,1510,12408,1510,0
6600780130,20140502T000000,367500,4,3,3110,7231,3110,0
5100403947,20140804T000000,580000,4,2.5,2150,5000,2150,0
1189000825,20140702T000000,580000,3,2.25,1900,3960,1200,700
3066400080,20140602T000000,665000,4,2.5,2720,10000,2720,0
2214800630,20141105T000000,239950,3,2.25,1560,8280,1560,0
4027701253,20140813T000000,470000,4,2.5,1990,30083,1990,0
9547205260,20140815T000000,733000,3,1.75,1740,3060,950,790
9320600020,20150130T000000,250000,4,2,2130,8400,1350,780
2807100095,20140908T000000,402000,4,1.75,1510,9176,1510,0
8067000020,20140611T000000,295000,5,3.5,2100,5107,1410,690
8731980440,20141016T000000,355000,5,2.5,2344,8000,1560,784
5112800233,20140909T000000,289000,3,1.5,1970,22486,1970,0
6141600179,20141112T000000,376000,3,2.25,1470,9140,1470,0
8122100595,20140627T000000,212700,2,1,940,5040,940,0
5467910190,20140527T000000,325000,3,1.75,1780,13095,1780,0
808300460,20140811T000000,415000,4,2.5,2230,5743,2230,0
7785350010,20150402T000000,935000,3,2.5,3570,15151,2400,1170
2133020020,20150116T000000,372000,3,2.5,1920,15260,1920,0
2588800006,20141021T000000,240000,3,1.5,1290,8366,1020,270
5169700022,20140915T000000,334950,3,1.75,1880,16262,1880,0
5416500660,20150430T000000,426500,4,2.5,2960,4640,2960,0
6117502745,20150224T000000,430000,2,1.75,1840,14874,1300,540
2624049169,20141211T000000,400000,3,1.5,1890,6183,1090,800
1426300842,20150428T000000,455850,3,2.25,1820,6000,1120,700
824059321,20140602T000000,1.97E+06,4,3.5,4370,8510,3610,760
126049217,20140604T000000,400000,3,1.75,1530,10731,1530,0
2201500185,20140808T000000,397500,3,1,1030,10480,1030,0
1972205790,20141211T000000,755000,3,2.5,2000,1950,2000,0
6843000080,20140709T000000,287000,5,1.5,1730,9230,1010,720
1442700250,20140716T000000,480000,4,2.5,3620,16000,3620,0
2607760680,20150416T000000,490000,3,2.5,2040,9622,2040,0
3523059056,20140618T000000,365000,3,2.5,2640,6715,1680,960
1657530010,20150224T000000,260000,3,2.5,1600,2244,1600,0
7276100020,20150414T000000,505000,4,1,1480,12675,1480,0
9828200460,20140627T000000,260000,2,1,700,4800,700,0
9828200460,20150106T000000,430000,2,1,700,4800,700,0
5608000840,20140724T000000,905000,4,2.5,3520,12193,3520,0
5422560470,20141203T000000,440000,3,2,1650,6408,1650,0
446000020,20140913T000000,439500,4,1,1360,5500,1360,0
9476200545,20150127T000000,270000,3,2,1350,6696,680,670
8648100130,20150429T000000,306500,3,2.5,1970,6291,1970,0
9358002232,20141019T000000,380000,3,2,1470,1656,1310,160
2212900920,20140722T000000,215000,4,1.75,1610,9652,1610,0
6149700380,20150206T000000,299900,2,1,810,6150,810,0
4340000080,20150327T000000,1.45E+06,4,3.5,2820,7809,2820,0
3751605432,20140513T000000,239950,3,1,1900,33888,1900,0
6384300020,20140623T000000,494000,4,2.5,1830,7345,1540,290
3450300430,20150105T000000,317500,4,1.5,1730,7700,1010,720
1245001763,20150303T000000,670000,4,2.5,2110,7291,2110,0
7853240660,20140820T000000,650000,3,2.5,3060,7831,3060,0
3723800414,20150320T000000,852000,4,2.5,2620,7328,2620,0
5104500020,20140617T000000,250000,2,1.5,1088,1360,1088,0
5438000080,20141210T000000,264950,3,1.5,1400,10853,1400,0
9498200091,20140925T000000,582500,2,2,1540,6804,1020,520
1498301213,20150311T000000,384000,3,2.5,1540,1564,1300,240
2652500285,20141028T000000,817000,3,1.5,2310,3360,1790,520
5127000430,20141201T000000,320000,4,1.75,1730,9520,1730,0
4017110020,20140630T000000,445800,4,2.25,2070,39446,1470,600
3336001946,20150307T000000,263300,2,1,900,4500,900,0
5253300387,20150128T000000,215000,3,1,860,6635,860,0
9222400605,20141115T000000,842500,5,4,2980,4500,2070,910
9222400605,20150411T000000,850000,5,4,2980,4500,2070,910
2163300130,20141001T000000,386000,5,2.5,2740,12413,2740,0
8662500130,20141209T000000,251100,4,2.5,1790,5257,1790,0
1770000130,20141126T000000,435000,3,1.75,1750,16748,1330,420
1888120080,20140922T000000,870000,4,4,3610,12811,3610,0
862000020,20150206T000000,800000,6,1,1430,20620,1430,0
7199100020,20140714T000000,555000,3,1.75,1570,15500,1570,0
9169600275,20140723T000000,280000,2,1,2280,37500,2280,0
2767601815,20150317T000000,356000,3,1,940,2366,940,0
7853221330,20141203T000000,675000,4,2.5,2920,6000,2920,0
7504010780,20141226T000000,605000,4,2.25,2260,11900,2260,0
5015000190,20140625T000000,690500,5,2,2000,4211,1280,720
8682260470,20140619T000000,437000,2,1.75,1440,4225,1440,0
4122700020,20140710T000000,850000,5,2,2310,13430,2310,0
8850000285,20140612T000000,350000,4,2.25,2300,4600,1340,960
4174600185,20140622T000000,480000,2,2.25,1490,6770,1490,0
7229800430,20140723T000000,379500,3,2.25,1830,25641,1830,0
42000130,20140924T000000,600000,5,4.5,4440,9784,4440,0
4139430250,20150330T000000,1.44E+06,4,3.5,4970,16582,3930,1040
9834201470,20141218T000000,303000,2,1.5,1000,1075,840,160
4058801702,20150206T000000,800000,4,2.5,4940,10037,3450,1490
3363400655,20140724T000000,549000,2,2,1980,6000,1220,760
8700500020,20141126T000000,324950,3,2.5,1560,9600,1210,350
8148600020,20140926T000000,170000,2,1,870,6537,870,0
8651430780,20140715T000000,178000,3,1,840,6500,840,0
1432400345,20150421T000000,144000,3,1,1250,8314,1250,0
2524049148,20150317T000000,1.58E+06,4,2.75,3120,20031,1980,1140
2475900840,20150427T000000,258000,2,1,750,7000,750,0
7452500190,20141016T000000,345000,3,1.75,710,5050,710,0
3459000050,20140610T000000,470000,3,1.75,2290,14800,1620,670
2624049091,20150313T000000,2.90E+06,5,2.5,3750,91681,3750,0
1138000250,20140521T000000,350000,3,1.5,980,7790,980,0
4399210130,20140626T000000,225500,2,1.75,1590,11276,1590,0
2770601365,20150224T000000,473000,2,1,940,4000,720,220
7272000980,20150226T000000,279000,3,1.75,1750,9623,1150,600
1566100010,20150414T000000,470000,3,1,1460,8227,880,580
6338000592,20140820T000000,565000,3,1.75,1540,4800,770,770
2815600305,20150422T000000,695000,3,2,2560,6800,1380,1180
561500290,20140711T000000,315000,3,1.75,1660,37642,1660,0
3905080280,20150304T000000,529000,3,2.5,1880,4499,1880,0
925069071,20150126T000000,750000,5,3.75,3500,101494,3500,0
2426049174,20141029T000000,481500,3,2.25,1840,10500,1840,0
9407600250,20150327T000000,211000,3,2,1060,7412,1060,0
7955050170,20150410T000000,455000,3,2.25,1790,7500,1390,400
7224000950,20141103T000000,238950,2,1,810,4838,810,0
464001025,20140918T000000,722500,4,3.5,2600,5100,1820,780
5569700020,20140730T000000,795000,4,2.5,3230,19193,2000,1230
1310910290,20150507T000000,327500,4,2.25,2240,9600,2240,0
5104531640,20150323T000000,585000,4,3,3400,5100,3400,0
1025039145,20140613T000000,775000,4,2,3140,10875,1940,1200
5406500170,20141024T000000,645000,4,2.5,2780,4200,2780,0
1826049426,20150105T000000,445000,4,2.75,2320,12368,1670,650
2011000010,20140502T000000,257950,3,1.75,1370,5858,1370,0
9368700006,20150324T000000,375000,5,1.75,2230,7560,1230,1000
8016250080,20140709T000000,245000,3,2.5,1610,7223,1610,0
4053200285,20140811T000000,725000,3,2.5,3410,41022,3410,0
5411600020,20150304T000000,702000,4,2.5,2810,4922,2810,0
847100078,20140818T000000,330000,3,1.75,1850,14986,1850,0
4232903295,20150416T000000,940000,3,1.5,1790,4800,1790,0
7979900680,20150305T000000,354500,3,1,1150,11396,1150,0
492000532,20150222T000000,279950,4,2.75,2420,8700,2420,0
2310000430,20150507T000000,284000,3,2.25,1580,7034,1180,400
8832900780,20141013T000000,480000,5,2,1760,21562,1560,200
8832900780,20150408T000000,647500,5,2,1760,21562,1560,200
3249500020,20150406T000000,625000,3,2.5,2750,35000,2750,0
8651442810,20140710T000000,152000,3,1,920,4875,920,0
8564500020,20150127T000000,322000,3,1,960,10181,960,0
3019300050,20140731T000000,445000,3,1.75,1120,4000,870,250
2460900020,20140730T000000,595000,3,1,1560,3960,1560,0
2698200010,20150513T000000,165000,3,1,1380,7334,980,400
104560010,20140610T000000,278500,4,2.5,1940,6206,1940,0
5710610430,20150313T000000,517500,3,1.75,1810,10625,1370,440
34000005,20140618T000000,343566,2,1,1100,4200,1100,0
7349400420,20141105T000000,286285,4,2.25,1980,9714,1170,810
3298300130,20150206T000000,474905,4,1.5,1340,6200,1340,0
7312400080,20140714T000000,550000,3,1.75,1680,4800,1400,280
3356404198,20150129T000000,286000,4,2.5,2060,16000,2060,0
2344300122,20140808T000000,900000,3,3.25,2620,7215,1770,850
3904901330,20140820T000000,449950,3,2.25,1610,5159,1610,0
7524100280,20140612T000000,259000,4,1.5,1490,7560,1490,0
2473390440,20141202T000000,340000,3,2.25,1900,8125,1540,360
2215800050,20150415T000000,785000,4,2.5,3440,56192,3440,0
2769602475,20140509T000000,490000,2,1,1840,3300,1130,710
9183700470,20140527T000000,344950,4,2,2330,6250,1400,930
1337800284,20140827T000000,950000,3,2,2250,2975,1880,370
3867400130,20140709T000000,810000,4,1.75,2000,3988,1000,1000
7856410020,20150309T000000,998160,2,2.5,3010,16050,1260,1750
9477730080,20141210T000000,377000,3,1.75,1680,7389,1150,530
3300760020,20140826T000000,595000,3,2,1530,6773,1530,0
148000440,20140818T000000,313300,2,1,970,4800,970,0
1708400595,20140725T000000,360000,5,1.75,1550,5225,1550,0
9264901680,20150323T000000,188000,3,1.75,1660,7350,1660,0
3226079091,20140912T000000,755000,3,2.5,3680,203860,3680,0
2877104175,20140910T000000,1.29E+06,5,3.5,3210,4060,2290,920
8843900396,20140714T000000,455000,3,1,1480,13280,1480,0
1425059193,20141009T000000,817500,5,3.5,3600,9312,2680,920
5694000768,20140922T000000,550000,3,2.25,1700,1481,1700,0
8732190460,20150505T000000,260000,3,1.75,1680,8725,1240,440
723099028,20140626T000000,320000,3,2,1550,34175,1550,0
4139480190,20140916T000000,1.15E+06,3,3.25,3780,10623,2650,1130
1133000050,20150420T000000,362000,4,2.5,2360,7370,1460,900
2770601462,20150423T000000,503500,3,2.5,1810,1750,1350,460
3630120480,20140602T000000,653000,3,2.5,2290,3475,2290,0
624110050,20140604T000000,760000,4,2.75,3370,12447,3370,0
2301400655,20141125T000000,775000,4,1.75,2090,5050,1090,1000
7936500190,20141021T000000,1.34E+06,4,3.75,2130,34689,2130,0
126039323,20150224T000000,417500,5,1.75,2060,10911,1360,700
9512500460,20140711T000000,525000,3,1.5,1560,9350,1220,340
7203601405,20150414T000000,217000,2,1,730,2400,730,0
6204200170,20140709T000000,525000,4,2.75,2910,6308,1640,1270
5027800190,20150324T000000,442500,4,2.25,2490,8700,1890,600
2206500430,20140709T000000,525000,4,1.75,1710,10440,1710,0
9477001410,20150225T000000,425500,4,1.75,1520,10630,1520,0
2324079073,20140815T000000,710000,3,2.75,2930,218235,2930,0
2817210420,20141114T000000,545000,4,3,3160,10948,1930,1230
1402200440,20150212T000000,410000,5,2.75,2910,16410,2910,0
1545808370,20150422T000000,245000,3,2.25,1700,8100,1200,500
7335400500,20140711T000000,194900,2,1,810,6697,810,0
1843130980,20140506T000000,284000,4,2.5,2000,5390,2000,0
9262800255,20140819T000000,280000,2,1.75,1894,52769,1520,374
8656800190,20141002T000000,280000,3,1.75,2080,87991,1040,1040
2113700235,20140512T000000,360000,4,2,1730,5500,1010,720
4235400255,20140905T000000,405000,2,1,720,4323,720,0
8691360380,20150414T000000,865000,4,2.5,3560,13981,3560,0
2205500080,20140610T000000,483300,4,2,1210,11100,1210,0
4137000250,20150318T000000,355000,4,2.5,2130,9268,2130,0
2310010050,20150430T000000,274950,3,2.25,1570,8767,1180,390
1370802115,20141205T000000,1.93E+06,3,4.5,3950,6134,2880,1070
6117900010,20141231T000000,755000,3,3.25,3450,15586,2690,760
2626069030,20150209T000000,1.94E+06,4,5.75,7220,223462,6220,1000
9407102360,20140616T000000,309212,3,1.75,1150,9600,1150,0
104510440,20140604T000000,219950,3,2.25,1500,7615,1150,350
7519000170,20140723T000000,690000,3,2.5,1300,5150,1300,0
2113700500,20141005T000000,250800,3,1.75,1290,4000,1170,120
1560930050,20150325T000000,557500,3,2,2510,35255,2510,0
9550204590,20140624T000000,941000,4,1.75,2320,3825,1820,500
4217402115,20150421T000000,3.65E+06,6,4.75,5480,19401,3910,1570
9412710440,20150422T000000,305000,4,2.75,2030,8600,1230,800
6043400006,20140729T000000,815000,4,1.5,2060,16110,2060,0
1024039049,20140512T000000,1.02E+06,3,2.5,2920,34527,1800,1120
1250204835,20140908T000000,1.24E+06,4,3,3330,6990,2330,1000
6388920460,20141226T000000,535000,3,2.5,2110,8164,2110,0
1925059049,20140721T000000,775000,3,1,1175,10454,1175,0
7760400420,20140718T000000,255000,3,2,1590,8670,1590,0
6163901271,20140811T000000,327000,2,1,1070,9750,1070,0
5437200050,20141120T000000,560000,4,2,2720,8819,2240,480
3885806565,20150130T000000,1.34E+06,4,3.5,2980,6349,2980,0
8651443190,20141204T000000,199500,3,1.75,1160,5200,1160,0
1722069145,20141223T000000,760000,4,2.5,3580,97574,3580,0
7883605985,20150330T000000,439000,3,2.25,3020,6000,1980,1040
4038700190,20140930T000000,527000,4,2.25,2380,5250,1410,970
8661000089,20140716T000000,199950,3,2.75,2270,13590,1300,970
2329800430,20150204T000000,254000,3,2.25,1660,8188,1660,0
6431500280,20150323T000000,393000,2,1,830,5000,830,0
6204430250,20141121T000000,585000,5,2.25,2480,12614,1860,620
4365200630,20140716T000000,450000,2,2,1900,7740,1150,750
3630120050,20140625T000000,565000,2,1.75,1670,4008,1670,0
7844200050,20140522T000000,330000,5,2.25,2000,7900,1300,700
1240700006,20150511T000000,870000,3,2,2320,65340,2320,0
8563000470,20140723T000000,585000,4,2.5,1860,8117,1460,400
3221069091,20141106T000000,500000,3,2.5,2110,208737,2110,0
8645530010,20140515T000000,225000,3,2,1400,7384,1150,250
8645530010,20150325T000000,295000,3,2,1400,7384,1150,250
2141300420,20140626T000000,775000,3,2.75,2850,14800,1920,930
9407101900,20140717T000000,280000,3,1,1370,11050,1370,0
1931300425,20140908T000000,539000,3,2.5,2170,3200,1280,890
9290800050,20150324T000000,567500,3,1.75,2570,14033,2570,0
9421500010,20150205T000000,442500,4,2.25,1970,7902,1310,660
3333500151,20150507T000000,598200,5,3.75,2980,4635,2980,0
3759500006,20141014T000000,610000,4,2.5,2300,10843,2300,0
4221270290,20141121T000000,544900,3,2.5,1990,4936,1990,0
1775801405,20141216T000000,557500,4,2.5,2390,38258,2390,0
3575302575,20140811T000000,532500,3,2.5,2160,7500,1430,730
2581300010,20140609T000000,1.35E+06,4,3.25,3300,15907,3300,0
8805900080,20150430T000000,750000,3,2,1840,2825,1040,800
8121200460,20141119T000000,530000,3,2.5,2030,10958,2030,0
2461900609,20140717T000000,346100,3,2.5,1400,2036,1400,0
3298600440,20140810T000000,260000,4,2.25,2320,16800,2320,0
643300010,20140829T000000,365000,3,1.75,1410,9150,1410,0
224069102,20140908T000000,615000,3,2,1860,42800,930,930
8856960050,20140724T000000,318400,4,2.5,1820,6916,1820,0
4024101478,20150303T000000,498500,4,2.5,1910,7172,1910,0
1839910470,20150408T000000,450000,3,1.75,1540,7490,1540,0
3668000670,20150327T000000,200000,3,2,1430,7905,1430,0
1274500420,20140909T000000,234000,3,1,1010,8906,1010,0
8151600470,20140804T000000,121800,2,1,940,8384,940,0
56000095,20140626T000000,805000,3,2.75,2600,5875,1600,1000
3432500980,20140708T000000,410000,4,2.25,2060,7283,1220,840
7940700050,20150218T000000,475000,3,2.5,1920,4534,1920,0
1025039292,20141030T000000,1.34E+06,4,2.5,2900,21074,2900,0
3438503140,20140918T000000,269000,1,1,1020,7920,1020,0
7558750190,20140724T000000,573000,4,2.25,2150,9520,2150,0
3395040440,20150327T000000,330000,3,2.5,1660,2890,1660,0
4338800190,20140626T000000,252750,4,1,1230,7410,1230,0
8682290670,20150406T000000,745000,2,2.5,2170,7546,2170,0
5113260430,20150304T000000,280000,3,2,1280,7633,1280,0
387000190,20150430T000000,535000,4,2.5,2240,6920,1380,860
6844703135,20150312T000000,580000,4,1.5,1780,5100,1320,460
8899000190,20141212T000000,301000,3,1.75,1840,7200,1220,620
3275760190,20140624T000000,600000,4,1.75,1740,7700,1740,0
3438500924,20140811T000000,538900,5,3,3040,6604,3040,0
5104530430,20150209T000000,366000,3,2.5,2370,4375,2370,0
5468770250,20140819T000000,303000,4,2.5,2100,6783,2100,0
4318200440,20140522T000000,432000,3,2.25,1470,1578,1090,380
1721800190,20150409T000000,300000,2,1.5,1300,6120,820,480
1250202285,20141020T000000,908800,3,3,3420,7826,2430,990
2767602945,20140625T000000,500000,3,1.5,1190,4750,970,220
321049090,20140626T000000,254000,5,2,2080,16117,1740,340
4443801495,20140917T000000,470000,5,1.5,2180,4268,1340,840
3275750290,20150317T000000,480000,3,2,1460,7860,1460,0
2273600460,20150130T000000,536000,3,1.75,1530,8503,1150,380
8562720420,20150430T000000,1.35E+06,4,3.5,4740,8611,3640,1100
1330900250,20140515T000000,550000,3,2.25,1980,40887,1980,0
1099600250,20141202T000000,260000,3,1.75,1710,6400,1240,470
1445200190,20150424T000000,284900,2,1.5,1160,982,890,270
1929300052,20141029T000000,740000,3,2.5,2200,3000,1530,670
7626200280,20141002T000000,425000,2,1,1170,5000,1030,140
7211402115,20140902T000000,230000,3,1,1120,7500,1120,0
324000280,20150413T000000,675000,3,1.5,1710,4000,1710,0
8091410080,20140729T000000,267500,3,1.75,1650,7807,1650,0
6616000010,20140825T000000,814000,4,2.5,2840,8820,1420,1420
1125069102,20150427T000000,1.25E+06,4,3,3310,217800,3310,0
6413600151,20140916T000000,460000,3,2,1860,7232,1320,540
2607720420,20150120T000000,445000,3,2.5,2250,9608,2250,0
1854900470,20140924T000000,715000,3,2.5,2890,7027,2890,0
8901000911,20150219T000000,425000,3,1.75,2120,5992,1060,1060
3709600190,20140715T000000,370000,4,2.5,2130,4750,2130,0
537000255,20150429T000000,302000,2,1.75,1170,8200,780,390
4036800170,20140623T000000,453000,4,1.75,2120,7420,1060,1060
5127100190,20140520T000000,290000,3,1.75,1280,10716,1280,0
1762600190,20141229T000000,1.04E+06,4,2.5,3170,47502,3170,0
7796100080,20140520T000000,925000,4,2.25,2260,41984,2260,0
9465910190,20140529T000000,600000,3,1.75,2930,19876,2030,900
9284801845,20140805T000000,354000,3,1.5,1060,5750,1060,0
3210200373,20140617T000000,204950,4,1.75,1740,9344,1180,560
1854900430,20150422T000000,675000,4,2.5,2990,5400,2990,0
2944000050,20150422T000000,995000,4,3.25,3530,20012,3530,0
7971300020,20150331T000000,800000,5,2,2960,10960,1500,1460
1542800010,20140909T000000,472500,3,2.5,1650,3711,1650,0
1433500050,20141202T000000,549950,4,2.5,2720,13500,1510,1210
9482700080,20141013T000000,575575,3,1.75,1516,2897,998,518
3303870050,20150303T000000,545000,4,3.25,4386,12275,2356,2030
2071700010,20141119T000000,340000,3,2.25,2580,7434,1630,950
421000430,20150331T000000,225000,3,1,960,5512,960,0
2787460430,20141028T000000,299950,2,1.75,1460,10506,1460,0
2436200185,20150223T000000,829900,4,3.5,3840,4000,2640,1200
9542830440,20150330T000000,340000,4,2.5,2090,4200,2090,0
23500190,20141008T000000,515000,4,2.25,2470,7800,1470,1000
3905030190,20140711T000000,601000,4,2.5,2090,6906,2090,0
8079050010,20150504T000000,470000,3,2.5,2070,8581,2070,0
3172600095,20140708T000000,371500,3,1,1650,6400,980,670
126059242,20141119T000000,550000,3,1.75,1880,45738,1410,470
2944510080,20141214T000000,242550,4,2.5,2060,7720,2060,0
7019000050,20140506T000000,367500,3,1.5,1410,9647,1410,0
7212680460,20140924T000000,359000,4,3.5,2770,8763,2100,670
5706600170,20150311T000000,204900,3,2,1390,8245,1390,0
3322049005,20140930T000000,850000,4,2.75,5440,239580,2720,2720
7338000950,20141021T000000,187000,3,1.5,1280,4452,1280,0
3323059027,20140528T000000,326000,3,2.75,1720,28000,1720,0
3323059027,20150225T000000,340000,3,2.75,1720,28000,1720,0
5502700005,20140625T000000,330000,6,2.25,3040,28535,1890,1150
7205930050,20150102T000000,782000,4,3.5,3780,7769,3110,670
1853200190,20141103T000000,612000,4,2.5,2670,5974,2670,0
2697400020,20141031T000000,400000,3,2,1350,7216,1350,0
226039316,20140603T000000,941500,5,3.5,3490,9680,2460,1030
3126049439,20150109T000000,313000,2,1.5,870,747,800,70
3491300052,20150409T000000,735000,4,2.25,2410,4250,1460,950
6662410020,20150319T000000,471000,3,1.75,1640,10123,1340,300
6139100086,20150224T000000,350000,3,1,1540,9800,1540,0
5710610670,20140723T000000,530000,4,2.5,2370,9601,1570,800
7503000020,20140507T000000,415000,4,3,1830,9548,1830,0
1795920440,20140621T000000,639500,4,2.25,2330,8994,2330,0
3570000130,20140611T000000,580379,4,2.75,2240,27820,2240,0
7853340430,20141119T000000,378000,2,2.5,1700,2513,1700,0
2473380010,20150115T000000,265000,3,2.25,1750,9298,1410,340
3306300630,20140924T000000,212000,3,1.75,1100,9750,1100,0
3222049120,20150123T000000,400000,4,3,2320,13068,2320,0
2425059173,20150206T000000,750000,4,2.5,2540,6491,2540,0
1196000007,20140505T000000,384900,5,2.5,3090,12750,1750,1340
8651402910,20140806T000000,176000,2,1,770,5200,770,0
3558000130,20140909T000000,350000,3,2.75,2370,4632,2370,0
3830210020,20140729T000000,168000,3,1,1200,7210,1200,0
7950302210,20141114T000000,358000,4,2,2200,3060,1100,1100
1774200190,20150428T000000,580000,3,2.75,2660,32757,2660,0
3715500170,20140623T000000,442500,3,1.75,1600,10280,1050,550
2436700655,20150317T000000,515000,2,2.5,1330,1249,1330,0
5072100095,20141117T000000,554000,5,2.5,3440,12900,1720,1720
305000170,20140610T000000,659000,3,2.5,2510,6320,2510,0
2570300130,20150317T000000,414999,4,2.5,2150,10098,1090,1060
776600130,20140502T000000,275000,3,1.5,1180,10277,1180,0
5379802181,20141119T000000,193000,2,1,680,8640,680,0
9558020380,20140820T000000,525000,4,2.5,2840,4750,2840,0
3396830020,20141009T000000,424000,3,2.5,1820,7500,1820,0
7519001825,20150108T000000,455000,2,1,1070,5150,870,200
2324039069,20140822T000000,463000,2,1,1250,5650,1250,0
1245500950,20150504T000000,1.10E+06,4,2.5,2190,6300,1240,950
5100404030,20141208T000000,523000,3,1.75,3000,5413,1900,1100
9542000050,20140808T000000,615000,4,1.75,2270,9830,2270,0
5608000630,20141103T000000,1.52E+06,4,4,4500,11795,4500,0
475001235,20140808T000000,870000,5,4,3400,5000,2320,1080
2725069150,20140817T000000,710000,3,2.5,2830,9680,2830,0
9202000080,20140707T000000,215000,3,1,960,9563,960,0
225039049,20140908T000000,590000,2,1,1530,6450,1530,0
2212500430,20140814T000000,323000,5,2.5,2500,13034,1300,1200
2473100010,20140722T000000,279000,4,2,1560,7569,1560,0
2795000080,20140919T000000,535100,3,2.25,2070,7207,1720,350
9541800010,20141027T000000,830000,5,2.25,2710,19800,1910,800
2619920010,20140703T000000,815000,4,2.5,3150,4203,3150,0
4046400010,20150309T000000,535900,3,2.25,1880,10880,1480,400
7642200095,20150309T000000,230000,3,1,1250,8800,1250,0
8899000430,20150217T000000,325500,4,1.75,2290,8142,1490,800
8944750480,20150130T000000,359000,3,2.25,1990,4331,1990,0
7852020660,20140509T000000,505000,3,2.5,2100,5824,2100,0
7789000080,20140930T000000,253905,3,1,940,8400,940,0
6413100122,20140711T000000,369950,3,1.75,1640,4860,1200,440
8856960280,20150121T000000,350000,3,2.25,1860,8378,1860,0
1868901190,20140807T000000,650000,4,2.25,2100,2500,2100,0
3123039136,20140825T000000,295000,3,1.75,1500,15246,1500,0
3585300415,20150507T000000,620000,3,1.75,1680,28046,1180,500
2624089007,20150320T000000,2.00E+06,2,2.5,3900,920423,3900,0
4338800170,20140507T000000,246000,3,1,1400,7410,1400,0
4046501300,20140916T000000,430000,3,2.75,2600,12860,1350,1250
3331001995,20150123T000000,509990,3,2,1440,4859,1440,0
802000130,20141209T000000,490000,4,1.75,1870,9500,1090,780
2011400779,20141202T000000,385000,4,2.75,2960,10454,2360,600
8651610660,20150429T000000,769000,4,2.5,2440,6733,2440,0
1788900380,20150212T000000,185000,2,1,1122,9100,1122,0
2121000250,20140509T000000,303500,3,1.5,1060,10464,1060,0
2110900050,20150211T000000,468000,4,2.5,2150,8165,1430,720
5469503280,20140721T000000,449950,4,2.5,3100,10000,3100,0
6300000364,20140616T000000,235000,2,1.5,880,1805,880,0
2616800050,20141202T000000,520000,4,2.5,2490,34947,2150,340
1446400648,20141106T000000,203000,2,1,1080,9067,1080,0
4038700380,20140826T000000,657000,5,2.5,2530,10190,1290,1240
9109000050,20140709T000000,275000,3,1,1200,7800,1200,0
9465910380,20141024T000000,540000,4,2.25,2850,7453,2850,0
1137400460,20140624T000000,455000,4,2.5,2950,4502,2950,0
2545700020,20141016T000000,458500,2,1.75,1160,6828,860,300
3260570290,20150424T000000,549900,4,3.5,3420,4751,3420,0
5652600185,20140502T000000,750000,3,1.75,2240,10578,1550,690
7347600507,20140623T000000,235000,4,1.75,1450,8891,1180,270
1545802850,20140911T000000,286000,4,2.5,1820,7930,1820,0
3126059027,20150318T000000,2.65E+06,4,3.5,4700,13730,3500,1200
8087800430,20150210T000000,602000,4,1.75,2430,14000,1580,850
9547200460,20140820T000000,640000,3,1.5,1960,4080,1960,0
3826501060,20141009T000000,267000,3,1.75,1440,10920,1440,0
5406500430,20150421T000000,712000,4,2.5,2730,4385,2730,0
5417600130,20141010T000000,244500,2,1,910,9000,910,0
5417600130,20150512T000000,301000,2,1,910,9000,910,0
2138700345,20140818T000000,990000,4,2.5,2430,6325,2020,410
5611500170,20150422T000000,739999,4,2.75,3350,6500,3350,0
5700002125,20140610T000000,480000,4,1.75,2320,4322,1140,1180
1473200170,20140729T000000,305000,3,2.5,1260,1622,1260,0
2922702965,20150115T000000,703300,3,2,1980,3525,1590,390
7895500290,20150330T000000,265000,4,1.5,1580,8468,1580,0
7338200170,20150422T000000,600000,4,2.5,2710,35009,2710,0
6929603769,20140721T000000,253000,3,1,1400,9750,1400,0
9429000170,20150326T000000,617950,4,2.5,2410,7950,2410,0
2114700190,20141212T000000,385000,4,3.25,1790,2460,1100,690
323049148,20141219T000000,319000,3,2,1640,9234,1060,580
4038700290,20150423T000000,696000,3,2.5,1670,8023,1170,500
9284802045,20140630T000000,345000,2,1,970,5750,970,0
3188100007,20141022T000000,380000,3,2.5,1610,1778,1610,0
1200019,20140508T000000,647500,4,1.75,2060,26036,1160,900
2616800480,20140925T000000,725000,3,2.5,3570,35271,3570,0
2310000380,20141219T000000,269950,3,1.75,1400,7735,1400,0
4054560170,20140611T000000,875000,4,2.5,3470,32109,3470,0
7972601900,20140530T000000,299950,3,1,1210,9525,1210,0
3391500050,20140703T000000,1.88E+06,4,3.25,3930,10929,3930,0
8132700190,20140602T000000,430000,2,1,990,4802,990,0
3904990430,20150129T000000,495000,5,2.5,2200,4942,2200,0
5469700052,20141113T000000,275000,3,1.5,1510,16200,1510,0
4006000509,20140916T000000,333000,3,1,1620,5040,1120,500
9269750460,20140519T000000,247000,3,2.25,1580,7941,1580,0
2721059173,20150309T000000,204555,3,1.75,1260,15000,1260,0
3981200660,20140715T000000,432000,3,2,2190,13673,2190,0
4012800050,20140521T000000,175000,3,1.75,1230,13056,1230,0
3275750050,20150320T000000,556300,4,2.5,2030,7140,1400,630
8572900275,20140625T000000,286000,2,1,780,3475,780,0
993000950,20140906T000000,320000,2,1.5,1110,1200,1110,0
426069099,20150420T000000,815000,3,2.5,2790,53143,2790,0
3276180020,20150327T000000,385000,4,1.75,1660,10757,1000,660
5700001640,20140508T000000,1.04E+06,4,1,3410,5000,2190,1220
9264940130,20141028T000000,350000,4,2.25,2390,13002,2390,0
7300400670,20140729T000000,277000,4,2.5,1850,5880,1850,0
4112100101,20150219T000000,415000,6,2,2500,5200,1250,1250
6163901381,20141204T000000,295000,3,1,1000,8320,1000,0
7603100020,20140805T000000,969000,4,2,2450,5000,2200,250
4302200415,20141104T000000,339888,4,1.75,1440,6144,720,720
3876760430,20140822T000000,269950,3,2.25,1660,7003,1660,0
3754501235,20141001T000000,1.19E+06,3,2.5,2510,4600,2510,0
8691330500,20141216T000000,780000,4,2.5,3090,12511,3090,0
8651401680,20150408T000000,198000,3,1,860,5185,860,0
8011100050,20150508T000000,350000,2,1,1220,28703,1220,0
3768000280,20141201T000000,350000,3,1,1010,7680,1010,0
1321710460,20141206T000000,319000,4,2.25,2390,7350,2390,0
8731981680,20140908T000000,311000,4,2.25,3340,8000,3340,0
7714000250,20141018T000000,394000,5,3.25,3620,4650,2790,830
1336800010,20140613T000000,1.34E+06,5,2.25,4200,5800,2910,1290
5442300807,20140624T000000,2.70E+06,5,2.75,3831,13800,3831,0
6190701112,20141125T000000,396000,3,1,1980,9540,1080,900
2680700280,20150402T000000,809000,4,1.75,1790,8372,1340,450
1025059181,20140722T000000,480000,3,2,1580,7400,1050,530
3856900005,20140909T000000,535000,6,1.75,2460,6000,1230,1230
4302700425,20150213T000000,425000,5,2.75,2110,5120,1870,240
6824100005,20140801T000000,408000,3,2.5,1470,1204,1470,0
3625600190,20150409T000000,1.26E+06,4,2.5,3510,13100,3510,0
7588700177,20150420T000000,310000,1,0.75,520,2885,520,0
3303950080,20141103T000000,292000,3,2.5,1950,7421,1950,0
985000950,20150227T000000,217000,2,1,770,9715,770,0
8011100005,20150127T000000,398500,4,2.5,2250,6064,2250,0
5316100980,20150326T000000,2.25E+06,3,3,4040,7200,3340,700
6819100345,20150325T000000,700000,4,1.75,2360,6000,1280,1080
3276930420,20140912T000000,585000,4,2.5,2330,45860,2330,0
6648900005,20141008T000000,399950,3,1,1720,8910,1720,0
6083000050,20140613T000000,235000,3,1.75,1900,8540,950,950
1180008315,20140715T000000,212000,3,1,1040,6800,1040,0
8651510380,20140821T000000,310000,3,2,2070,9195,1220,850
8651510380,20141216T000000,539000,3,2,2070,9195,1220,850
9826701794,20141205T000000,390000,3,3,1550,1608,1280,270
2790400380,20141201T000000,560000,3,2.5,2020,11935,2020,0
6979940050,20140916T000000,800000,5,2.5,3320,9024,3320,0
1727001300,20140609T000000,1.90E+06,4,3.25,4130,112521,4130,0
686100380,20141027T000000,472000,5,2,2030,9804,1110,920
4037400280,20140923T000000,502550,3,1.75,1770,7875,1170,600
8691400010,20150327T000000,830000,4,3.25,3330,7809,3330,0
1450300050,20140723T000000,224950,4,2.5,2260,9686,1520,740
4024101440,20140618T000000,375000,3,2.5,1950,6871,1950,0
624100010,20141208T000000,645000,3,2.5,2930,19900,2930,0
9523102580,20140523T000000,599000,3,2.75,1960,2500,1410,550
7429000130,20150509T000000,515000,4,2.5,2980,12534,2980,0
7335400345,20140528T000000,135000,2,1,780,6685,780,0
7215721330,20141023T000000,485000,3,2.5,1650,4218,1650,0
3117100130,20140714T000000,890000,3,3.25,4030,12765,2800,1230
2868900020,20150408T000000,215000,3,1,1010,10125,1010,0
5703500130,20141217T000000,299500,3,1,1190,9600,1190,0
3025059136,20140813T000000,800000,2,1,1050,8750,1050,0
6679000130,20150209T000000,275000,3,2.5,1560,4244,1560,0
4222500020,20150219T000000,256400,3,1.5,1490,7800,1010,480
3997500130,20150224T000000,310000,2,1,770,8149,770,0
9834201205,20150304T000000,385000,1,1,620,5100,620,0
806000020,20150310T000000,203000,3,1.5,1200,9120,1000,200
507100005,20150310T000000,285000,4,2,2120,6865,1060,1060
8635760480,20150127T000000,473975,3,2.5,2330,3610,2330,0
1328330190,20140714T000000,320000,3,1.75,2000,9760,1400,600
2919702040,20140612T000000,599000,5,2.75,2820,4608,1450,1370
3095000095,20140714T000000,580000,3,2,2040,4800,1020,1020
304100010,20141209T000000,269500,4,2.25,1700,7056,1700,0
617000089,20141117T000000,274000,2,1,820,6200,820,0
3582750280,20150326T000000,347000,2,1.75,1315,2162,1315,0
3438500430,20140521T000000,270000,3,1.75,1390,10905,860,530
8964800225,20150303T000000,1.43E+06,3,2,1890,12017,1890,0
2013801350,20150220T000000,220000,3,1.75,1460,7226,1460,0
1320069163,20150304T000000,243000,3,1,1480,15416,1480,0
7549800168,20140527T000000,457500,3,1.75,1840,4030,1050,790
3226049466,20141219T000000,340000,2,1.75,1880,7208,940,940
9822700285,20140918T000000,657500,4,1.5,1910,5000,1610,300
538000250,20150112T000000,332500,4,2.5,2220,4720,2220,0
5702450250,20140717T000000,340000,3,2,1410,10015,1410,0
8835900086,20140902T000000,350000,4,3,3380,16133,2330,1050
3333002302,20150213T000000,428000,4,2.5,1950,5602,1120,830
7787120500,20150504T000000,515055,4,2.5,2400,8320,2400,0
8563010420,20150204T000000,450000,3,1.75,1560,8968,1560,0
3361400190,20150226T000000,190000,3,1,1040,8910,1040,0
1024039001,20140717T000000,1.00E+06,4,2.75,3090,16538,2590,500
6806100420,20141119T000000,299000,3,2.5,1850,4600,1850,0
3204300225,20141103T000000,508000,2,1,1200,2500,1090,110
8857640420,20141001T000000,294000,4,2.25,2190,3746,2190,0
4443800130,20141024T000000,320000,2,1,1380,5820,1380,0
3449800290,20150406T000000,641000,5,2.75,3710,8674,3710,0
2426059071,20141021T000000,675000,3,2.5,2320,98445,1380,940
2618300190,20141224T000000,255000,3,1.5,1110,10296,1110,0
6181400920,20150430T000000,286651,3,2.5,1830,4997,1830,0
424069150,20150213T000000,607500,4,2.5,2460,45738,1650,810
856000255,20150203T000000,765000,3,1,1270,6500,1270,0
1841500050,20141020T000000,334950,4,1.75,1700,40973,1700,0
3226059071,20140819T000000,426000,3,1,1130,9147,1130,0
524059093,20140825T000000,775000,3,1.75,1640,18730,1640,0
1568100225,20141204T000000,343000,2,1.5,1040,8526,1040,0
4027700726,20140908T000000,470101,4,2.5,2320,7800,2320,0
5198600005,20150505T000000,195000,3,1.5,1200,7800,1200,0
7677300010,20150303T000000,772500,4,1,1720,4410,1720,0
7979900006,20140625T000000,450000,3,1.5,2330,11740,1330,1000
1102000527,20140902T000000,1.44E+06,4,3.75,4410,9231,4410,0
1115800440,20140918T000000,525000,4,1.75,1650,8560,1650,0
9407110680,20141008T000000,280000,3,1.5,1370,11400,1370,0
6084601060,20140718T000000,270000,3,2.5,1770,8640,1420,350
993001330,20140505T000000,406100,3,2.25,1410,1332,1410,0
2475200290,20141020T000000,332544,2,1.75,1710,4187,1710,0
5381000048,20150427T000000,110000,2,1,790,8250,790,0
5605000595,20141209T000000,685000,6,2.25,2770,5854,2120,650
1124000050,20140729T000000,461000,4,1,1260,8505,1260,0
3558900430,20150414T000000,615000,3,2.25,2300,8067,1300,1000
2708100130,20150503T000000,550000,2,1,1070,3000,870,200
1236300290,20141022T000000,1.06E+06,4,3.5,3850,8100,2430,1420
525069099,20141022T000000,685000,3,2.5,2320,219978,2320,0
3262300235,20141126T000000,1.56E+06,5,2.5,2870,16238,2870,0
5104510130,20140603T000000,312000,4,2.5,1830,5175,1830,0
7197350050,20140701T000000,507500,3,1.75,1990,9594,1190,800
2822049148,20140918T000000,217000,3,1,1110,9827,1110,0
7558300170,20141212T000000,439000,3,2.25,1830,13477,1170,660
7852190050,20140626T000000,620000,6,3.5,3600,6875,2740,860
1277000020,20140812T000000,915000,4,2.5,3210,8532,3210,0
567000660,20141204T000000,425000,4,2,1490,5300,1110,380
9214400396,20150227T000000,435000,2,1,990,5643,870,120
9406520290,20141229T000000,305000,3,2.25,1646,12414,1646,0
2112700895,20150326T000000,276000,2,1,720,4000,720,0
2474400250,20140630T000000,327500,3,2.25,2310,7200,2310,0
3889100029,20140617T000000,810000,3,2.5,2670,10481,2670,0
11501310,20141121T000000,715000,3,3.25,3060,9055,2460,600
5672000020,20140805T000000,272000,3,1.5,1380,11760,1380,0
6668900005,20150421T000000,266000,2,1,700,5559,700,0
2346800005,20150427T000000,543000,3,1.5,1710,8364,1710,0
2872900050,20141007T000000,400000,3,2.5,1450,8064,1450,0
4040600190,20140806T000000,509500,5,2.25,2060,9000,1320,740
7129301578,20140521T000000,495000,3,3.5,2380,6250,1670,710
3955900500,20150313T000000,424950,4,2.5,2760,5564,2760,0
7788400170,20140926T000000,230000,3,1,940,10875,940,0
3831000010,20140806T000000,235000,4,1.5,1760,6150,1760,0
3885803895,20150309T000000,763000,3,2,1360,8752,1360,0
3810000480,20140919T000000,350000,3,1.75,2010,6150,2010,0
6169901197,20141126T000000,900000,3,1.5,2160,2260,1620,540
6882520050,20141007T000000,250000,3,1,930,6060,930,0
2608300103,20150126T000000,225000,3,2.5,1020,2040,720,300
3530400080,20141226T000000,255000,2,2,1360,5433,1360,0
1099760470,20140604T000000,161700,4,1.75,1720,7200,1220,500
4327600010,20150202T000000,336000,3,3,1790,13350,1190,600
6150200005,20141023T000000,410500,3,1,1150,6800,1150,0
4019300480,20141111T000000,502700,4,3.5,2710,14016,2710,0
6855100010,20140923T000000,505000,3,2.5,2400,9601,1390,1010
5249801440,20141216T000000,250000,3,1,1660,7650,1350,310
5249801440,20150422T000000,570000,3,1,1660,7650,1350,310
7524350080,20150318T000000,349900,4,2.5,2290,8796,2290,0
1137800460,20141209T000000,465000,3,2.5,2870,25663,2870,0
587550280,20140530T000000,625000,4,3.25,4240,25639,3550,690
871001365,20150219T000000,655000,3,1.75,1800,5102,1170,630
1430800279,20150327T000000,469000,4,1.75,2960,11347,1570,1390
1226039130,20141009T000000,355000,3,2.25,1980,7200,1300,680
7254000050,20150224T000000,596000,3,2.5,1730,2631,1730,0
3530200020,20150402T000000,790000,4,2.5,3020,36893,3020,0
2386000020,20141008T000000,885000,4,2.25,4470,86225,4470,0
6738700225,20140912T000000,1.03E+06,4,3.25,2830,4000,1910,920
6821600005,20150403T000000,710000,4,1.75,2120,5400,1060,1060
3579000010,20140814T000000,428040,3,2.5,2150,9266,2150,0
9359100101,20150414T000000,1.37E+06,5,2.25,3510,13843,1850,1660
6819100122,20140605T000000,546000,2,1,970,3400,970,0
3908100020,20140803T000000,540000,4,1,1360,5766,1360,0
6392001950,20140908T000000,435000,3,2.5,1470,3000,930,540
2872900280,20150406T000000,540000,4,2.25,3040,10283,1430,1610
6437400101,20141113T000000,284000,2,1,860,7204,860,0
7227502155,20140714T000000,208000,2,1,820,5700,820,0
1115100169,20141203T000000,315000,3,1.75,1900,7076,1130,770
2919702705,20140731T000000,417500,2,1,1330,5510,850,480
7302000500,20140917T000000,345000,3,1.75,1240,38095,1240,0
6021503656,20140902T000000,375000,3,2.5,1330,1064,1330,0
8665200020,20140623T000000,389800,3,1.75,1880,12821,1880,0
3288301330,20150408T000000,475000,3,1.75,1890,7560,1430,460
2621700010,20140508T000000,569000,4,2.25,2250,41688,2250,0
1824079073,20150331T000000,985000,5,4.25,4650,108464,3260,1390
1954440080,20150129T000000,532000,3,2.5,1830,8022,1830,0
7452500285,20140811T000000,280000,2,1,720,5000,720,0
7937600380,20150217T000000,435000,4,2,1960,50112,1050,910
5153200651,20150316T000000,223000,3,1,1220,71191,1220,0
2323069022,20150115T000000,390000,2,1,1800,119790,1200,600
1328340380,20141027T000000,315000,3,1.75,1340,12800,880,460
2256500005,20141014T000000,612000,3,3,1740,3700,1740,0
9828200545,20140513T000000,591000,3,1.75,1680,2400,870,810
686450080,20140711T000000,800000,4,2.25,3220,8436,3220,0
2571900380,20150122T000000,225000,3,2,1610,8400,1610,0
1026069120,20140508T000000,589900,2,3,3160,66646,3160,0
3882320010,20141126T000000,565000,4,2.5,2520,13156,1520,1000
1377300020,20150219T000000,650000,3,1.5,2120,8448,1060,1060
1124000005,20140918T000000,499000,3,2.5,2090,8505,2090,0
1151100010,20140515T000000,280000,3,1,1330,20562,1330,0
7997200130,20150128T000000,649950,3,2.5,2420,7500,1210,1210
2419600005,20140709T000000,420000,3,1.75,1510,6360,1510,0
5727000010,20141215T000000,319990,4,2.5,2120,5293,2120,0
8656300080,20140812T000000,265000,3,2,1850,16535,1850,0
9517200290,20150223T000000,482000,3,1.75,2300,16474,1220,1080
3123049142,20140805T000000,452000,3,2.25,2600,14810,1490,1110
4139500080,20140718T000000,1.49E+06,4,4.25,5180,13077,4280,900
6150200280,20140821T000000,375000,2,1,1810,8527,1810,0
6021500840,20140703T000000,588000,5,3,2190,4900,1490,700
8691310420,20150424T000000,635000,4,2.5,2500,10215,2500,0
1402900380,20140703T000000,280500,4,2.5,1890,6962,1890,0
2345500010,20140925T000000,210500,2,1.75,2040,8600,1430,610
3279000460,20140926T000000,196500,3,2,1310,7000,1310,0
723000114,20140505T000000,1.40E+06,5,3.5,4010,8510,2850,1160
5145100080,20150206T000000,475000,3,1.75,1780,8033,1210,570
8078410280,20150504T000000,550000,3,2.5,1980,9061,1980,0
3885806105,20140521T000000,1.58E+06,3,3.25,3690,7200,3690,0
5702380780,20150422T000000,240000,3,1.75,1540,6687,1200,340
3826000280,20150429T000000,272000,3,1,1130,8100,1130,0
1421079007,20150324T000000,408506,3,2.75,2480,209199,1870,610
3702900185,20140818T000000,640000,3,2.5,2580,7500,2580,0
4136880460,20140514T000000,316000,4,2.5,2010,7226,2010,0
7885100005,20140820T000000,299000,4,2,2320,12000,1720,600
3037200010,20150305T000000,447500,2,2.25,1180,2090,1180,0
4309710250,20140505T000000,736500,4,2.5,3180,21904,3180,0
3401700185,20140728T000000,665000,4,2,2970,52567,2970,0
2141300080,20150424T000000,707000,5,2.5,3050,13212,1590,1460
3387800380,20140829T000000,215000,4,1.75,1630,8000,1630,0
2310000280,20141211T000000,275000,3,2.25,1620,6415,1620,0
1687900170,20150325T000000,648000,4,2.25,2170,8240,2170,0
8079000190,20141028T000000,415000,4,2.5,2150,8173,2150,0
1710400005,20141119T000000,690000,3,2,1770,1800,1770,0
2473420170,20140924T000000,320000,4,2.75,2110,13260,1290,820
1056200010,20140902T000000,750000,3,1.75,1590,8285,1590,0
263000359,20140630T000000,355000,3,2.25,1370,1524,1370,0
6624010170,20140508T000000,246000,3,1.75,1390,7399,1390,0
824059265,20141001T000000,1.16E+06,3,1.75,1640,10464,1640,0
2869100080,20140606T000000,744000,3,2.5,2670,12187,2670,0
203100440,20140911T000000,1.21E+06,3,3.75,5400,24740,5400,0
9542800290,20141210T000000,217000,3,2,1690,6750,1210,480
3342100780,20140709T000000,583000,3,2.5,2600,5100,2600,0
475000080,20141111T000000,515000,2,1.5,1400,5000,1150,250
1562100380,20150319T000000,594000,4,1.75,2140,8000,1410,730
3878900185,20141022T000000,303100,3,1.5,1640,5650,1640,0
6791100280,20141010T000000,430000,3,1.75,1720,15225,1020,700
1926059099,20141208T000000,708000,5,3.25,3060,11778,3060,0
2881700547,20140813T000000,221000,3,1,1150,7260,1150,0
3260800190,20150324T000000,325000,3,2.5,2000,7205,2000,0
2954400190,20140624T000000,1.30E+06,0,0,4810,28008,4810,0
7715600050,20150219T000000,385000,3,1.75,1560,5950,780,780
3158500460,20150327T000000,359500,3,2.5,2070,4689,2070,0
4027700797,20140807T000000,433000,3,2,1920,7200,1300,620
9161100460,20150323T000000,525000,2,1,1000,4950,800,200
8069000216,20140722T000000,356200,3,2,1690,10062,940,750
3401700255,20140729T000000,595000,4,2,3090,87120,1590,1500
4083306720,20140915T000000,560000,4,1.5,1790,3420,1020,770
6377200010,20141208T000000,2.18E+06,4,3,4750,21701,4750,0
2767601100,20141027T000000,513000,4,2,2090,4000,1480,610
2856100185,20140721T000000,365000,2,1,680,2550,680,0
3438500797,20140708T000000,368000,4,1.75,2100,11942,1030,1070
6738700275,20140625T000000,870000,4,2.75,2840,4000,1960,880
1761100190,20140724T000000,225000,3,2.25,1470,6808,1160,310
713500020,20150421T000000,1.39E+06,4,4.5,4490,24767,3800,690
5412310170,20140619T000000,177000,3,1.75,1150,8079,1150,0
7751800080,20150127T000000,465000,3,1.5,1460,9879,1460,0
1121000414,20140927T000000,750000,4,2.75,3150,6343,1810,1340
4239400920,20140922T000000,149000,3,1,1090,2800,1090,0
9408300380,20140609T000000,605000,3,2.5,2670,47480,2670,0
6865200095,20141024T000000,725000,3,2,2110,5800,1990,120
6669080010,20140922T000000,413900,4,2.25,1770,5236,1770,0
1446400670,20140731T000000,199950,3,1.5,1510,6600,1510,0
203100460,20140924T000000,400000,1,1,530,13679,530,0
9523102750,20140812T000000,870000,3,1.5,2420,5000,2200,220
8078570380,20140605T000000,292000,5,2.5,2490,7666,1490,1000
1423800080,20140512T000000,225000,3,1,990,8012,990,0
9259900010,20150316T000000,466750,4,2,1730,9139,1730,0
4223400050,20150323T000000,330000,2,1.5,1440,11954,1440,0
686400380,20141002T000000,770000,7,2.25,3260,8145,3260,0
1102001112,20150213T000000,802500,4,2.25,1950,7000,1450,500
241900020,20140718T000000,378800,5,2.5,2740,5400,2740,0
8691300380,20150501T000000,795000,3,2.75,2940,12487,2940,0
3426049132,20150422T000000,460000,3,2,1200,7320,1200,0
3904901190,20141219T000000,567000,3,2.5,2070,10908,2070,0
1789900080,20140722T000000,209950,3,1.75,1570,15570,1570,0
1021049022,20140520T000000,415000,2,1,1050,60113,1050,0
5634500179,20141215T000000,424500,4,1.5,1830,6985,1080,750
795002455,20150505T000000,261000,2,1,970,12500,970,0
6666860170,20140827T000000,365000,3,2.5,2200,9696,2200,0
9828200605,20150408T000000,631000,4,2,1930,3240,1930,0
853200010,20140701T000000,3.80E+06,5,5.5,7050,42840,4320,2730
4449800345,20141008T000000,584000,3,2.5,1790,3962,1790,0
2522029136,20140729T000000,310000,3,1.75,1560,82328,1560,0
1149900050,20150312T000000,717000,4,2.5,2780,7985,2780,0
6908200080,20140616T000000,667000,3,1.5,1720,8100,1720,0
3395800660,20141230T000000,190000,3,1,1640,8100,1040,600
9414610010,20140617T000000,430000,3,2,1730,9000,1370,360
5379805120,20150424T000000,213000,2,1,740,7380,740,0
1530900290,20141007T000000,475000,3,2.5,2280,3710,1550,730
8886000005,20150309T000000,649000,2,2.75,2090,23962,2090,0
8965400010,20140606T000000,715000,3,2.5,2550,13458,2550,0
8644210470,20150318T000000,845000,4,3.5,3350,19487,2460,890
1545805980,20141110T000000,390000,3,2.5,2770,8820,1900,870
2841500010,20140924T000000,390000,4,3,2860,5724,1730,1130
1328330290,20140729T000000,328000,4,1.75,1990,7194,1400,590
4222100280,20141205T000000,239999,3,2.75,1740,8436,1140,600
4222200280,20141021T000000,225000,3,2,1460,7740,1460,0
3224510290,20141016T000000,920000,3,1.75,3670,11884,1950,1720
5196420290,20150317T000000,940000,4,2.75,3270,9231,3270,0
1703900005,20150501T000000,465000,3,1,1210,4872,1210,0
3329530480,20140701T000000,241000,3,2,1770,7000,1770,0
1541700170,20140609T000000,307550,4,2.5,1980,5909,1980,0
8833510190,20141031T000000,490000,4,2.5,2650,9627,1610,1040
8961970190,20140512T000000,647000,4,2.5,3040,6887,3040,0
323069120,20140827T000000,780000,4,2.75,3640,231739,3640,0
8944360170,20141114T000000,517500,3,2.5,1810,4332,1810,0
2546500020,20140618T000000,295000,3,2,1380,8682,1380,0
1338801060,20141204T000000,560000,4,1.5,1810,3400,1810,0
3747600050,20141105T000000,319450,5,2,2250,5472,1750,500
327000050,20141212T000000,1.50E+06,4,3.25,3860,7199,2870,990
1898900280,20140919T000000,340000,4,3,2380,20277,1500,880
1423400005,20140815T000000,249950,3,1,1370,11658,1370,0
9521100585,20140613T000000,499950,3,1,1830,3000,1430,400
2025059150,20140702T000000,1.04E+06,4,1.75,1440,13296,1440,0
8941500010,20150216T000000,750000,4,2.5,2510,17200,1540,970
1425069071,20150323T000000,875000,4,2.5,3230,256132,3230,0
686400670,20150414T000000,678000,3,1.75,1670,7210,1670,0
2624049073,20140729T000000,360000,2,1,780,4200,780,0
1523059180,20140923T000000,354900,3,1,1720,16552,1720,0
8016300250,20140827T000000,632000,5,2.5,2260,10087,1520,740
7694600143,20141218T000000,350000,3,1.75,1480,9375,1480,0
269000950,20140730T000000,990000,3,4,2550,3900,2050,500
2724079090,20150105T000000,1.65E+06,4,3.25,3920,881654,3920,0
3342103369,20140707T000000,481000,4,2.5,2286,8269,2286,0
7104100050,20140624T000000,485000,3,2.5,1500,5412,900,600
8944360290,20150413T000000,477000,3,2.5,1740,4960,1740,0
6072500050,20140729T000000,560000,5,2.5,2880,9000,1440,1440
1066000290,20141117T000000,600000,6,3,2600,9350,1340,1260
2817260130,20140613T000000,622500,5,2.75,3320,23760,2190,1130
3582750170,20150429T000000,410000,2,2.25,1660,2128,1660,0
255370420,20150402T000000,318200,3,2.5,1990,3644,1990,0
2571910380,20140605T000000,289000,3,2,1680,8424,1680,0
3832150190,20140520T000000,263000,3,1.75,1570,7775,1570,0
5279100680,20140605T000000,240000,3,1,1150,4825,1150,0
7889601870,20150407T000000,281500,3,1,1270,7500,1270,0
5694001061,20140620T000000,587206,3,3.5,1890,1710,1640,250
1912100882,20140730T000000,482000,2,2.25,1350,1248,1180,170
8563020170,20150310T000000,485000,3,1.75,1650,9500,1650,0
8656800020,20150212T000000,309000,3,2.5,1450,11480,1450,0
3876540780,20140619T000000,221000,3,2.25,1640,7350,1140,500
8563030280,20140513T000000,700000,3,2.5,2030,8398,2030,0
2114300290,20140929T000000,411500,5,3,2420,7740,1360,1060
9141100005,20141028T000000,285000,4,3.5,2770,10505,2770,0
5727500019,20140605T000000,395000,4,3,1980,7931,1160,820
1796360080,20140709T000000,237950,2,1.75,1460,7926,1460,0
9485800050,20150310T000000,680000,3,2.5,1610,8064,1160,450
5560000680,20141226T000000,199950,2,1,1010,10057,1010,0
9297300480,20141212T000000,765000,4,3.5,2760,4000,2000,760
6813600415,20140508T000000,515000,2,1,1060,4960,1060,0
6751300255,20140616T000000,470000,3,1.5,1510,8000,1510,0
3300700480,20140820T000000,330000,2,1,880,4000,780,100
5379800446,20150226T000000,284000,3,2.5,2150,9375,1550,600
9558200080,20140912T000000,295000,3,2.5,1660,8125,1150,510
6817801150,20150330T000000,555000,4,2.5,2160,10987,1440,720
1454100005,20140806T000000,350000,3,1,1370,8162,1370,0
104540840,20141203T000000,240000,3,2.25,1460,5818,1140,320
2207100635,20150204T000000,419900,3,1.5,1450,7000,1450,0
2489200250,20150430T000000,528000,3,2,1560,6300,1560,0
5130000080,20150311T000000,481000,4,2.5,2480,9869,1240,1240
6150700169,20140609T000000,304700,2,1,740,5995,740,0
8691350130,20150204T000000,715000,4,2.5,2927,12171,2927,0
6189200345,20140820T000000,738950,4,2.75,2260,12005,2260,0
2222059099,20141022T000000,215000,3,1.5,1240,9405,1240,0
7227800660,20140522T000000,300000,6,2,2040,10812,2040,0
1148000005,20140623T000000,346000,3,1.75,1270,8100,880,390
6055000430,20150327T000000,473000,4,3.5,4370,37193,2780,1590
7616200050,20150105T000000,500000,3,1.75,1700,6120,1700,0
7234601440,20140925T000000,750000,2,1.5,1300,7632,1300,0
8563020380,20140520T000000,519900,4,2,1820,9350,1820,0
1454100480,20140819T000000,378500,2,1,880,6171,880,0
5151600285,20140507T000000,314500,3,1.75,1870,12381,1870,0
2155000480,20150429T000000,499950,3,1.5,1350,9315,1350,0
1024049024,20141203T000000,1.74E+06,5,3.5,4870,7700,3650,1220
1026069163,20150422T000000,630000,3,2.5,2460,38794,2460,0
4427100095,20140623T000000,360000,4,1.5,1720,6417,1720,0
4047200380,20140526T000000,460000,2,1.5,2730,19877,1570,1160
3222049024,20140522T000000,361000,3,1,1100,4046,1100,0
2287000010,20140710T000000,713400,3,2.25,1810,9845,1810,0
3692900010,20141028T000000,445000,2,1,930,3150,930,0
320069049,20140514T000000,305000,4,1.5,1590,131551,1590,0
868002335,20150304T000000,1.43E+06,3,2.75,2710,9204,1480,1230
8945100050,20150424T000000,222000,3,1,1460,8400,1460,0
7853250080,20150216T000000,510000,5,3.25,3400,4499,2740,660
6713700250,20140604T000000,500000,5,3,2920,11440,2920,0
4232901990,20140516T000000,605000,2,1,910,3600,910,0
3578401760,20140820T000000,393000,3,2,1320,10720,1320,0
9113200290,20140625T000000,725000,4,2.5,2490,5170,2490,0
5116000250,20140707T000000,320000,3,1.75,2220,11646,1270,950
1099600010,20140612T000000,210000,4,1.5,1130,7840,1130,0
5416500980,20140729T000000,419900,4,2.5,2750,5767,2750,0
7312100010,20150302T000000,410000,4,2.5,2240,4447,2240,0
7936000562,20141216T000000,721000,3,2.25,2680,10440,1540,1140
9839300545,20140714T000000,605000,2,2,1270,5500,1270,0
6837700005,20141203T000000,738000,3,1.75,1520,5500,1520,0
6918720080,20150402T000000,725000,6,3,2480,12000,2480,0
9407001700,20140819T000000,255000,2,1,960,20954,960,0
1473200130,20150320T000000,303000,3,2.25,1340,873,1340,0
4037200585,20140723T000000,394950,3,2.5,1090,7700,1090,0
5249803870,20140902T000000,530000,4,3,2240,5580,1830,410
9558050170,20140513T000000,475000,4,2.5,3740,8700,2260,1480
1545808110,20140617T000000,250000,4,2.5,1800,8100,1800,0
1604601155,20141208T000000,180000,3,1,780,3540,780,0
2754700170,20140804T000000,443500,2,1,1330,4140,930,400
3622059180,20140703T000000,390000,4,2,1900,76877,1900,0
7201600190,20150220T000000,430000,4,1.75,1570,7650,1100,470
3450300280,20150225T000000,460000,5,4.5,3100,7260,3100,0
1036450170,20150312T000000,660000,3,3.5,2740,3785,2190,550
8965000050,20140729T000000,515000,3,1.75,1570,10939,1200,370
4354700010,20150421T000000,482500,3,2,1330,6490,1330,0
4057300170,20140602T000000,305000,2,1.5,1140,2980,1140,0
4217400185,20140603T000000,835000,4,2.75,1550,4000,1550,0
8155750010,20141204T000000,237000,3,2,1290,7952,1290,0
2159900020,20141126T000000,445000,2,1.5,1510,2001,1510,0
2487700130,20150406T000000,710000,4,2.5,2720,8000,1360,1360
2085200545,20140821T000000,180000,3,1,840,5700,840,0
9432900380,20141023T000000,280017,3,2.5,1850,8770,1850,0
2591850080,20140630T000000,436500,4,2.5,2290,11173,2290,0
1025049174,20140515T000000,1.26E+06,4,2.5,3200,7535,3200,0
5628400080,20141218T000000,420000,3,2.25,1800,9800,1300,500
7657000225,20140719T000000,205000,3,1,860,7467,860,0
6151800080,20140902T000000,570000,3,1.5,1980,10203,1680,300
6154900095,20140711T000000,565000,4,1.75,2140,7102,1070,1070
9542800050,20141211T000000,287000,2,2.5,2410,7500,1550,860
526059224,20140923T000000,260000,4,1.75,1650,7276,1010,640
526059224,20150206T000000,470000,4,1.75,1650,7276,1010,640
3275850190,20140905T000000,700000,3,2.5,2410,9916,2410,0
4137000460,20150225T000000,249000,3,1.75,1520,7500,1520,0
7936000403,20140609T000000,568000,3,1.75,2050,3520,1070,980
1175000073,20140606T000000,500000,4,1,1720,4011,1720,0
8645540290,20141126T000000,358000,5,2.5,2390,8775,1270,1120
7137960460,20140528T000000,225000,3,2.5,1680,6755,1680,0
8805400010,20150226T000000,275500,3,1,1060,7246,1060,0
1036450290,20150202T000000,495000,3,2.5,1860,3150,1860,0
7613700660,20150326T000000,758800,5,2.25,1750,5000,960,790
8648210050,20150403T000000,280000,3,1.75,1480,8165,1480,0
1565950670,20150225T000000,380500,3,2.5,1900,7361,1900,0
7159200005,20140507T000000,3.20E+06,7,4.5,6210,8856,4760,1450
8687800010,20140617T000000,260000,3,1.75,1440,12888,1090,350
4242900285,20140805T000000,630000,4,2.5,1910,1502,1910,0
7834800225,20140820T000000,875000,3,2,2010,4000,1210,800
5649600225,20150403T000000,457500,3,1,960,4600,960,0
1959702045,20141119T000000,900000,2,1,1240,5500,1240,0
717000225,20141028T000000,235000,2,2,870,6450,740,130
792500190,20140627T000000,410000,3,2,1400,45738,1400,0
3820100284,20140827T000000,355000,3,3,1850,9600,1230,620
3629890190,20140606T000000,1.30E+06,4,4,4270,6002,3180,1090
6868200029,20140929T000000,467500,3,1.75,2260,8512,1130,1130
8901000143,20141125T000000,500000,4,4.5,2690,7350,2690,0
2927600630,20150416T000000,995000,4,3.5,2780,9550,2530,250
3432501315,20140827T000000,277000,3,1,1140,8144,1140,0
5101407250,20141217T000000,630000,4,2.25,2900,9680,1990,910
3999200780,20141121T000000,628000,5,2.75,2830,11795,1710,1120
2826079145,20140814T000000,655000,5,2.5,2560,46786,2560,0
1446403145,20150122T000000,170000,2,1,1240,9900,940,300
5137000170,20141217T000000,352500,4,2.5,2100,10750,2100,0
2896310420,20150219T000000,615000,4,2.75,3120,34040,3120,0
1446400725,20140610T000000,165000,3,1,970,6600,970,0
4030500130,20140923T000000,243500,4,2.5,2300,15188,2300,0
3319500299,20140806T000000,304000,2,1.5,950,676,850,100
7139800020,20141016T000000,369000,3,1.5,2110,5195,1210,900
9433000460,20141007T000000,779950,4,2.75,2990,4298,2990,0
1326049130,20140702T000000,605000,4,2.25,2940,48788,1520,1420
7137960440,20141223T000000,292500,4,2.5,1860,8709,1860,0
3946900010,20150323T000000,500007,2,1.75,1820,6050,910,910
5592050080,20150429T000000,449999,4,2.5,1950,4947,1950,0
3288020050,20140627T000000,355000,4,2.5,1890,7867,1890,0
2459000020,20141125T000000,258000,4,3,2710,7199,1710,1000
126049167,20140619T000000,380000,4,2.25,2150,20181,1090,1060
1525079069,20140708T000000,650000,4,3,3720,57499,1880,1840
1786200010,20150514T000000,456500,4,2.5,2580,11780,2580,0
5602000275,20140825T000000,259950,4,2,1540,10212,1540,0
1446403617,20140702T000000,123000,2,1,1050,6600,1050,0
2767603649,20140730T000000,520000,3,2.25,1210,1250,1210,0
3649100387,20150416T000000,506000,4,2.25,2040,12000,1300,740
5249802660,20140730T000000,425000,3,1,980,4800,980,0
2592400470,20141205T000000,438000,5,2.5,1990,6840,1990,0
6448000020,20150129T000000,1.49E+06,4,2.5,2420,18480,2420,0
1211000185,20140616T000000,375000,4,2,1240,3000,1040,200
7399300780,20150429T000000,337500,3,2.25,1530,6600,1240,290
984100010,20140930T000000,300000,4,2.25,2080,7700,1450,630
6127010670,20140728T000000,627000,5,3.25,3570,5425,3570,0
1245002391,20141022T000000,1.40E+06,5,4.25,4230,6907,3450,780
3904921100,20150512T000000,674725,4,2.5,2700,10160,2700,0
2473381150,20140618T000000,325000,3,2.75,2200,7000,1280,920
9269750010,20150402T000000,230000,5,2,1210,12538,1210,0
1924069071,20140729T000000,485000,5,1.75,2140,43124,1220,920
2571900430,20140923T000000,315000,4,2.5,2740,8400,2740,0
8673400052,20150403T000000,560000,3,2.75,1370,1193,1370,0
5104511630,20140812T000000,444000,4,3,2800,7198,2800,0
3438500168,20150507T000000,325000,3,1.5,1060,7488,1060,0
1446403850,20140916T000000,118125,2,1,790,7153,790,0
1446403850,20150114T000000,212000,2,1,790,7153,790,0
5416500950,20150309T000000,428900,4,2.5,2820,5056,2820,0
8096600050,20150123T000000,510000,3,2,1850,9600,1850,0
1473000020,20140523T000000,416000,3,1.5,1110,9762,1110,0
722039049,20141009T000000,950000,4,3,3230,438213,3230,0
2212210660,20150227T000000,204000,3,1.5,1460,7140,980,480
6762700020,20141013T000000,7.70E+06,6,8,12050,27600,8570,3480
5608010980,20141007T000000,878000,4,2.5,3480,13421,3480,0
5015001045,20140826T000000,1.05E+06,4,3,3560,4000,2970,590
1005000250,20150130T000000,350000,2,1,840,5551,840,0
7974700122,20140610T000000,659500,3,1.75,1820,5500,1620,200
1775910460,20150313T000000,395000,3,2.5,1630,15200,1120,510
3797300190,20140708T000000,308950,4,2.5,1920,8562,1920,0
6450300605,20150501T000000,410000,3,2,1750,2550,1750,0
3918400143,20141016T000000,710000,4,3,2750,7500,1630,1120
1022049182,20150428T000000,175000,1,1,620,8685,620,0
3578400780,20150327T000000,508800,3,2,1720,10098,1140,580
6905200050,20141009T000000,606400,3,3,1800,5000,1500,300
303100080,20140528T000000,245100,3,1.75,1300,7958,1300,0
123039642,20150501T000000,540000,3,2.5,1970,14876,1320,650
8718500095,20150507T000000,415000,3,1.5,1740,9046,1740,0
1774000780,20150105T000000,469500,4,2.75,1930,13041,1180,750
2421039075,20141106T000000,195000,3,1.75,1190,14777,1190,0
4139470010,20141006T000000,1.62E+06,4,3.25,4250,12281,3020,1230
629800380,20141013T000000,1.45E+06,4,3.5,4360,24603,4360,0
8965520190,20141030T000000,1.20E+06,3,2.5,3420,16622,2410,1010
925059193,20140709T000000,1.07E+06,4,3.75,4260,9800,4260,0
1245500250,20150507T000000,555500,2,1,920,10000,920,0
9828700005,20150512T000000,440000,3,1,1040,4000,1040,0
5101402312,20150423T000000,485000,3,1,1260,7250,960,300
339200130,20140531T000000,693000,3,2.5,2460,12028,2460,0
6145602125,20140724T000000,295000,3,1,830,3386,830,0
9346910500,20150330T000000,700000,3,2.5,2060,10650,1050,1010
7986401305,20141216T000000,767500,2,1.75,2210,9374,1560,650
922059169,20141201T000000,800000,6,4.25,5480,189050,5140,340
123059071,20140708T000000,440000,3,2,1860,217800,1860,0
1626069069,20141029T000000,600000,3,2.5,1350,187313,1350,0
5605000430,20140917T000000,1.16E+06,4,2.5,2790,5450,1930,860
7640400250,20140619T000000,506000,2,1,1570,8210,1150,420
4477000290,20150311T000000,474950,4,1.75,2030,15400,1130,900
8127700440,20141211T000000,654000,3,2.5,2570,5500,1320,1250
6822100780,20140911T000000,710000,2,1,1210,6000,1000,210
9195700380,20140811T000000,620000,4,2.25,1530,7845,1030,500
1425059174,20141028T000000,390000,3,2,1510,10827,1510,0
2155000290,20140630T000000,550000,3,2.25,1720,9600,1220,500
4058200630,20141002T000000,353000,3,1.75,2190,7021,1390,800
5561400440,20140827T000000,465000,4,2.5,3030,47958,1660,1370
4178500440,20150128T000000,279900,3,2,1410,6600,1410,0
1923039022,20141120T000000,700000,2,1.75,1679,577605,1679,0
9412200660,20140619T000000,395000,4,1,1980,10350,1430,550
2780700020,20140910T000000,375000,4,2.5,1900,9428,1900,0
1868901815,20140617T000000,547000,4,1,1720,2800,1200,520
4022902715,20150403T000000,525000,5,3.25,2480,10277,1640,840
225039145,20140619T000000,285000,3,1,1210,4731,1210,0
9274203390,20140520T000000,570000,2,1.75,1540,4025,1190,350
4397000020,20150324T000000,409000,3,2.5,2740,9168,2740,0
9415950020,20140608T000000,260000,4,2.5,1811,4381,1811,0
2591830020,20140916T000000,348000,4,2.5,2720,7697,2120,600
3211200460,20140806T000000,389000,4,1,1520,9800,1520,0
2297400250,20141217T000000,445000,4,2.75,2160,7200,1220,940
9268200440,20140721T000000,400000,3,1.75,1390,4602,930,460
255580190,20140915T000000,302000,4,2.5,1740,7895,1740,0
6352600680,20141021T000000,798000,3,2.5,2849,9588,2849,0
1829700050,20140724T000000,335000,2,1,1440,8842,840,600
7859960250,20150107T000000,585000,4,2.5,3000,6892,3000,0
6072800170,20150428T000000,2.50E+06,4,4,3330,24354,3330,0
6373000130,20141201T000000,555000,4,2.25,1720,2300,860,860
4131900066,20140825T000000,3.10E+06,3,3,3920,13085,3920,0
8965450190,20150218T000000,295000,3,2.5,1500,3060,1500,0
1311200460,20140618T000000,265000,4,1.5,2050,7100,1050,1000
3764800250,20150105T000000,330000,4,2,1180,7275,1180,0
6607000095,20150218T000000,286000,4,1.5,1600,5750,1600,0
4358700188,20150331T000000,305000,3,2.5,1260,895,1160,100
5101403915,20150403T000000,970000,2,1,1290,5376,1290,0
7844200425,20150414T000000,525000,4,2,2680,14157,1460,1220
9407001330,20141202T000000,355000,3,1.75,2370,9750,1280,1090
7905370440,20141010T000000,469950,5,2.5,2310,8303,1300,1010
2202500290,20140502T000000,435000,4,1,1450,8800,1450,0
3374500250,20140922T000000,363500,4,2.5,2680,7700,2680,0
5244800895,20140523T000000,595000,2,1.5,1030,4500,830,200
100100050,20141112T000000,275000,3,1,1320,11090,1320,0
7454001060,20150408T000000,295000,2,1,670,7952,670,0
7215400280,20150116T000000,345000,3,2.25,2670,37089,2670,0
203101330,20140701T000000,485000,3,2.25,2440,47916,2090,350
2450000290,20141215T000000,1.25E+06,5,2.5,3370,8113,3370,0
5101402472,20150129T000000,340500,2,1,940,5413,940,0
4310700020,20141010T000000,280000,3,1,1100,5132,840,260
7967600285,20141211T000000,449888,3,2.25,2520,78408,2520,0
7905200381,20141028T000000,483000,2,1.75,1400,4720,820,580
3992700585,20141120T000000,445500,3,1.75,1880,9360,940,940
7972601950,20140617T000000,379900,5,3.5,2800,7350,2800,0
6870310010,20140702T000000,599950,4,3.5,2500,3080,1810,690
2970800130,20141009T000000,215000,3,1,810,5240,810,0
6084600660,20140718T000000,263000,3,2.5,1720,6847,1720,0
325059126,20150209T000000,565000,4,1,2170,12100,2170,0
526069024,20140512T000000,950000,5,3,4530,258746,3200,1330
6163901261,20140909T000000,395000,4,1,1440,8320,1440,0
4289900005,20141230T000000,1.54E+06,4,3.25,2850,4100,1820,1030
2818100255,20141029T000000,922000,4,2.5,2620,14126,1620,1000
1389310130,20141212T000000,330000,3,2.5,1676,18778,1676,0
4139910250,20150210T000000,1.53E+06,4,3.75,5850,35070,4410,1440
5416100020,20141209T000000,323000,3,1.75,1910,8329,1910,0
8682261650,20140710T000000,554000,2,2,1670,4996,1670,0
8100400170,20150410T000000,500000,3,2,2050,11454,2050,0
1604590190,20150513T000000,775000,5,3.5,3730,16679,2760,970
6882510020,20140715T000000,340000,4,1.75,1800,5210,1080,720
3459800020,20150406T000000,560000,4,1.75,2230,6838,1320,910
5437600010,20150406T000000,304000,3,2.5,1670,5298,1670,0
1395500020,20141107T000000,279900,3,1,1400,10800,1400,0
807800020,20150304T000000,315000,5,3,2110,10766,2110,0
1563102880,20140621T000000,849000,4,2,2160,6300,2160,0
8937500020,20150210T000000,325000,3,1.75,2420,14862,1380,1040
629420480,20140926T000000,786000,4,3.5,3320,8808,3320,0
8961950250,20140915T000000,384000,5,2.75,3220,8160,3220,0
4217400420,20141124T000000,907000,3,1.5,1340,6000,1340,0
3121500020,20140702T000000,700000,3,2.5,2490,23891,2490,0
2025700430,20140826T000000,269500,3,2,1640,8395,1640,0
739800250,20150222T000000,269000,3,2.25,1420,7297,1130,290
8647600020,20141111T000000,749950,4,2.5,3340,123600,3340,0
1518000290,20150316T000000,325000,3,2.75,1580,4007,1580,0
8917100020,20140606T000000,1.15E+06,3,1.5,2170,16600,1130,1040
3205100010,20141216T000000,406000,3,1.5,1370,7853,1370,0
2405500050,20140606T000000,650000,4,2.5,2840,9354,2840,0
7823700005,20140707T000000,295000,3,1.75,1940,7500,1940,0
8642600170,20141009T000000,375000,4,2,1757,19370,1757,0
7518502960,20150227T000000,395000,2,1,980,5100,980,0
4279600080,20141231T000000,609000,6,3,2470,9267,2470,0
6421100592,20140910T000000,510000,3,1.75,1610,11950,1210,400
7967200290,20140530T000000,190000,3,2.25,1590,11745,1090,500
7228501903,20140805T000000,250000,1,1,780,1033,780,0
9275200080,20141107T000000,295000,3,1.5,720,7450,720,0
8825900095,20150421T000000,740000,3,1.5,1630,4080,1630,0
7849201100,20150217T000000,323000,3,1,1590,7759,1590,0
8562790980,20150303T000000,713000,3,2.75,2310,1850,2020,290
1370801435,20141105T000000,1.07E+06,3,1.75,2320,6090,2040,280
3897100275,20141027T000000,460000,3,1.75,1660,9900,1660,0
6745700190,20150407T000000,880000,3,1.75,2070,5000,2070,0
2770600795,20150302T000000,585000,4,1.75,2500,7000,1250,1250
1148000190,20140522T000000,249950,2,1,940,8532,940,0
5039300305,20141107T000000,450000,3,2.5,1990,3478,1520,470
3981200250,20140926T000000,450000,3,2.5,2620,14096,2620,0
5457300095,20150107T000000,1.78E+06,4,3.25,3730,7071,3730,0
1862400479,20140923T000000,350000,3,3.25,1600,1298,1600,0
8669160010,20150325T000000,292500,3,2.5,2095,3438,2095,0
2481630290,20140626T000000,879000,4,2.75,4230,31747,4230,0
8925100255,20140612T000000,1.18E+06,4,2.5,3200,7500,1860,1340
424069130,20150213T000000,584999,4,2.75,2050,17859,1300,750
2231800020,20141120T000000,366000,4,2.75,2020,8093,1300,720
3625700080,20150108T000000,987500,4,2.25,3270,15760,2000,1270
3343901188,20150323T000000,300000,3,1,1320,7200,1320,0
1328330430,20150408T000000,299000,2,1.75,1270,7800,890,380
2464400500,20140714T000000,560000,4,1.75,1980,2700,1210,770
4054710190,20140701T000000,695000,3,2.5,2620,51354,2620,0
5095400630,20141205T000000,360000,4,1.75,1750,18810,1220,530
1788300020,20140708T000000,183500,3,1,1040,8892,800,240
3336001470,20140619T000000,311000,3,1.75,1900,3000,1070,830
1310960190,20141021T000000,263000,3,1.75,1660,7210,1660,0
1545803340,20150224T000000,269000,3,1.75,1530,7930,1530,0
524059148,20140606T000000,1.60E+06,4,3.5,4280,9583,4280,0
7852190290,20150303T000000,564000,4,2.5,2870,6658,2870,0
2385200050,20140620T000000,425000,3,2.5,2540,5612,2540,0
8827901060,20140709T000000,679000,4,2.75,2100,4480,1780,320
6456200020,20140826T000000,410000,3,2,1740,9300,1740,0
4166800080,20141020T000000,340000,4,2.5,2441,7316,2441,0
1591600307,20150511T000000,360000,3,1.75,1810,7200,1030,780
926069132,20140520T000000,450000,3,1.5,2060,44866,2060,0
7130300170,20150326T000000,552000,4,2.75,3160,8429,1620,1540
2599200460,20140805T000000,294000,4,2,2930,12840,2930,0
7214400005,20150313T000000,663500,2,1,1310,5200,910,400
5017000470,20140710T000000,1.98E+06,6,4.5,4800,9097,3580,1220
8651402660,20141008T000000,175409,4,1.5,1450,5530,1450,0
8665900328,20150123T000000,459000,4,3,1900,9077,1900,0
3881900321,20140514T000000,339950,3,1,1050,5402,1050,0
1524079028,20141029T000000,393000,5,1.75,1610,15246,1610,0
626049091,20140627T000000,275500,2,1,720,11400,720,0
6073200020,20150413T000000,485000,3,1,1020,9835,1020,0
3243100050,20140722T000000,250000,3,1,1250,7920,1250,0
1693600080,20141030T000000,935100,4,3.5,3200,8049,2700,500
7140600020,20150414T000000,245000,3,1,990,9599,990,0
6388910280,20150429T000000,670000,4,2.5,2850,25993,2850,0
2524000050,20141212T000000,1.39E+06,3,3.5,4240,21578,3500,740
2223069120,20140820T000000,440000,4,1.75,2800,49149,1400,1400
1732801300,20141008T000000,1.25E+06,2,2.5,2310,3313,2310,0
1685200020,20140827T000000,203000,3,1.75,1490,8000,1200,290
9510970050,20140901T000000,583000,4,2.5,1840,4011,1840,0
7156200005,20150402T000000,575000,3,1,1740,9163,1740,0
5316100780,20140922T000000,2.58E+06,4,3.5,3280,3800,2880,400
9362000080,20150316T000000,1.60E+06,5,3.5,4050,20925,3020,1030
2221800080,20150416T000000,312500,4,2.5,2160,8755,2160,0
2722059075,20140811T000000,455000,3,2.75,2720,31314,2720,0
3459600440,20141125T000000,1.31E+06,5,3,3650,16600,1860,1790
6844700415,20150316T000000,605000,4,2.25,1750,6120,1150,600
1223089016,20140718T000000,325000,3,2.25,2450,49658,1770,680
8044700010,20150427T000000,630000,3,1.75,1940,7306,1470,470
2024059130,20150109T000000,928950,4,3.75,3280,6000,3280,0
8019700010,20141010T000000,489950,3,1.75,2480,10804,1800,680
1785400780,20150415T000000,550000,3,2.25,2120,18255,1590,530
4222200380,20140805T000000,237000,3,2,1710,7920,1260,450
7503000050,20140807T000000,390000,3,2.5,1690,10113,1310,380
1592000680,20140528T000000,665000,3,2.5,2190,10370,2190,0
4303200130,20150210T000000,277000,4,3,1960,5160,1170,790
7731100066,20140612T000000,545000,3,1,1510,5000,1510,0
2770602335,20150407T000000,615000,3,2.5,1490,1410,1300,190
6706200130,20150415T000000,343000,3,1.75,2210,7920,1400,810
6632300567,20140730T000000,597000,4,2.5,2340,7877,2340,0
7000100635,20140715T000000,600000,3,1,940,19000,940,0
1954420420,20150313T000000,479000,3,1.75,1470,6018,1470,0
7809200005,20141216T000000,292000,3,1.75,1650,14633,1650,0
3056000050,20140912T000000,265000,3,1.5,1400,6527,1110,290
7214780050,20150420T000000,623000,4,2.5,2710,49044,2710,0
3210950080,20140514T000000,486000,4,2.5,2150,39449,1420,730
6914700130,20140615T000000,520500,3,2,1900,8100,950,950
7237550130,20140520T000000,1.30E+06,4,3.5,4380,74052,4380,0
1250202660,20140924T000000,825000,4,1,2290,6300,2150,140
3546000380,20140928T000000,259900,3,1.75,1690,7953,1690,0
5451200280,20150402T000000,1.17E+06,5,2.75,3090,12031,1600,1490
7129301851,20140923T000000,245000,2,1,1120,5650,720,400
582000010,20150320T000000,830200,3,2.5,2680,4990,1440,1240
8078360080,20140623T000000,650000,4,2.5,2400,7351,2400,0
2658000373,20150122T000000,305000,4,2,1610,6250,1610,0
7504400290,20150305T000000,599000,5,2.5,3470,12003,3470,0
7137950460,20140926T000000,272000,4,2.5,2070,6175,2070,0
3303950130,20141113T000000,415000,3,2.5,2420,10733,2420,0
6648500440,20141121T000000,319000,4,2.25,2380,7400,1760,620
3824100235,20140724T000000,425000,4,1.75,2120,15920,1060,1060
8732020440,20150428T000000,297500,4,2.5,2190,8100,1250,940
8649900480,20140527T000000,725000,4,2.5,2740,12899,2740,0
7708250010,20150107T000000,325000,3,2.5,1830,7585,1830,0
7955040130,20140805T000000,460000,3,1.75,1370,8467,970,400
3424069215,20150217T000000,396480,3,1,1000,10800,1000,0
1337801060,20150305T000000,1.03E+06,3,1,2050,4800,1950,100
2225300585,20141120T000000,370000,3,2.75,1750,9166,1170,580
2525300380,20150416T000000,260656,3,1,1620,13803,1620,0
5634500415,20140715T000000,431000,3,2.5,1710,12677,1710,0
2113700780,20150113T000000,320000,3,1,1060,5000,1060,0
1310970380,20140519T000000,296500,3,2.75,2170,7900,1380,790
8562500380,20150309T000000,679000,4,2.5,3080,8451,1540,1540
567000680,20140801T000000,359000,3,3,1320,1071,1080,240
1623049174,20150402T000000,330000,4,3,1920,12040,1920,0
9406590280,20140516T000000,350000,4,2.5,2440,4000,2440,0
3275800050,20141022T000000,242000,3,1.5,1640,8922,1640,0
326069027,20150326T000000,692500,3,2.5,2420,198198,2420,0
825049073,20140630T000000,441000,2,1.5,1190,3400,990,200
3275870080,20141212T000000,765000,4,2.5,2910,15016,2910,0
6837700170,20140903T000000,375000,2,1,1010,4050,1010,0
243000380,20150326T000000,365000,3,1.75,2080,7800,1220,860
582000675,20140908T000000,580000,2,1.5,1990,6000,1430,560
2655500235,20150410T000000,1.61E+06,4,3.5,3920,19088,2240,1680
4178300040,20150219T000000,841000,4,2.5,3080,13870,3080,0
3526059115,20150421T000000,515000,5,3,2670,11761,1370,1300
1722069052,20141024T000000,565000,5,2.5,4320,107157,2160,2160
5101404698,20141215T000000,365000,2,1.5,1200,6380,1200,0
13002495,20140707T000000,295000,3,1.5,1640,7222,1640,0
2391600555,20140630T000000,406500,2,1,870,5750,870,0
1133000144,20150212T000000,614905,3,2.5,2410,7225,2410,0
2525049133,20150402T000000,1.40E+06,5,2.25,2640,14959,1770,870
345700180,20140716T000000,250000,2,1,990,10556,990,0
7518504775,20141112T000000,549000,5,1,1500,3978,1500,0
3056800230,20140820T000000,397000,4,2.5,1790,6590,1790,0
6143600580,20140505T000000,184000,3,1.75,1490,10125,1490,0
9471200265,20150505T000000,2.50E+06,4,3.25,3960,16224,3100,860
8024200855,20140728T000000,499100,3,1.5,1620,5108,1620,0
3178100065,20140925T000000,676101,4,1.5,2270,6010,1290,980
3432501295,20140623T000000,290000,3,1,1150,8145,990,160
5467500040,20150304T000000,390000,4,1.75,2180,7560,1560,620
2872100245,20140604T000000,465000,3,1,910,4500,910,0
1154100515,20140926T000000,470000,3,2.75,2770,54707,2370,400
3298300210,20150219T000000,435000,3,1,940,7590,940,0
2473002700,20140627T000000,415000,3,1.75,2410,8944,1860,550
7544800395,20150225T000000,450000,3,2,1010,2820,1010,0
822039111,20150327T000000,645000,3,2.5,2120,196995,2120,0
2223059052,20140529T000000,231000,4,2,1530,6375,1530,0
1320069223,20140624T000000,358000,3,1.5,1810,100188,1810,0
2551500220,20140815T000000,330000,3,1,1040,11900,1040,0
1049000740,20141120T000000,229950,2,1.5,1160,1848,1160,0
9324800180,20141016T000000,403250,2,1.5,1430,8137,1130,300
7853220690,20140912T000000,470000,3,2.5,2280,6134,2280,0
1545803980,20150425T000000,239000,3,1,1200,7810,1200,0
2484700015,20150327T000000,579000,4,1.5,2480,6000,1520,960
993000873,20150318T000000,380500,3,2,1270,1348,1270,0
9520900210,20141231T000000,614285,5,2.75,2730,6401,2730,0
3629960590,20150407T000000,376000,2,2,1340,1635,1340,0
9558200210,20150217T000000,290000,3,1,1240,9300,1240,0
3876000910,20150129T000000,487000,4,2.25,2400,7000,1800,600
7228501745,20150219T000000,935000,4,2,1220,7489,1220,0
8856004328,20150327T000000,255000,4,2.5,2163,5882,2163,0
253600150,20140826T000000,380000,2,2.5,1860,3504,1860,0
5101400934,20150424T000000,450000,2,1,810,4368,810,0
9202650100,20141010T000000,622000,3,2.5,1950,7481,1950,0
2310030490,20150323T000000,292500,3,2.25,1390,6004,1390,0
1860600535,20141220T000000,1.32E+06,4,3,2120,3600,1830,290
1250201130,20150206T000000,410000,4,2,1510,3240,870,640
3298700820,20141024T000000,160000,3,1.75,1010,5355,1010,0
1339300025,20140602T000000,809000,4,1.5,1840,4337,1840,0
4006000571,20150312T000000,183750,5,2.75,1650,5453,1650,0
9310300300,20141013T000000,411000,5,1.75,2860,12293,1430,1430
5332200515,20150209T000000,1.05E+06,3,1.75,2650,5512,2250,400
809001565,20140822T000000,625000,2,1,1100,4160,1100,0
9406520580,20140819T000000,305000,3,2.25,1646,9519,1646,0
1323059143,20150423T000000,915000,4,4.5,5250,48352,5250,0
2131701020,20150311T000000,317000,3,1.5,1390,8300,1390,0
3438503045,20150120T000000,165000,2,1,780,6380,780,0
3204300705,20140515T000000,575000,2,1,1490,6000,1090,400
7941600220,20140610T000000,219900,3,1,970,7742,970,0
3885805175,20141001T000000,1.49E+06,4,3.25,3730,7200,2810,920
1237500120,20140520T000000,300000,3,1,1090,9900,1090,0
322069020,20140619T000000,520000,3,1.75,1940,219527,1940,0
1310700330,20150507T000000,310000,4,2.25,1780,8820,1480,300
423059207,20150223T000000,322500,3,2,1190,6445,1190,0
7205000180,20150417T000000,320000,4,2.25,2000,10374,2000,0
7852180530,20150403T000000,440000,3,2.5,1390,4997,1390,0
6021501780,20140818T000000,578000,3,1,1500,4500,1120,380
8673400061,20141119T000000,382000,2,1.5,1070,877,1070,0
3905100220,20140528T000000,535000,3,2.5,1720,4006,1720,0
5104540330,20150508T000000,679000,4,2.5,3680,7236,3680,0
6752300120,20141201T000000,258900,3,2.25,1400,10436,1040,360
4077800412,20150316T000000,563000,3,1.5,1730,9509,1270,460
2787250090,20140618T000000,562000,5,3,2795,15101,2795,0
461002150,20150105T000000,725000,4,1.75,2000,3750,1120,880
1898310100,20150220T000000,236775,3,2.5,1830,8372,1830,0
3886902950,20140911T000000,860000,4,3.5,3380,8098,1690,1690
4427100025,20140509T000000,270000,3,1.5,1500,6337,1500,0
4038700730,20141230T000000,621000,4,2.75,1950,6930,1250,700
7852011020,20150327T000000,527900,3,2.5,2490,5928,2490,0
126059018,20150108T000000,395000,4,2.25,1780,10748,1780,0
9407001340,20140522T000000,320000,3,2,1110,10500,1110,0
2799800750,20150416T000000,300000,4,2.5,2500,4750,2500,0
192000120,20140520T000000,320000,3,1.75,1480,7225,1480,0
625069064,20150507T000000,625000,3,2.25,2570,47480,2570,0
2391600330,20150410T000000,505000,2,1,810,5060,810,0
4180400090,20140613T000000,300000,4,2.5,2700,10814,1560,1140
50300220,20150212T000000,363000,4,2.5,2180,9281,2180,0
4141010110,20140808T000000,1.70E+06,4,3.5,4330,15335,3230,1100
6641040100,20140515T000000,1.15E+06,4,3.5,4210,10308,4210,0
7922720040,20150317T000000,680000,4,2.5,2880,9202,1780,1100
8825900245,20141209T000000,678940,5,2.25,2610,4080,1750,860
3883100220,20150120T000000,299000,3,1.75,2010,8065,1090,920
3649100306,20140506T000000,379900,4,1.75,1500,11600,1000,500
1099600090,20140613T000000,205000,3,1,1290,6566,1290,0
9828201725,20140520T000000,387500,4,1,1320,4440,1320,0
9352901085,20150204T000000,256000,3,1,1290,4720,790,500
4104910040,20140701T000000,548000,4,2.5,2440,11005,2440,0
6147600040,20150224T000000,163000,3,1.75,1290,4811,1290,0
6371000026,20150122T000000,367500,2,2,1030,600,680,350
8121100147,20140714T000000,390000,3,2.25,1640,2875,1240,400
6152900332,20140801T000000,415000,4,2.5,1160,16008,1160,0
9522600120,20141022T000000,449000,4,2.25,2230,8440,2230,0
2207200405,20140716T000000,460000,5,2,1910,12264,1010,900
203900690,20141223T000000,395000,4,2,1980,15354,1980,0
252000300,20150120T000000,300000,3,2,1470,16500,1470,0
8899100230,20150311T000000,345000,3,1.75,1520,7439,1520,0
685000265,20150102T000000,825000,3,1.75,1930,8442,1930,0
2705600068,20150327T000000,539950,3,2.5,1330,2180,1330,0
3326059191,20140616T000000,410000,4,2,1580,9581,1580,0
1207000025,20140801T000000,245000,3,1,1370,6000,1370,0
3288301050,20140819T000000,482000,4,2.75,3010,15750,1560,1450
9407001500,20140811T000000,270000,3,1.75,1390,9000,1390,0
3882300090,20141226T000000,475000,3,1.75,1330,14560,1330,0
2926049221,20141014T000000,445800,3,2,1320,6500,1320,0
2121000300,20150219T000000,518000,4,3,2430,11670,1330,1100
3885801970,20140812T000000,785000,2,0.75,1260,4800,1080,180
3869900120,20150226T000000,430000,3,2.5,1690,1310,1140,550
4077800026,20140530T000000,715000,4,1.75,3420,7200,1770,1650
9324800450,20141009T000000,560000,3,1.5,2790,6900,1700,1090
1250201194,20141107T000000,449000,3,1.75,1270,6600,1270,0
2597520580,20141008T000000,805000,4,2.5,2910,9000,2910,0
6679000720,20140924T000000,296000,3,2.5,1560,5845,1560,0
7312400325,20140625T000000,275000,2,1,770,4840,770,0
2473500110,20150112T000000,419950,3,1.75,1770,16909,1770,0
1773100123,20141002T000000,285000,3,1.75,1100,1307,780,320
6791050100,20140721T000000,775000,3,2.5,2890,8470,2890,0
1823059106,20150428T000000,288250,3,1.75,2110,15400,1380,730
3644100065,20150427T000000,257000,2,1.75,1220,2268,610,610
5652601075,20140825T000000,377000,1,1,950,10585,950,0
2769601250,20150512T000000,550000,2,1,1420,3100,820,600
9842300540,20140624T000000,339000,3,1,1100,4128,720,380
7818700410,20141106T000000,481500,3,1.75,2140,6000,1070,1070
5437810360,20141107T000000,224500,3,1.75,1300,7735,1300,0
5163700085,20140826T000000,260000,3,1,1790,11884,1790,0
1794500360,20150423T000000,865000,2,1,1470,5400,1470,0
1777600450,20150505T000000,730000,5,3,2500,11779,1550,950
4083800555,20150326T000000,550000,2,1,980,3080,980,0
3359500096,20140820T000000,645000,3,2,2130,4000,2130,0
4024100090,20141008T000000,250000,3,1.75,1360,16000,1360,0
7228501910,20150122T000000,507200,3,3.5,1630,1329,1360,270
7183000120,20140812T000000,380000,4,2.5,2500,11070,1300,1200
7527000090,20140814T000000,540000,4,1.75,2260,19500,1450,810
8682281080,20140617T000000,738500,3,2.5,2300,6009,2300,0
2525310040,20150129T000000,206000,3,1,1060,10350,1060,0
5589300210,20150317T000000,265000,2,1,940,9458,940,0
4008400515,20150120T000000,190000,1,0.75,780,77603,780,0
3268000040,20140628T000000,339900,3,1,1200,9087,1200,0
1022059123,20141226T000000,250000,6,2.5,2590,10890,1340,1250
3013300968,20140801T000000,416500,3,1,1100,4184,1100,0
7853220740,20150407T000000,575000,4,2.5,2890,9775,2890,0
3574801490,20140609T000000,385000,3,1.75,1230,7500,1230,0
2987400025,20141009T000000,253000,3,1,1030,6250,1030,0
625049313,20140902T000000,460000,3,1,1140,4600,1140,0
6169901085,20140807T000000,1.45E+06,4,2.5,3200,3600,2600,600
9212900300,20150304T000000,492000,2,1,950,6000,950,0
2520069100,20141016T000000,275000,4,2,1960,30480,1060,900
2623069031,20140521T000000,542500,5,3.25,3010,1074218,2010,1000
7625703945,20140701T000000,345000,2,1,1080,7775,1080,0
9238480120,20150421T000000,575000,4,2.75,2730,35075,1530,1200
626049058,20150504T000000,275000,5,2.5,2570,17234,1300,1270
125059138,20140722T000000,510000,6,4.5,3300,7561,3300,0
9185700485,20150401T000000,2.54E+06,4,3.5,4350,6000,2970,1380
2523089110,20140909T000000,830000,3,3.5,3820,145054,2870,950
3825310540,20141121T000000,640000,4,2.5,2260,5172,2260,0
7202340590,20141014T000000,702000,4,2.75,3880,15025,3880,0
1952200410,20141119T000000,960000,3,2.5,2010,6857,1450,560
7137900410,20150429T000000,190000,3,1,950,7610,950,0
7105600085,20141009T000000,500000,3,2.25,1730,13040,1290,440
1461200040,20140714T000000,529000,3,2.5,3070,22098,3070,0
6675500035,20140613T000000,435000,3,1.75,1500,8173,1500,0
4322500110,20150303T000000,670000,3,1.75,2160,5760,1260,900
6064800090,20150507T000000,365000,3,2.25,1960,1985,1750,210
8085400355,20141204T000000,1.27E+06,5,3,3950,9520,2250,1700
943100220,20140925T000000,465000,3,1,1100,145490,1100,0
854000165,20150107T000000,285000,3,1.5,1400,7582,1400,0
1443500905,20150205T000000,219950,3,1,1020,4960,920,100
4031700210,20141117T000000,220000,3,1.5,1600,10548,1600,0
6169900580,20140709T000000,1.47E+06,6,4.5,4230,6420,2360,1870
4232401265,20141020T000000,1.11E+06,5,3.5,3090,3600,2060,1030
8682290410,20150417T000000,694000,2,2.5,2320,9311,2320,0
3904902430,20150403T000000,620000,3,2.5,2440,10363,2440,0
114101540,20140821T000000,415000,3,1,2020,19210,1760,260
1025069106,20150223T000000,765000,3,3,3270,38088,3270,0
3179101945,20140715T000000,864000,4,1.75,2260,6600,1220,1040
3083000355,20141204T000000,385000,5,2,2020,4000,2020,0
1741700040,20150113T000000,725000,3,1,1000,19969,1000,0
1828001130,20140617T000000,545000,4,2.25,2030,11585,1590,440
3211580210,20150411T000000,299900,3,1.75,1730,9893,1730,0
1036000610,20150507T000000,639500,3,1.75,2010,8072,2010,0
3378100100,20150317T000000,345000,4,1.5,1540,7168,1160,380
9286000150,20150330T000000,1.13E+06,6,4,5330,18116,3950,1380
7254200040,20150316T000000,345000,2,1,960,2700,780,180
8827900690,20150421T000000,600000,3,2,1460,2800,730,730
9202500150,20141104T000000,355000,4,1.75,2160,7417,1360,800
1786810040,20140909T000000,698000,3,2.75,2640,11957,2260,380
8078410210,20140616T000000,566000,4,2.25,2170,7737,2170,0
3905100210,20140723T000000,449950,3,2.5,1530,3840,1530,0
5592900015,20150116T000000,404600,3,1,1570,7727,1270,300
7522700110,20140624T000000,258000,3,1,1490,7435,1120,370
5253300243,20150429T000000,415000,4,2,1960,10559,1960,0
6669020490,20140812T000000,320000,4,2.25,2190,9020,2190,0
5104510540,20141126T000000,295000,3,2.5,1690,4102,1690,0
3579700100,20140527T000000,389000,5,2,2330,10750,1190,1140
8643200035,20140821T000000,299900,3,1.75,1470,27000,1470,0
2781250100,20150415T000000,394000,3,2.5,2550,5349,2550,0
3885807255,20150202T000000,762000,4,2,2130,5500,2130,0
1774230090,20140613T000000,697000,4,2.75,3650,48351,3650,0
3521069146,20150330T000000,485000,3,2.5,3340,70131,2420,920
424500100,20141008T000000,189900,2,1,800,5600,800,0
3761700053,20150105T000000,2.15E+06,3,2.75,3470,9610,3470,0
2685600090,20141118T000000,345000,3,1.5,1030,6969,1030,0
6381500065,20140729T000000,376500,3,2,1630,7800,1630,0
9294300515,20141024T000000,775000,3,2,2010,7017,2010,0
2769602840,20141016T000000,450000,3,1,1360,3737,1360,0
2526039156,20141210T000000,760000,4,2.25,2040,8315,1480,560
7852140100,20141007T000000,569000,4,2.5,2830,10954,2830,0
5522600205,20140917T000000,500000,3,1.5,2040,6750,1280,760
1370802620,20141211T000000,592500,2,2,1340,5350,1340,0
8079100210,20150304T000000,620000,4,2.5,2130,9139,2130,0
644200040,20140515T000000,1.00E+06,5,4.25,3920,16258,2900,1020
9808640090,20150319T000000,815000,3,2.5,2415,2186,2415,0
5104531120,20150323T000000,775000,5,2.75,3750,12077,3750,0
3575303970,20140716T000000,340000,3,1,1010,7500,1010,0
6413100090,20140915T000000,458000,2,1.75,990,5850,990,0
2475200870,20140917T000000,250000,2,1.5,1200,5773,1200,0
3423059081,20141009T000000,151600,2,1,1060,16988,1060,0
1137410040,20140527T000000,515000,4,2.5,3200,6473,3200,0
3352400330,20150327T000000,216000,2,1,1810,10360,1010,800
2781320100,20150309T000000,245000,3,1.75,1670,24650,1670,0
8894000040,20140625T000000,645000,3,2.75,1850,16960,1850,0
3333000775,20140903T000000,249900,3,1,1100,5000,1100,0
9274204230,20140709T000000,410000,3,1.75,1660,6250,830,830
3972900025,20150313T000000,499000,6,1.75,2400,7500,1400,1000
1159400220,20140529T000000,790000,5,3.25,2900,12160,1890,1010
3876313030,20140520T000000,458000,1,2.25,2140,10350,1470,670
2856100515,20140805T000000,925000,4,2.5,2670,5100,1940,730
4239400730,20140625T000000,152000,3,1,1090,3264,1090,0
1826059042,20140923T000000,402000,3,2.5,1970,12205,1970,0
3869900155,20150326T000000,340000,2,2,1250,1178,980,270
2600010220,20150326T000000,1.25E+06,4,2.5,4040,11350,3690,350
9290870040,20141117T000000,775000,4,2.5,3220,38448,3220,0
5347200175,20150319T000000,299800,2,1,1310,2814,810,500
3810000455,20140908T000000,340000,4,2.25,2060,8400,1300,760
1962200037,20140502T000000,626000,3,2.25,1750,1572,1470,280
795001930,20141007T000000,324950,2,1,1150,9186,1150,0
3905080730,20150223T000000,535500,3,2.5,2050,4976,2050,0
8651611110,20140905T000000,817500,3,3.25,3230,7639,3230,0
5411600210,20140812T000000,810000,4,3.5,4170,4322,2940,1230
7519000665,20150408T000000,565000,5,1.5,1940,3430,1220,720
4217400120,20141125T000000,978000,3,1.5,2390,4000,1690,700
3586500665,20150112T000000,530000,3,1,1440,27505,1440,0
2582500110,20141007T000000,305000,4,2.5,2230,6487,2230,0
6749700031,20140609T000000,345000,3,2.5,1210,1420,1210,0
4136800205,20150219T000000,258000,2,2,750,6553,750,0
3438503120,20150330T000000,275000,4,1,1770,7345,1770,0
1922069089,20150324T000000,310000,3,1,1020,55756,1020,0
4099501215,20140603T000000,713250,3,2,2050,9000,2050,0
3325069025,20150508T000000,500000,3,1,2000,21780,1480,520
4058200985,20140911T000000,472000,3,1.75,2180,7200,1090,1090
3031200246,20140711T000000,250000,3,1,920,4429,920,0
624101110,20141002T000000,725000,4,2.25,3440,14237,3440,0
4046700210,20140629T000000,345000,3,2,1610,15005,1610,0
2916200065,20150115T000000,460000,3,1.5,1870,15685,1470,400
6141100038,20140602T000000,440150,2,1,1110,6800,1000,110
2806800090,20141104T000000,390000,3,1.75,2200,8036,1270,930
312000265,20150504T000000,375000,2,1,790,5120,790,0
2938200040,20141211T000000,224950,3,1.5,1630,9282,1630,0
114101161,20140829T000000,480000,3,1.5,2100,67269,1220,880
1862400353,20150326T000000,721000,4,2.75,2690,5400,2210,480
179000100,20140826T000000,174000,2,1,600,4854,600,0
7812800865,20141119T000000,170000,2,1,810,9882,810,0
809002390,20150115T000000,658000,3,1.5,1660,3190,1660,0
2925059294,20150327T000000,860000,3,2,1880,8494,1200,680
7574200210,20140618T000000,407450,4,1.5,2310,68824,2310,0
5634500775,20150130T000000,615000,4,1.5,2650,34000,2650,0
8965460090,20150407T000000,920000,4,3,3130,12381,3130,0
1796350300,20140710T000000,195000,2,1,860,10400,860,0
428000150,20140718T000000,269950,3,1,990,9950,990,0
2323089009,20150119T000000,855000,4,3.5,4030,1024068,4030,0
3528900735,20140910T000000,620000,3,2.25,1780,1429,1570,210
3904100220,20141209T000000,276000,2,2,1480,6075,740,740
254000735,20140806T000000,329000,3,1,1140,5258,1140,0
7893205080,20141007T000000,270000,3,1.5,1230,7500,1230,0
4397010300,20141113T000000,440000,4,2.5,3080,10646,3080,0
1150000740,20141003T000000,639000,4,2.5,1990,8034,1990,0
1926049141,20141010T000000,403500,1,1,700,5621,700,0
7011201016,20141001T000000,585000,3,2.5,1700,1156,1320,380
3028200100,20140826T000000,216000,2,1,860,9000,860,0
8081010040,20140911T000000,1.15E+06,3,2.5,3160,24437,2160,1000
3023049186,20150416T000000,575000,3,2,2500,30056,1840,660
8029900110,20141114T000000,430000,4,2.5,3000,9460,3000,0
9367200205,20150324T000000,660000,2,1,1670,8195,1670,0
5550300205,20150413T000000,338000,2,1,690,6400,690,0
8820901415,20140529T000000,400000,4,2.75,1240,3867,800,440
6018500120,20150220T000000,210000,2,1,900,5000,900,0
3826000665,20140522T000000,305000,4,1.75,2200,8100,1400,800
1025079086,20140820T000000,365000,2,1,960,223898,960,0
2621660040,20140629T000000,325000,5,2.75,2130,6222,1300,830
8731982550,20141210T000000,245000,4,1.75,2020,8800,2020,0
4324500180,20140926T000000,182000,3,1,1060,7350,1060,0
1702901485,20140603T000000,440000,2,1,1230,6600,1130,100
251300110,20140731T000000,225000,3,2.25,2510,12013,2510,0
251300110,20150114T000000,358000,3,2.25,2510,12013,2510,0
461002615,20141202T000000,580000,5,2.5,2720,5000,1530,1190
8091401030,20150422T000000,240000,3,1.5,1070,8886,1070,0
3924500040,20150413T000000,700000,4,3.25,3580,43093,3580,0
9432900040,20140729T000000,325000,4,2.5,2230,8500,2230,0
2426049125,20141114T000000,488000,4,2.25,2500,10890,1800,700
2883201055,20140910T000000,875000,4,1,1670,4600,1670,0
1795900360,20140602T000000,615000,4,2.5,2150,9070,2150,0
9542830690,20141120T000000,321000,3,2.5,2020,4183,2020,0
1245500690,20140602T000000,1.04E+06,3,2.5,2230,5750,2230,0
7454000315,20150424T000000,299500,2,1,740,6300,740,0
2426049113,20150414T000000,459000,4,1.5,2020,9583,2020,0
8665050450,20140912T000000,435000,3,2.5,1730,4065,1730,0
2787320620,20141010T000000,222000,3,1.75,1370,8280,1370,0
5100401411,20141027T000000,485000,4,1,1210,6380,1210,0
2767602855,20150429T000000,750000,5,3.5,2160,2323,2160,0
7575620750,20141222T000000,266000,3,2.25,1550,6022,1550,0
1529300115,20140602T000000,455000,2,1,1170,6000,970,200
122029066,20150508T000000,490000,3,1.75,2020,215622,2020,0
8732130580,20150430T000000,280000,3,1.75,1740,8625,1240,500
1689400375,20140805T000000,1.45E+06,4,3.25,3100,3900,2090,1010
985001321,20141217T000000,291000,4,1,1590,24330,1140,450
7987400475,20150417T000000,745000,5,3,2400,10126,2400,0
6383000820,20140807T000000,685900,3,2.5,2290,9142,2290,0
1311400120,20140801T000000,160000,3,1.75,1610,7392,1610,0
1153000040,20150429T000000,650000,4,2.5,2240,9934,1490,750
7452500530,20150219T000000,250000,2,1,850,6370,850,0
6300000212,20150218T000000,265000,2,1.5,920,1458,920,0
3332000530,20141105T000000,599000,5,3.25,2590,6180,1330,1260
7657600195,20141105T000000,199950,3,1,1340,7260,1340,0
1102000237,20150428T000000,712500,4,2.75,2420,11201,1420,1000
2887702070,20141022T000000,490000,2,1,1420,4305,920,500
6392001005,20140620T000000,511500,4,1,1360,6000,1360,0
1601600195,20150319T000000,299000,3,1,1510,6200,1010,500
3586500620,20140814T000000,685000,4,2.5,2650,25248,2330,320
6021502250,20140825T000000,597000,4,2,2120,4000,1720,400
3830210220,20140908T000000,210000,3,1,1200,7200,1200,0
2568300266,20140530T000000,659000,4,2.5,3190,11375,2210,980
3423600065,20140604T000000,540000,3,1,1050,4160,1050,0
3343300180,20150330T000000,469000,3,2,1300,22605,1300,0
3125079013,20150430T000000,1.07E+06,3,2.5,3970,263538,3970,0
6453900040,20140714T000000,575000,5,2.5,2990,7500,1800,1190
148000590,20140731T000000,725000,4,2.75,2440,7042,1640,800
419000015,20140917T000000,299950,4,1,1170,5400,1170,0
303000220,20150421T000000,375000,4,2,2270,18450,2270,0
6450302175,20141118T000000,342450,3,1.5,1280,5525,1280,0
1180000625,20141029T000000,315000,4,2.5,1950,3225,1950,0
7972600450,20141222T000000,328000,4,2.75,1930,3840,1170,760
1328300180,20140509T000000,323000,4,2.75,1970,7213,1170,800
7866000158,20141022T000000,320000,4,3,1820,3120,1000,820
7518505345,20141229T000000,550000,2,1,950,4080,950,0
8084900195,20141121T000000,1.65E+06,6,3.5,4010,16200,2090,1920
4139420590,20140520T000000,1.21E+06,4,3.5,4560,16643,2230,2330
4139420590,20140827T000000,1.20E+06,4,3.5,4560,16643,2230,2330
2621600015,20150121T000000,120000,3,1,1150,8924,1150,0
2621600015,20150430T000000,175000,3,1,1150,8924,1150,0
8005100360,20140916T000000,169900,3,1,910,5800,910,0
9527000330,20140811T000000,508000,6,2.75,2890,7500,1830,1060
748000145,20141211T000000,335000,2,1,1070,6678,1070,0
9191200015,20140910T000000,613200,3,2.75,2050,3320,1580,470
1822300040,20140507T000000,420000,2,1.5,1040,3500,1040,0
9129100040,20140825T000000,1.00E+06,4,3.25,3320,8587,2950,370
3331500940,20140617T000000,342000,2,1,740,6180,740,0
524069101,20140723T000000,850000,4,2,3380,90968,1690,1690
6021502310,20141218T000000,582000,2,1.75,1210,4141,910,300
4022901316,20141031T000000,475000,3,2.5,2480,6031,2480,0
23500180,20140505T000000,570000,3,2.25,2010,6000,1330,680
9191200490,20150324T000000,826600,4,3.25,3230,5000,1750,1480
1189000207,20141021T000000,387000,2,2.5,1170,1394,1170,0
1771110720,20140521T000000,330000,3,1,1250,9126,1250,0
224069010,20140725T000000,653450,3,2.5,2070,49658,1540,530
3630060040,20140911T000000,285000,2,1,1050,3088,1050,0
3211100450,20140814T000000,217000,3,1,1400,7800,1400,0
1245003255,20150223T000000,615000,3,1,1120,12500,1120,0
1438000110,20140603T000000,580135,4,2.5,3150,5886,3150,0
8089500180,20140730T000000,1.15E+06,4,3.5,4540,19767,4200,340
6802200110,20141029T000000,231200,3,2,1400,8821,1400,0
7203100120,20140616T000000,680000,4,2.75,2500,4950,2500,0
3445400120,20140725T000000,267500,3,1.5,1390,2153,1390,0
1454100650,20140804T000000,942000,4,2.75,3160,37200,2310,850
106000015,20140619T000000,435000,3,1.75,1310,8065,1310,0
9459200110,20140610T000000,315000,2,1,1740,3622,950,790
3448000410,20140513T000000,354901,3,2.5,1490,1709,1490,0
8682281220,20141014T000000,439888,2,2,1300,6515,1300,0
2114700530,20150122T000000,360000,4,1,1460,3840,1340,120
8093600065,20141231T000000,205000,4,1,1030,6621,1030,0
4137030040,20140612T000000,299995,3,2.5,1970,7500,1970,0
5126900100,20140923T000000,150000,2,1,790,7275,790,0
5469501530,20140603T000000,575000,3,2.25,3800,33825,3330,470
7784000180,20150505T000000,625000,3,2,2168,12616,2168,0
7135520610,20140529T000000,950000,4,3.5,4140,13392,4140,0
8856500120,20150210T000000,278800,4,2.5,2440,7797,1560,880
5015000180,20141110T000000,713500,3,2,1720,4200,1720,0
3024059014,20150325T000000,1.90E+06,4,2.25,3020,11489,2110,910
9268200348,20141028T000000,439000,5,2,2610,5009,1710,900
9195700040,20140926T000000,425000,3,2,1500,8086,1060,440
8798000100,20140825T000000,252500,4,2.5,2600,11280,1570,1030
304000530,20140512T000000,185000,3,1.5,1370,8470,1370,0
3575304895,20140923T000000,406550,5,2.75,2400,15781,1200,1200
9406500540,20140630T000000,243000,2,1.5,1068,1758,1068,0
6071800410,20141201T000000,500000,3,1.5,2220,8994,1110,1110
2122049013,20150513T000000,204750,2,1,880,7575,880,0
5470100220,20140909T000000,222000,3,1.5,1310,9273,1310,0
6623400246,20140523T000000,200000,4,1,1350,11507,1350,0
3918400028,20141021T000000,367000,3,2.25,1400,1320,1400,0
1422700040,20150514T000000,183000,3,1,1170,7320,1170,0
7660100336,20141210T000000,300000,3,2.5,1020,1570,720,300
6145602240,20140819T000000,369000,3,1.75,1300,3844,1300,0
7287100035,20140731T000000,380000,3,2,2010,16736,2010,0
5101405465,20150203T000000,463000,3,2,1590,5009,1590,0
3756500180,20141208T000000,475000,3,1,1470,9750,1470,0
3750605620,20150324T000000,225000,3,1.75,1580,14400,1580,0
2473350790,20150511T000000,371000,3,1.75,1970,9512,1970,0
3389900965,20140827T000000,625000,3,2.5,2330,3141,2330,0
1068000375,20140923T000000,3.20E+06,6,5,7100,18200,5240,1860
9407100730,20150129T000000,329000,3,1.75,1230,10725,1230,0
7618700112,20150210T000000,634000,3,1.75,2570,13000,2570,0
5104540360,20141107T000000,616000,4,2.5,3440,6915,3440,0
1051000040,20150424T000000,1.82E+06,3,2.25,3330,20053,3330,0
2896400300,20150319T000000,435000,4,2.25,1780,2684,1780,0
5003600120,20150415T000000,320000,4,2.5,2110,6295,2110,0
6352600490,20150114T000000,820000,4,3.5,2770,8049,2770,0
3820350120,20140822T000000,310000,3,2.5,1590,3359,1590,0
4235400097,20141202T000000,443750,3,2.25,1460,968,1140,320
2757000040,20140605T000000,795000,4,2.25,2070,13084,1700,370
537000325,20141104T000000,475000,3,2.5,2420,36862,1530,890
9522100485,20140515T000000,585000,5,1.75,2000,3750,2000,0
345700040,20140729T000000,315000,2,1,1010,7338,1010,0
3904960910,20140917T000000,635000,4,2.5,3050,7238,3050,0
1771000690,20140528T000000,305000,3,1,1160,11776,1160,0
1931300035,20140516T000000,785000,3,2,2180,5440,1100,1080
2770601800,20141024T000000,525000,3,1.75,1560,6000,780,780
5309100515,20150120T000000,537000,4,1.75,1580,3635,790,790
984210850,20150217T000000,279950,3,1.75,1660,8303,1380,280
924059233,20141208T000000,659000,4,2,2350,9329,2350,0
5029451080,20140821T000000,203000,2,1,1440,6650,970,470
4379400220,20140909T000000,782500,4,2.5,2930,7806,2930,0
5419800220,20140610T000000,250000,3,1.75,1590,7560,1130,460
1839500065,20140805T000000,279000,3,1,1400,9450,1060,340
2525059172,20141125T000000,664000,6,2.5,3190,12196,3190,0
7159200040,20140917T000000,2.90E+06,4,3.25,4580,4838,3080,1500
3812400107,20150330T000000,378500,4,2,1830,6000,1070,760
2726079061,20140507T000000,535000,3,1.75,2720,149410,2720,0
1270000040,20140716T000000,520000,2,1,1360,22508,1360,0
2113700115,20150504T000000,369950,3,2,1520,4000,800,720
824069113,20140924T000000,545000,3,2.25,2290,14585,2290,0
8856920110,20150504T000000,360000,3,2.5,2150,14092,2150,0
8146100410,20140805T000000,760000,3,1.5,1170,7645,1170,0
5101400838,20140916T000000,450000,3,1.75,1830,5488,1010,820
1088800850,20140502T000000,612500,4,2.5,2730,12261,2730,0
1061400360,20140701T000000,280000,3,1,1090,10710,1090,0
9545250110,20150414T000000,750000,3,2.5,2560,9182,2560,0
425400115,20140715T000000,237000,3,1,1160,6132,1160,0
2436700315,20141014T000000,441500,2,1.75,1010,4000,1010,0
1545803520,20150126T000000,251000,3,2,1650,7930,1650,0
257000037,20141229T000000,200000,3,1,2120,31564,1220,900
5016000315,20140616T000000,332000,1,1,960,2640,760,200
6300500477,20140826T000000,401500,3,2.5,1509,1114,1509,0
4022905172,20140926T000000,585000,4,1.75,2270,27122,1300,970
7300000650,20140702T000000,340000,4,2.5,1954,4805,1954,0
8682282070,20150112T000000,920000,3,3.5,2800,7694,2800,0
7812801115,20140613T000000,153000,3,1,1270,6405,1270,0
9269750690,20150105T000000,299950,4,2.25,1810,7601,1080,730
1402620120,20150512T000000,440000,4,2.5,2410,7517,2410,0
3793501390,20140915T000000,293000,3,2.5,1690,17383,1690,0
9282800065,20150329T000000,203000,3,1.75,1190,6000,1190,0
1921059310,20150320T000000,193000,2,1.75,1280,6774,1280,0
109000040,20150316T000000,305000,3,1.75,1460,7862,1460,0
5101405331,20140502T000000,495000,4,1.75,1600,6380,1130,470
2044500142,20140902T000000,420000,3,1.75,1770,6000,1130,640
1837010040,20140905T000000,569500,4,2.5,2800,8190,1700,1100
3905000540,20140515T000000,620000,4,2.5,2680,9185,2680,0
6071200375,20141211T000000,466000,3,1.75,1680,9460,1680,0
3756500610,20150324T000000,355500,3,1,1120,10032,1120,0
3885805035,20150508T000000,687500,2,1,1040,7200,1040,0
7525100530,20150411T000000,432100,3,2.25,1790,2240,1790,0
1324059048,20140721T000000,500000,3,2.5,2410,34848,2410,0
3904921250,20141010T000000,690000,5,3.25,3370,7313,2140,1230
3331500485,20150102T000000,350000,2,1,800,5150,800,0
7338401759,20140610T000000,268000,2,1,1380,5000,870,510
3122069029,20140619T000000,120000,2,1,990,39964,990,0
3797310150,20150218T000000,285000,4,2.5,1800,9229,1800,0
2205500540,20141008T000000,365000,4,1.5,1820,12327,1380,440
7202310040,20150408T000000,635000,3,2.5,2620,6842,2620,0
3630120330,20140708T000000,630000,2,2.5,2290,3507,2290,0
4310700665,20150305T000000,450000,4,3,2200,4466,2200,0
7504001080,20150304T000000,590000,4,2.5,2940,12600,1850,1090
2021200770,20140909T000000,895000,2,1.75,1700,3618,1260,440
2005600090,20140514T000000,160000,3,1,860,11900,860,0
123000110,20140930T000000,520000,2,1,910,5000,910,0
2473372170,20140806T000000,432000,4,3.25,2820,13059,2820,0
7227500865,20140519T000000,141800,2,1,930,4743,930,0
510001280,20140714T000000,980000,4,2,2190,4560,2190,0
3886903615,20150416T000000,1.29E+06,4,2.5,3430,7200,3430,0
439200035,20141117T000000,740000,4,2.75,2560,6900,1480,1080
4303200184,20141010T000000,230000,2,1,770,6450,770,0
9362000040,20140623T000000,3.40E+06,3,4.5,5230,17826,3740,1490
4039701280,20150408T000000,954500,3,2.25,2440,9689,1830,610
9828201202,20150316T000000,622000,3,1.5,1650,3150,1650,0
2734100835,20150303T000000,90000,1,1,780,4000,780,0
6749700110,20141029T000000,342000,3,3,1260,1634,1260,0
3832060940,20140729T000000,305000,4,2.5,2320,4683,2320,0
2214800110,20140820T000000,259900,4,2.75,1560,8820,1060,500
1909600115,20140827T000000,420000,3,2,2330,6346,1600,730
40000553,20150304T000000,250000,2,1,1400,19570,1100,300
7686203195,20150323T000000,249950,3,1.5,1450,6875,1450,0
2923059064,20150217T000000,199000,2,1,1140,15120,990,150
2895600090,20150407T000000,355200,3,1,1120,7320,1120,0
4019301386,20140909T000000,425000,3,1.5,1970,13709,1680,290
7199360100,20141112T000000,379500,3,1,1110,7128,1110,0
1241500032,20140819T000000,860000,4,2.5,3070,6923,3070,0
9558020610,20140512T000000,335000,3,2.5,1940,4927,1940,0
2050100450,20141105T000000,865000,3,2.5,3050,12558,3050,0
1250200600,20150408T000000,390000,3,1,1240,3600,1240,0
9325200110,20140909T000000,569950,5,4.25,3380,7805,3380,0
293850040,20150205T000000,495500,3,2.5,3190,7828,3190,0
3723800097,20141211T000000,476500,4,1.75,1670,10200,1390,280
7788400180,20140812T000000,261000,3,1,1660,11200,1660,0
2206700215,20140822T000000,375000,4,2,2070,9822,2070,0
2206700215,20150422T000000,550000,4,2,2070,9822,2070,0
603001050,20140723T000000,230000,2,1,1430,4000,930,500
3583400120,20150204T000000,526750,5,2.5,2270,10700,1570,700
3886903155,20150304T000000,606000,3,2,1980,7680,1070,910
9485910100,20150424T000000,368500,4,2.75,2500,26400,1780,720
3223039089,20140929T000000,275000,3,1,1230,171190,1230,0
2596300035,20150422T000000,342000,4,1,1390,9023,1390,0
9542801120,20150327T000000,278100,4,1.75,2120,8520,1600,520
8150600195,20141028T000000,450000,4,2.75,1540,4840,850,690
6806100040,20140825T000000,349950,4,2.5,2000,5006,2000,0
8857640040,20150410T000000,425000,4,2.5,2400,6053,2400,0
2138000120,20140626T000000,435000,4,2.75,2110,8751,1510,600
4022902260,20140626T000000,460000,4,2.5,2550,19017,1300,1250
2225300149,20141222T000000,323000,4,1.75,1440,8114,1440,0
3438500880,20150430T000000,325000,2,1,810,6827,810,0
1646502165,20140813T000000,480000,2,1.75,1170,4635,690,480
9541600110,20150430T000000,1.33E+06,3,2.5,3590,8400,2950,640
3348401095,20150427T000000,210000,4,1.75,2090,6485,1280,810
7579200915,20150401T000000,920000,5,4.5,3820,5750,2830,990
2126049096,20141202T000000,399000,3,1,1460,8290,1460,0
6021500025,20140818T000000,631750,3,1.75,2360,4063,1180,1180
8945000910,20150326T000000,184000,3,1,1100,8680,1100,0
2473411130,20150416T000000,333000,4,2.5,2100,7208,2100,0
2781250900,20140620T000000,218000,2,2,1310,2841,1310,0
3330500925,20150224T000000,258305,2,1.5,750,2964,750,0
9522100375,20140715T000000,775000,5,1.5,1720,5000,1720,0
1826049362,20140611T000000,515000,3,2.5,3370,19585,3200,170
1250200495,20140624T000000,455000,2,1.5,1200,1259,1000,200
5662100110,20150218T000000,440000,3,2.5,1830,6807,1830,0
2025049111,20140619T000000,1.44E+06,3,3.5,3870,3819,2760,1110
7576700131,20140714T000000,850000,3,2.25,2220,3707,1620,600
4027701265,20150501T000000,480000,3,1.75,2920,21375,1850,1070
3423059177,20141126T000000,420000,5,2.75,2540,27007,1520,1020
3876312840,20140912T000000,408000,3,1.75,1970,7100,1590,380
6928600330,20140820T000000,278000,5,1.75,2170,9752,1100,1070
5316100820,20150122T000000,1.20E+06,3,3,2350,1620,1560,790
1022059161,20140613T000000,454000,4,2.25,2630,39000,2630,0
4134300175,20150417T000000,1.85E+06,4,2.5,4120,14866,2070,2050
7853301130,20150505T000000,499000,4,2.25,2440,5000,2440,0
6928000620,20150218T000000,590000,5,3,3480,6625,3480,0
5680000750,20140730T000000,385000,3,3.5,1900,4805,1560,340
333100265,20140924T000000,1.25E+06,4,3.25,3160,10043,3160,0
3530490031,20140924T000000,202200,2,1.75,1330,2159,1330,0
6400700230,20150311T000000,450000,3,2.25,1420,13468,960,460
322069010,20150508T000000,435000,3,2,2570,233481,2570,0
2722059013,20150204T000000,550000,2,1,1270,43560,1270,0
3878900815,20150504T000000,361000,3,2.25,2470,5650,1550,920
2600010330,20150120T000000,760000,4,2.25,2590,12600,2590,0
3889100027,20140616T000000,902000,4,2.5,3030,8507,3030,0
3505100297,20150411T000000,505000,3,1.75,1240,4550,1240,0
5560001130,20150225T000000,200000,3,1,1040,8925,1040,0
1311910300,20150204T000000,260000,5,2.25,2320,6375,1270,1050
7518505160,20140925T000000,417000,2,1,1190,5100,1190,0
2115510330,20150202T000000,287500,3,2.25,2030,8690,1360,670
3955500100,20150407T000000,450000,3,1.5,1390,10530,1390,0
2771104965,20150130T000000,825000,2,1.75,2050,4000,2050,0
5317100530,20140827T000000,1.48E+06,4,3,3050,6179,2330,720
3336002215,20150225T000000,319950,2,1,1240,5500,1240,0
9408300180,20140828T000000,682000,4,2.5,3030,30000,3030,0
2770604575,20150506T000000,560000,3,1.75,1930,6000,1130,800
7305900082,20141230T000000,350000,3,1.75,1490,10344,1490,0
8661000148,20141028T000000,270000,3,2,1510,10215,1510,0
7968460230,20150305T000000,284000,3,1.75,1320,35100,1320,0
827000110,20140714T000000,308000,4,2.5,2330,4606,2330,0
3390600025,20140529T000000,450000,4,2,2240,7725,1120,1120
1026069172,20140618T000000,540000,4,2.5,2050,34222,2050,0
1226039103,20140610T000000,380000,4,1.5,1680,11123,1130,550
2125079054,20150224T000000,522500,4,2.75,2200,122403,2200,0
1545807810,20141021T000000,118000,1,1,670,7957,670,0
7205500120,20150423T000000,280400,4,1.75,1730,7210,1010,720
924069176,20140903T000000,710000,4,2.75,2710,41811,1690,1020
4045500620,20140910T000000,720000,3,3.25,3410,25741,3410,0
8146100325,20140505T000000,787000,3,1.75,1330,7500,1330,0
8663240180,20150330T000000,537000,4,2.5,1990,2660,1990,0
2087700115,20141103T000000,650000,2,1.5,1900,4450,1500,400
7973202225,20150106T000000,154200,4,1,1310,8640,910,400
2557000090,20150115T000000,238000,4,2.5,1690,7260,1080,610
3500100209,20140804T000000,285650,3,1,1040,8199,1040,0
7234601166,20140807T000000,485500,2,1.5,1340,1286,1190,150
3972900215,20150126T000000,315000,2,1,1120,7350,1120,0
1924059029,20140617T000000,4.67E+06,5,6.75,9640,13068,4820,4820
3900500110,20141117T000000,627000,3,2,2310,10525,2310,0
5561000600,20150410T000000,525000,3,2.5,2190,34528,2190,0
3589500315,20140919T000000,526000,3,3.25,1220,1281,930,290
3658700690,20150327T000000,480000,3,1.5,1200,3060,1060,140
4054560120,20141008T000000,970000,3,3.5,3840,53696,3840,0
3918400123,20140811T000000,640000,4,2.5,2460,9973,1560,900
2592300450,20140627T000000,279000,3,2.5,1630,7950,1320,310
123039424,20140710T000000,303000,2,2,970,9750,970,0
8068000730,20140625T000000,315000,4,2,1780,5336,930,850
7461420230,20150325T000000,336500,4,1.75,1760,7268,1080,680
1443501020,20141113T000000,163250,2,1,770,8150,770,0
3798000165,20150218T000000,444950,3,1,1760,6927,1050,710
730000085,20140801T000000,285000,2,1,990,2446,990,0
2061100265,20150317T000000,370000,2,1,1250,4960,940,310
1683900040,20141215T000000,330000,3,2.25,1440,5150,1440,0
3959401880,20140820T000000,395000,2,2,1960,4018,980,980
2124049160,20150416T000000,440000,6,3,2510,5310,1460,1050
7708180040,20140503T000000,625000,4,2.75,2920,6605,2920,0
1422300100,20140929T000000,435000,3,2.5,1730,46638,1730,0
255550230,20141118T000000,299950,3,2.5,1570,2577,1570,0
1370804480,20140929T000000,560000,2,1.75,970,4233,970,0
5104511590,20140520T000000,380000,4,3,2800,9764,2800,0
1498302783,20140519T000000,333000,4,2,1580,7800,1580,0
1623800300,20140610T000000,499000,2,1,1220,3000,920,300
5649600266,20150224T000000,386000,3,1.5,1550,8000,1330,220
2968801075,20140922T000000,320600,3,2,1220,7620,720,500
1923039089,20140610T000000,285000,2,2,1651,18200,1651,0
4006000183,20140909T000000,450000,7,4,3150,7800,3150,0
9183700845,20141218T000000,175000,2,1,800,7150,800,0
9558050360,20150421T000000,544800,5,2.75,3190,5857,3190,0
1683600120,20150121T000000,220000,3,1.75,1720,7587,1140,580
1604601570,20140905T000000,374000,2,2.25,1100,1695,1100,0
2787460720,20150227T000000,200000,3,2,1010,7896,1010,0
2787460720,20150506T000000,259950,3,2,1010,7896,1010,0
6386700300,20140722T000000,255000,4,2.75,1760,9222,1140,620
2297400090,20150323T000000,447000,3,1.75,1400,6750,1040,360
2420069278,20150319T000000,287000,3,2.5,1820,8722,1820,0
7276100145,20140930T000000,344950,3,2,1470,6950,1470,0
2475900850,20141010T000000,212000,2,1,770,7000,770,0
3760100100,20140723T000000,425000,5,2.75,1340,11583,1190,150
7849202585,20140904T000000,170000,1,1,480,4560,480,0
6430500291,20150212T000000,565000,3,1,1260,4080,1260,0
8151600701,20140623T000000,234000,2,1,870,11100,870,0
2597450620,20141009T000000,1.51E+06,3,2.5,4010,12105,2600,1410
1099900120,20150126T000000,345000,3,2.5,2340,8414,1280,1060
7853340450,20150427T000000,415000,3,2.75,1770,3172,1770,0
5652600065,20141010T000000,760000,5,1.75,2660,10637,1670,990
6114400142,20150226T000000,484000,5,2.5,3600,20001,3600,0
3630050180,20140926T000000,360000,2,1.75,1230,1107,1230,0
1853000300,20150224T000000,875000,3,2.75,3270,39586,3270,0
3585900785,20140514T000000,930000,3,2.5,3100,20553,3100,0
1545801970,20140516T000000,250000,3,2,1900,6660,950,950
7853340610,20150421T000000,394000,2,2,1750,2731,1750,0
8562900590,20150122T000000,865000,4,3.5,3380,11270,2160,1220
9422400035,20140912T000000,477500,2,2,2090,6000,2090,0
9273200115,20141217T000000,1.25E+06,4,2.75,4120,12500,2060,2060
3971700937,20140827T000000,270000,3,1.75,1260,7500,840,420
1508210230,20150428T000000,567000,3,2.25,1800,6875,1230,570
5249803550,20140602T000000,635000,3,2.5,1960,7200,980,980
4218400100,20140911T000000,1.87E+06,6,2.75,4460,6952,3460,1000
1424100100,20140610T000000,183000,3,1.75,1330,9200,1330,0
7861000021,20150429T000000,309933,3,1.75,1820,78408,1220,600
7856601110,20150325T000000,945800,4,2.75,3360,9100,1760,1600
1121039059,20140522T000000,503000,2,1.75,2860,59612,1510,1350
522059172,20140814T000000,220000,3,1,1460,10200,1460,0
8594400110,20150401T000000,335000,3,1.75,1900,36769,1900,0
9201000120,20150422T000000,650000,3,2.25,1790,9927,1240,550
1822059440,20150203T000000,511000,4,3.5,3100,7600,3100,0
1623089039,20141217T000000,275000,2,1,900,57063,900,0
452001570,20150403T000000,576250,2,1.75,1530,5000,1260,270
1724069079,20150319T000000,1.45E+06,2,3.25,2070,3128,1760,310
3141600210,20140619T000000,186000,3,2,1340,4320,920,420
1797500530,20150505T000000,655100,1,1,1220,4160,1220,0
7300400580,20140505T000000,328000,4,2.5,2370,6500,2370,0
1826049442,20150310T000000,441000,3,2.5,1890,11036,1460,430
2525000220,20150414T000000,370000,3,1.75,1480,7725,1480,0
191100665,20150413T000000,630000,2,1,1050,8382,1050,0
5634500201,20150414T000000,470500,4,2.25,2070,14000,1720,350
795000405,20150413T000000,285950,2,1,1170,6000,1170,0
1300300730,20150324T000000,698000,3,1.5,1090,7200,1090,0
1862900040,20140626T000000,268000,3,2.5,1650,6684,1650,0
9279700150,20150212T000000,1.63E+06,4,3.75,4410,8112,3570,840
322059311,20150330T000000,355000,4,2.5,1780,15000,1780,0
3333002710,20140917T000000,299000,3,1,1550,8778,1250,300
1257200115,20140521T000000,1.00E+06,4,2.75,2290,6120,2170,120
9183703045,20150420T000000,275000,4,2,2220,8229,2220,0
7899800905,20150503T000000,475000,3,1.75,1150,10240,1030,120
7215400770,20140623T000000,260000,4,2.5,2000,37045,2000,0
1139000215,20140718T000000,416000,2,1.75,1270,7560,1270,0
9218400088,20141119T000000,495000,5,1,1810,11205,1810,0
9455200596,20150114T000000,357500,3,1,1450,8100,1450,0
510002506,20140825T000000,459500,2,1.5,1170,1079,1170,0
7212680850,20140903T000000,258000,3,2.5,1730,6930,1730,0
5229300085,20150411T000000,600000,3,2.25,2680,98445,2680,0
7436000205,20140919T000000,665000,3,1,1260,24550,1260,0
425200205,20141003T000000,165000,3,1.5,1020,10152,1020,0
7138200150,20140518T000000,297000,5,2.5,1970,8605,1970,0
1782000180,20141023T000000,350000,2,1,830,5100,830,0
3623500205,20140513T000000,2.45E+06,4,4.5,5030,11023,3250,1780
1423200110,20150513T000000,180000,2,1,800,9450,800,0
797000256,20150407T000000,339950,3,1.75,1330,12092,720,610
9357000215,20150127T000000,365000,3,1,1030,4700,1030,0
2526069095,20140605T000000,955000,4,4.25,5660,193593,4100,1560
6908200650,20140527T000000,732000,3,2.5,2330,1987,1410,920
5021900175,20140616T000000,500000,3,1.75,1540,10800,770,770
4038700220,20150213T000000,610000,6,2.75,2040,8560,1100,940
9455200205,20140604T000000,525000,3,2,1540,7800,1540,0
5379804470,20140617T000000,170000,4,1,1920,13787,1220,700
2517000150,20140713T000000,300000,3,2.5,1870,3439,1870,0
9264930770,20141029T000000,389500,5,3.5,2960,12527,1940,1020
4197400043,20150219T000000,330000,3,1.5,1690,10250,1690,0
2329800330,20141114T000000,269950,3,2.25,1610,7187,1610,0
7899800450,20140828T000000,107000,2,1,670,4720,670,0
2895110062,20141202T000000,249000,3,1,1752,14626,1752,0
3448001285,20140818T000000,442500,4,2,1540,5920,1540,0
521079025,20150417T000000,579000,3,2.5,3160,286181,3160,0
624069098,20150121T000000,621500,3,1.75,2570,39634,2570,0
2946003580,20141119T000000,203000,3,1.5,1370,7500,1080,290
7227500450,20140909T000000,222900,2,1,860,5800,860,0
2322069100,20150409T000000,453000,2,1.5,1680,17400,1680,0
2144800615,20140625T000000,190000,1,0.75,930,29258,930,0
1432900150,20150406T000000,320000,4,1.75,1820,7381,1150,670
7942601810,20141210T000000,733500,3,1.5,2120,4370,2120,0
7302900090,20150218T000000,555000,4,2.25,3330,21785,3330,0
2310050110,20141215T000000,364950,3,2.25,2520,6170,1850,670
6743700090,20141120T000000,490000,3,1.75,1560,9247,1160,400
3935900093,20150427T000000,688000,5,1.75,2250,13526,1350,900
123039279,20140711T000000,165000,2,1,640,7768,640,0
4307350730,20141113T000000,506000,5,3.75,3880,8370,3880,0
1954700610,20141209T000000,2.19E+06,3,2.25,3360,7108,2770,590
8155500110,20150429T000000,754000,5,1.75,2350,7800,1510,840
7129303045,20150417T000000,949950,5,2.5,2340,1989,2340,0
6021503451,20140822T000000,443600,3,2.5,1430,1056,1430,0
3793400360,20140814T000000,380600,3,2.5,1920,12244,1920,0
7504101280,20150126T000000,722800,3,3.25,4330,14600,3630,700
3331500121,20150210T000000,342888,2,1,790,5150,790,0
438000015,20140916T000000,555000,4,1.75,2350,5946,1350,1000
5366200205,20140603T000000,613000,3,2.5,1350,3068,1350,0
2026049067,20140702T000000,480000,3,2,1470,10052,1470,0
3885808035,20150316T000000,619500,6,1.5,1680,5202,1680,0
1494300040,20140624T000000,437000,4,2.5,1890,8505,1290,600
6071200195,20150408T000000,621000,4,2.5,2030,9905,2030,0
1257202215,20140714T000000,810000,4,1.75,1760,4080,1760,0
5589300145,20140527T000000,415000,3,2.25,1950,8868,1350,600
293000145,20141113T000000,250000,4,1,1440,7404,1080,360
4315701163,20150413T000000,585000,3,1.5,2230,6000,1260,970
6163900981,20140528T000000,220000,3,1,1180,5002,1180,0
4157600120,20150422T000000,580000,5,2.5,2500,11900,1400,1100
3262301355,20140725T000000,1.32E+06,3,2.75,2680,20104,1820,860
4376700330,20140801T000000,675000,4,2.5,2040,9225,1610,430
8691370330,20141029T000000,695000,4,2.75,2660,7389,2660,0
5078400090,20141209T000000,915000,5,2.75,2580,7630,1730,850
5272200040,20141121T000000,375000,3,1,1000,6947,1000,0
2997800015,20150407T000000,500000,3,1.5,1330,1265,1140,190
2780900220,20141226T000000,335000,2,2,1420,5185,1420,0
4463400195,20140718T000000,170000,2,1,1280,21750,1280,0
844001485,20150429T000000,320900,5,2.5,2200,8500,1400,800
8123450300,20150306T000000,508000,3,1.75,1800,8462,1440,360
7137800300,20140708T000000,228950,3,1.75,1200,9085,1200,0
7972600910,20150507T000000,433000,4,2,1840,4760,1080,760
7452500770,20140908T000000,267500,2,1,960,5150,960,0
5250300035,20141008T000000,910000,4,1.5,2890,9000,2090,800
9517200610,20150303T000000,370000,3,1.75,1290,10117,1290,0
952004570,20141206T000000,320000,2,1,1140,3834,1140,0
579002600,20141001T000000,660000,3,1.75,1750,5200,1750,0
4351300978,20140826T000000,787888,4,2.25,2580,21115,2580,0
1152700090,20141218T000000,329000,4,2.5,2650,5880,2650,0
3179100720,20141203T000000,602000,2,1,1470,6398,970,500
5628300015,20141106T000000,375000,3,2,1640,9750,1640,0
1900000035,20150505T000000,212000,1,1,620,7620,620,0
1105000432,20140822T000000,224000,3,1.5,1440,8370,1440,0
1402810150,20150310T000000,315500,3,2,1160,10079,1160,0
2163900028,20150128T000000,350000,2,1,1070,2880,1070,0
5409000110,20150506T000000,389000,6,4.5,3560,14010,3560,0
8687800100,20140713T000000,285000,3,1.75,1720,13104,1720,0
8563300085,20141201T000000,425000,3,1.75,1530,9800,1530,0
7140200330,20150309T000000,190000,3,1.75,1270,7875,1270,0
2124069103,20150505T000000,374000,3,1.75,1510,18439,1510,0
1703401110,20140807T000000,292000,2,1,880,5500,880,0
6046400755,20150511T000000,475000,5,1.75,2020,5100,1320,700
5309100450,20150330T000000,546500,3,2.5,1410,2675,820,590
3883800011,20141105T000000,82000,3,1,860,10426,860,0
3883800011,20150408T000000,219900,3,1,860,10426,860,0
4315700175,20140612T000000,440000,3,1,1210,5750,1210,0
221029019,20150428T000000,400000,3,2.5,2090,32718,1550,540
4035900085,20141117T000000,453000,3,1.75,1430,20193,1430,0
3438500781,20140812T000000,330000,6,3.25,2120,6893,1060,1060
8097000330,20140721T000000,359950,3,2.75,2540,8604,2540,0
8677300720,20140617T000000,616000,4,2.5,2490,12929,2490,0
3644100072,20141107T000000,245000,2,1,670,2356,670,0
1453602284,20141103T000000,296000,2,2,1320,2040,1320,0
4365700450,20141106T000000,193000,2,1,950,9000,950,0
9268200315,20140828T000000,456000,3,2,1870,8442,1060,810
4358700141,20150427T000000,480000,4,1.75,1840,9250,980,860
4310701577,20140509T000000,382000,3,3.25,1410,1253,1410,0
9828200762,20140628T000000,650000,2,1,1050,2542,880,170
2026049097,20141125T000000,431750,2,2,1400,10052,1400,0
6639900219,20150511T000000,419900,3,2.5,1630,1755,1320,310
2521039066,20141229T000000,315000,3,2,1900,9513,1900,0
5649300120,20150420T000000,597500,4,3,1890,35280,1510,380
1774230300,20150306T000000,615000,3,2.5,2980,43301,1930,1050
7313200120,20141031T000000,605000,4,3.25,2885,33671,2885,0
4137010540,20150401T000000,220000,3,2.5,1980,11900,1980,0
7844200120,20150413T000000,340000,4,2.5,3020,8750,1710,1310
1923099058,20141015T000000,620000,4,2.5,2980,210395,2980,0
7922710690,20140519T000000,602000,5,1.75,3290,11900,3290,0
2624049165,20140513T000000,575000,3,1.75,1580,11750,1180,400
7575600100,20140502T000000,285000,3,2.5,2090,10834,1360,730
3450400330,20150220T000000,306500,3,1.5,1100,8140,1100,0
4307300930,20150102T000000,325000,3,2.5,1870,3480,1870,0
3288301030,20150319T000000,623000,3,2.75,2390,21804,1450,940
5466350120,20150311T000000,256500,3,2,1320,8568,1320,0
3791410210,20141117T000000,473000,5,3.5,3430,6872,2830,600
1795900120,20141029T000000,549000,3,2.5,2250,9235,2250,0
8656300385,20150317T000000,305000,3,1,1710,19115,1710,0
6649250410,20150204T000000,317000,4,2.5,2160,8049,2160,0
1426049054,20140701T000000,450000,3,1.75,1400,13775,1400,0
7841300535,20150409T000000,225000,2,2.5,1560,5333,780,780
2867700035,20150212T000000,500000,5,2,2300,7897,2300,0
2658000215,20140812T000000,207000,2,1,820,4860,820,0
7100000120,20140818T000000,474900,3,1,1630,8308,1630,0
200300210,20140701T000000,515000,3,2.5,2010,7200,2010,0
1868903130,20150212T000000,542000,4,1,1540,5000,1090,450
7385310040,20140605T000000,725000,4,2.75,2420,10962,1530,890
5104510210,20150309T000000,314950,3,2.5,1690,4533,1690,0
9517200180,20141106T000000,375000,3,2,1410,10078,1410,0
1725079061,20140710T000000,500000,3,1.75,1640,47044,1640,0
2141310820,20140624T000000,689000,3,1.75,2200,9840,1500,700
2902200234,20141209T000000,525000,3,2.25,1290,1182,1000,290
1443500395,20150504T000000,360000,3,1.5,1060,6232,1060,0
2391601010,20140820T000000,425000,3,1,1240,5750,1240,0
7129303970,20150304T000000,239950,2,1,1280,5500,1280,0
567000025,20150402T000000,577500,2,2.5,2330,3000,2330,0
2493200195,20140502T000000,615000,3,1.75,2360,7291,1360,1000
8562901250,20140827T000000,516000,4,2.75,2210,10800,1170,1040
2600020330,20140813T000000,1.22E+06,4,2.75,3670,15400,3670,0
1370801520,20140527T000000,1.66E+06,4,3.5,3080,4815,2300,780
5589900761,20150501T000000,315000,2,1,770,6731,770,0
3601800580,20141021T000000,250000,4,2,2600,9000,1410,1190
3336000296,20141113T000000,250000,4,1.5,1220,4900,1220,0
1525059020,20150410T000000,925000,4,2.5,2910,48351,1910,1000
6150200330,20140825T000000,358000,3,1,1150,4681,1150,0
4136950180,20140926T000000,262000,3,2.5,1700,6200,1700,0
259600790,20141015T000000,500000,3,1.75,1220,7370,1220,0
2770604925,20140715T000000,1.30E+06,5,1,1670,6400,1670,0
6902000100,20140915T000000,500000,3,1.75,2420,65501,2420,0
3275850180,20140602T000000,675000,3,2.25,2610,9002,2610,0
4154300296,20140926T000000,235000,3,1,960,5030,960,0
4154300296,20150318T000000,545000,3,1,960,5030,960,0
3888100043,20140507T000000,350000,3,1,1010,9360,1010,0
8165501510,20141125T000000,320000,2,2.25,1550,1827,1550,0
5152700120,20150318T000000,452000,5,2.5,5067,13315,3154,1913
1962200475,20140725T000000,875000,3,2,2350,6000,1990,360
272000355,20141108T000000,325000,3,1.5,1310,2998,1310,0
5113400113,20140619T000000,756000,4,2.25,2160,5600,1080,1080
6669010120,20140624T000000,319000,4,2.5,2510,7992,1610,900
7170200110,20150121T000000,455000,3,1.75,890,3800,750,140
2113700025,20150409T000000,330000,2,1,1129,3840,1129,0
7197000100,20150108T000000,510000,4,3.25,1980,9988,1340,640
7577700061,20150416T000000,532000,3,1,2360,5012,1560,800
1862400215,20150120T000000,775000,3,2.5,2480,5007,1960,520
3726800201,20150417T000000,410000,3,1.75,2160,4000,1080,1080
13002460,20150318T000000,205000,2,1.75,1740,5100,580,1160
5151200215,20141212T000000,585000,4,2.5,2430,6766,2430,0
8731983200,20150310T000000,255000,2,1.75,1950,8200,1950,0
5309101395,20140911T000000,415000,2,1,910,3750,910,0
4364700945,20150402T000000,459000,4,2,2360,7080,1180,1180
395300330,20141211T000000,354000,3,1,1130,11250,1130,0
3295730040,20140715T000000,587000,3,2.5,2150,5193,2150,0
7937600395,20140708T000000,782000,4,3.5,5270,53428,3440,1830
1236300146,20150504T000000,570000,3,1.5,1300,7287,1300,0
8024200625,20150205T000000,414500,3,1,1050,6002,840,210
7340600845,20140806T000000,185000,4,1,1380,6700,1190,190
898000220,20141001T000000,262500,3,1.5,1610,10291,1610,0
2212600100,20140522T000000,370000,4,2.75,3150,67518,2250,900
6412100092,20150105T000000,362500,3,1,1520,9507,1520,0
8835350300,20150304T000000,536000,3,2.5,1990,7397,1990,0
2586800210,20150421T000000,425000,5,2,2500,7804,1570,930
2044500201,20140609T000000,435000,3,2.25,1890,7200,1230,660
6450303950,20140505T000000,435000,5,2,1840,9240,1540,300
3013300409,20150312T000000,400000,2,1,1220,6300,760,460
1934800087,20140626T000000,446000,2,1.5,1370,1221,1080,290
1125049140,20150126T000000,1.25E+06,3,2.5,2710,13120,2710,0
2025700180,20141120T000000,300000,3,2.25,1760,5421,1760,0
8024201055,20140806T000000,404500,2,1,800,5080,800,0
2426059097,20150305T000000,910000,4,2.5,3530,49222,3530,0
9829200855,20140513T000000,771000,3,2.25,1780,6120,1390,390
1864940180,20140605T000000,335000,4,2.5,2610,4781,2610,0
1023089085,20140804T000000,390000,3,1.75,1850,15170,1850,0
4399200100,20150428T000000,288000,3,2.25,1560,9706,1560,0
1087500040,20141014T000000,403000,3,1.75,1270,10790,1270,0
1972201965,20140624T000000,510000,3,2.25,1420,1309,1420,0
272000085,20150219T000000,751000,6,3,2880,6800,2880,0
7129302806,20150203T000000,408000,3,1,1420,8000,1420,0
4389201021,20140701T000000,1.01E+06,3,1,1640,12855,1500,140
6751300385,20150424T000000,575000,3,2,1730,9030,1730,0
723049274,20150417T000000,330000,3,1.75,1250,8100,1250,0
2767602094,20140516T000000,565000,3,2.25,1520,1221,1520,0
8635760330,20150413T000000,456000,3,2.5,1820,2935,1820,0
3905010100,20140615T000000,652500,4,2.5,2700,9122,2700,0
2493200215,20141231T000000,582000,3,1.75,1820,3140,1820,0
8691390530,20140625T000000,700000,4,2.5,2770,5686,2770,0
4319200620,20141015T000000,235000,2,1,1270,9182,1270,0
424069096,20140731T000000,460000,3,1.75,1400,12155,1400,0
8121200820,20140522T000000,475000,3,2.25,1820,8008,1240,580
8682231110,20140609T000000,579000,2,2,1870,6275,1870,0
2767602645,20141110T000000,507000,4,2,1360,2746,1360,0
7131300035,20140512T000000,210000,3,2.5,1040,2643,720,320
2595650100,20140630T000000,359500,4,2.75,2140,10316,2140,0
2616700450,20141107T000000,248000,3,1.75,1330,9831,1330,0
2520900301,20141022T000000,239300,3,1,1070,5750,1070,0
1473200150,20141216T000000,315000,3,2.25,1370,1533,1370,0
1726600150,20150226T000000,970000,4,3,3510,12410,3510,0
9169600110,20150317T000000,510000,3,1.5,1730,6240,1000,730
4036800580,20140621T000000,418000,4,1.5,1550,9176,1000,550
2324800110,20140612T000000,699000,4,2.5,3280,27441,3280,0
7855800910,20150321T000000,871000,4,2.5,2150,8536,1400,750
3625059140,20140507T000000,515000,3,1.75,1580,9147,1210,370
1200021,20140811T000000,400000,3,1,1460,43000,1460,0
9455200790,20141209T000000,445000,3,1.75,1410,5100,1110,300
2021200530,20150225T000000,1.11E+06,4,2.75,3090,6600,1800,1290
7760600110,20141027T000000,212000,3,1.5,1690,9600,1210,480
9323610110,20150112T000000,710000,4,2.5,2870,11304,2870,0
1612500090,20150331T000000,225800,4,1,1100,7110,880,220
4027700594,20141222T000000,520000,3,1.75,2310,36665,1580,730
1924059254,20150508T000000,1.30E+06,5,3.75,3490,15246,1940,1550
2172000846,20140619T000000,248000,4,2,2080,13510,1040,1040
514500195,20141016T000000,556000,4,2.5,2230,7200,1220,1010
8151600142,20150512T000000,319950,5,1.75,1710,11900,1070,640
7950304045,20150331T000000,320000,4,2.75,1640,3000,1000,640
6700390210,20140708T000000,245000,3,2.5,1600,2788,1600,0
2195700230,20150203T000000,700000,3,2.5,2850,36585,2850,0
558100090,20150312T000000,628000,5,2.75,2600,8160,2600,0
2749600245,20140617T000000,640000,3,2,1380,4800,1380,0
1782500065,20150428T000000,420000,4,1.75,1320,4978,940,380
263000329,20141008T000000,349950,3,2.5,1420,1162,1420,0
9432900180,20140714T000000,307999,4,2.75,2420,8438,2420,0
142000165,20140507T000000,749950,4,2.75,2600,6050,1960,640
6145600410,20140711T000000,290000,2,1,840,3844,840,0
2599001500,20140712T000000,235000,3,1.75,1420,7920,1420,0
1721801010,20140903T000000,225000,3,1,1790,6120,1790,0
1721801010,20150424T000000,302100,3,1,1790,6120,1790,0
5101404491,20150212T000000,520000,2,1,1340,6380,890,450
326049111,20140626T000000,285000,2,1,1010,7200,1010,0
1785400300,20140821T000000,525000,3,2,1640,15258,1640,0
1310980580,20150319T000000,374900,5,2.75,2980,8500,1540,1440
6632300230,20141006T000000,377500,3,2,1370,7200,1130,240
9324800650,20150427T000000,587450,3,2.25,2190,8775,2190,0
2188201010,20150121T000000,245000,3,2.25,1530,12000,1070,460
7137910360,20140729T000000,200000,3,2,1290,5757,1290,0
125069038,20141125T000000,2.14E+06,4,3.75,5150,453895,4360,790
9465910150,20141109T000000,607000,3,2.5,2470,9226,2470,0
724069023,20150414T000000,1.25E+06,1,1.25,1810,5070,1230,580
6600220150,20150310T000000,549950,4,2.5,2230,14694,1180,1050
7227800025,20141118T000000,250000,3,3,2300,7701,2300,0
3905040220,20140509T000000,525000,3,2.5,2030,6970,2030,0
5072300210,20140624T000000,440000,3,1.75,2000,9900,1480,520
121039042,20150313T000000,425000,3,2.75,3610,107386,3130,480
6705870120,20140701T000000,739900,5,2.5,3290,5029,3290,0
1109000040,20140528T000000,315000,3,2,1300,3731,900,400
9358001590,20150303T000000,340000,5,1,1880,3774,1360,520
705700580,20150501T000000,366000,4,2.75,2170,9743,2170,0
4343800100,20141021T000000,315000,3,1.75,1680,7250,930,750
3343900781,20141027T000000,299000,3,1.5,1190,9135,1190,0
1062100085,20141113T000000,350000,2,1,940,5000,940,0
6821101827,20141105T000000,340000,2,1.75,1010,1461,670,340
3901100015,20141230T000000,460000,3,1.75,1290,8580,1290,0
9500900110,20140731T000000,224000,3,1.5,1480,10588,1480,0
4006000401,20140811T000000,140000,2,1,900,6400,900,0
1218000025,20141013T000000,246000,4,2,1400,7632,1400,0
1875500040,20150127T000000,330000,3,2.5,2040,14071,2040,0
7955000210,20140709T000000,306000,3,1,1450,7200,1010,440
7568700175,20140604T000000,324950,3,1,1210,7440,1210,0
3410600100,20140613T000000,345000,2,1.5,1800,26615,1240,560
923049378,20140508T000000,207000,3,1,1490,8995,1490,0
420000085,20140827T000000,238000,3,1,1240,5700,1240,0
2817210210,20150401T000000,695000,3,2,2632,18743,2632,0
2141340040,20140911T000000,649950,3,2.5,2150,15304,2150,0
714000315,20150414T000000,515000,3,2.75,1710,9448,1010,700
263000040,20141001T000000,452000,3,2.5,1530,5032,1530,0
1721801161,20141030T000000,236000,4,2.5,1630,3060,1630,0
4139490210,20140730T000000,1.29E+06,4,3.5,4080,14450,3210,870
6790900110,20140610T000000,563000,3,2.75,2340,16500,1500,840
1775800220,20150402T000000,410988,3,1.75,1000,14061,1000,0
2569500210,20141117T000000,339950,0,2.5,2290,8319,2290,0
4141000490,20141021T000000,1.20E+06,4,2.5,3180,13118,3180,0
8078100120,20150319T000000,340000,4,2.5,2170,19785,2170,0
3034200666,20141107T000000,808100,4,3.25,3020,13457,3020,0
8892900210,20140609T000000,236000,3,1.75,1330,6301,1330,0
7399000360,20150513T000000,330000,4,1.75,1720,8300,1720,0
3491300082,20150127T000000,799990,4,3.5,2540,5808,1820,720
2310060040,20140925T000000,240000,0,2.5,1810,5669,1810,0
323059146,20150417T000000,343000,3,1,1410,18600,1410,0
1079350090,20140617T000000,332000,3,2.5,1530,9406,1270,260
98000740,20150401T000000,945000,5,3.5,4380,14925,4380,0
5126400150,20140617T000000,239950,3,1,1140,8366,1140,0
8815400165,20150303T000000,674000,5,1.75,2110,5000,1250,860
421000555,20140520T000000,200000,3,1,1050,5000,1050,0
686300930,20150305T000000,453000,3,1.75,1600,7232,1600,0
2744600040,20140614T000000,330000,3,1.75,1430,8865,1430,0
3832070040,20150416T000000,285000,4,2.5,1996,4547,1996,0
7305300090,20141106T000000,338000,4,1.75,1530,8152,910,620
7452500730,20150424T000000,264950,2,1,1000,6000,1000,0
1824059079,20150311T000000,880000,4,2,2530,10800,1350,1180
3438503426,20150406T000000,209500,3,1.5,970,5488,970,0
8948500025,20150425T000000,380000,4,2.5,2400,9398,1310,1090
1722059021,20141217T000000,336500,3,2,1830,12891,1830,0
8899210090,20140714T000000,360000,3,2.25,2130,8466,1290,840
4019300155,20140821T000000,911100,4,3.25,3330,33826,3330,0
4364700165,20141124T000000,249900,2,1,560,7560,560,0
796000085,20140923T000000,175000,4,1,1210,6250,1210,0
7987401095,20141113T000000,549950,3,2.5,2380,2500,2380,0
1237500540,20141021T000000,225000,3,1.75,1370,10866,1370,0
1237500540,20141222T000000,270000,3,1.75,1370,10866,1370,0
3649100304,20140819T000000,400000,3,2.25,1740,11040,1740,0
7400062,20140521T000000,299800,2,1,790,5240,790,0
6388910730,20140806T000000,555000,3,2.5,2480,8676,2480,0
7882900120,20140507T000000,230000,3,2.5,1920,9180,1920,0
1865000040,20141210T000000,360000,4,2.5,2750,6259,2750,0
6821100246,20140903T000000,415000,2,1,880,3200,880,0
8731981500,20140818T000000,355000,4,1.75,2160,8000,1660,500
6979910120,20150323T000000,635000,4,2.5,2570,27972,2570,0
2123700100,20141202T000000,353000,5,2.75,2130,5000,1100,1030
3425059141,20140528T000000,999000,7,4,3150,34830,3150,0
3876600120,20150422T000000,265000,3,1.5,1780,10196,1270,510
4038000040,20150326T000000,250000,4,1.75,1910,8250,1910,0
6668900155,20140820T000000,225000,2,1,1170,7142,1170,0
8132700150,20140503T000000,553000,2,1,900,5000,900,0
4038800580,20140604T000000,565000,5,2.5,2650,11455,1400,1250
3331001910,20140818T000000,312000,2,1,1170,5150,980,190
2726079103,20140722T000000,475000,3,2.5,2630,185130,2630,0
7212651210,20141106T000000,320000,4,2.75,2150,9163,1340,810
2026059119,20140825T000000,453000,3,2,1430,9583,1430,0
3330501120,20150325T000000,320000,3,1,960,6180,960,0
1250202324,20150122T000000,610000,4,2.75,2640,8400,1440,1200
3815500035,20140520T000000,385000,3,1.5,1490,9630,1490,0
5706600150,20140528T000000,215000,3,1.75,1210,8075,1210,0
8005100540,20140709T000000,215000,4,1.5,1860,5040,1860,0
293720180,20141230T000000,415000,3,2.5,1980,4274,1980,0
5101405604,20140814T000000,350000,1,1,900,6380,900,0
5101405604,20150428T000000,395000,1,1,900,6380,900,0
2387000110,20141110T000000,898000,2,1.75,1490,9874,1490,0
7238000330,20141218T000000,480000,3,2.5,2980,7338,2980,0
3879901295,20141110T000000,1.24E+06,3,2.5,2660,1973,1870,790
326069131,20140611T000000,599000,4,2.5,2790,230868,2790,0
629811340,20150508T000000,770000,4,3,2800,9127,2800,0
9808700650,20150313T000000,1.21E+06,3,2.25,1590,8520,1590,0
8964800755,20150116T000000,1.59E+06,4,2.25,3240,11131,2080,1160
1126059095,20140526T000000,880000,3,2,2130,35169,2130,0
1899400365,20140620T000000,332000,3,2,1510,7884,1510,0
259800410,20141106T000000,445000,3,1.75,1750,7200,1750,0
3523069047,20140825T000000,849000,4,2.75,4010,87555,4010,0
6852700476,20141211T000000,752000,4,1.5,1650,2970,1650,0
424049043,20140811T000000,450000,9,7.5,4050,6504,4050,0
7646900360,20140918T000000,420000,3,1,1320,5500,1320,0
2991000220,20150317T000000,330000,4,2.5,2310,6320,2310,0
3034200366,20141203T000000,409000,3,1.75,1440,9065,1440,0
5127000410,20140627T000000,350000,5,1.75,2330,14322,1180,1150
2826079101,20150415T000000,570000,4,2.5,2430,44001,2430,0
3972900195,20140916T000000,315000,3,1,1390,8333,1390,0
8018600870,20141006T000000,224000,2,1,1150,15000,1060,90
257000038,20141006T000000,293550,4,1.75,2120,9706,1370,750
7981900110,20141003T000000,350000,4,2.75,2300,3175,1340,960
8965500880,20140916T000000,1.11E+06,4,2.5,3320,9380,3320,0
5253300437,20150319T000000,442500,4,2.5,2400,7092,2400,0
2523069172,20140804T000000,616500,3,2.5,3580,118047,3240,340
6388910360,20141119T000000,506400,3,2.5,2100,9040,1700,400
7326200110,20141222T000000,324000,3,2.25,1550,4411,1550,0
3701900085,20140805T000000,169000,3,1.5,1570,6450,1570,0
9376301520,20140529T000000,595000,3,2,1480,5000,750,730
2111000580,20140521T000000,299900,3,2.5,2720,6014,2720,0
8645510230,20140529T000000,332000,3,2.25,2270,8876,1380,890
6204410330,20141020T000000,432000,4,1.75,2410,8400,1600,810
8159300040,20141002T000000,510000,4,2.75,2730,9112,1740,990
8091410530,20150501T000000,270000,3,2.5,1540,7739,1540,0
8653600100,20150330T000000,750000,5,2.5,3120,15593,3120,0
9550202730,20141014T000000,509250,2,1.5,1480,3120,930,550
8651410740,20150219T000000,189000,3,1,860,5200,860,0
225039177,20141208T000000,726500,4,2.5,2180,3893,2180,0
6082400191,20140619T000000,287000,3,2,1300,11374,1300,0
3622069095,20140917T000000,679000,4,3.5,3420,49223,3420,0
6666860210,20140602T000000,316000,3,2.25,2130,8721,1570,560
8161000230,20150427T000000,498000,4,2.5,2300,22445,2300,0
7214820610,20141007T000000,448000,4,1.75,2560,8270,1480,1080
434000040,20140527T000000,535000,2,1,1040,5527,1040,0
8914200220,20150116T000000,560000,4,3,3080,9601,3080,0
6072760210,20141002T000000,437850,4,2.25,2670,14255,1610,1060
9485950040,20140606T000000,435000,4,2.75,3270,50994,2720,550
4027700456,20140619T000000,510000,4,2.5,2610,8031,2610,0
1023059365,20140506T000000,520000,3,2.5,2460,54885,2460,0
8944600620,20140703T000000,509000,2,1.5,1930,3521,1930,0
2997800090,20150406T000000,575000,3,1,1220,5652,1220,0
2787700150,20150422T000000,365000,4,2.5,2030,7210,1330,700
4055701110,20140612T000000,795000,3,2,2420,17859,1500,920
2517000790,20140611T000000,285000,3,2.5,1870,4060,1870,0
2125059124,20140602T000000,955000,3,2.25,3020,43560,2720,300
7284900405,20140714T000000,775000,4,2.5,2880,8400,2050,830
3937900120,20141006T000000,400000,4,3,1810,5012,1810,0
200520120,20140701T000000,570000,4,2.5,2590,8483,2590,0
7203220360,20141020T000000,955990,5,3.25,3830,6507,3830,0
3425059219,20140929T000000,1.15E+06,3,2.25,3250,34848,2260,990
5469502170,20150414T000000,459950,4,2,2760,21465,2120,640
6303401395,20150219T000000,245000,2,1.75,1220,8382,1220,0
8822901301,20140908T000000,281000,3,1.5,1280,974,1280,0
6730700385,20141022T000000,205000,3,0.75,770,7000,770,0
4396000530,20140611T000000,290000,3,1.75,1520,15090,1520,0
4077800590,20150226T000000,635000,4,2.5,2080,11176,2080,0
2461900845,20140903T000000,310000,1,1,570,6000,570,0
5366200330,20150114T000000,470000,4,2,1500,3659,830,670
6899990230,20140701T000000,600000,2,2.5,2510,14878,2510,0
7950700120,20141217T000000,279000,4,2,1980,10051,1980,0
7852090180,20140804T000000,538500,3,3.5,2500,4270,2500,0
3066410850,20140709T000000,594950,4,2.5,2720,10006,2720,0
2422059015,20140808T000000,533050,2,1,910,295772,910,0
7436500360,20140606T000000,510000,3,1.75,1480,7040,1480,0
984210590,20140929T000000,360000,4,2.25,2470,8686,1270,1200
8024202350,20140721T000000,435000,2,1,1650,5106,1090,560
6392002020,20150324T000000,559000,3,1.75,1700,6500,1700,0
6398000191,20140827T000000,645000,2,1.5,1995,115670,1995,0
3904100065,20141028T000000,340000,2,1,1280,9690,640,640
5535600150,20150312T000000,565000,4,2.5,2980,10459,2980,0
8024200820,20150213T000000,575700,3,1.75,1730,6130,1480,250
9301300215,20140617T000000,1.01E+06,3,3.25,2420,1923,1840,580
1122069006,20140710T000000,540500,3,2,2800,185130,2320,480
5379801972,20140818T000000,265000,5,4,1400,8580,900,500
4077800088,20140811T000000,699950,4,2,2070,7830,1180,890
1823069059,20140611T000000,355000,1,1.75,750,20339,550,200
7979900215,20140611T000000,381000,3,1.5,1460,11407,1460,0
5101404444,20150414T000000,564000,5,2.25,2140,8700,1220,920
892000025,20140710T000000,114975,2,1,740,6250,740,0
6303400395,20150130T000000,325000,1,0.75,410,8636,410,0
2320069189,20141027T000000,299990,2,1,1570,125452,1570,0
2568200610,20150513T000000,751000,5,2.75,2860,5280,2860,0
6073230230,20141231T000000,425000,3,2.25,1400,6970,1400,0
1024049006,20150114T000000,665000,3,1.75,2700,5040,1560,1140
823069044,20150325T000000,833450,5,4,4460,269345,3330,1130
2926049086,20141028T000000,575000,7,1.5,2670,11250,2320,350
5127001320,20141125T000000,190000,3,1.75,1520,9600,1520,0
5127001320,20150223T000000,314950,3,1.75,1520,9600,1520,0
1994200375,20141203T000000,601150,2,2,1660,5200,1120,540
7100000035,20141212T000000,315000,2,1,860,8308,860,0
6329000705,20150402T000000,545000,2,1.5,2340,13380,1280,1060
7524950870,20140519T000000,565000,4,2.25,2110,10698,2110,0
9564800145,20140506T000000,175000,3,1,1010,7034,1010,0
2077700042,20140626T000000,530000,3,2,2330,26571,2330,0
3835500195,20140618T000000,4.49E+06,4,3,6430,27517,6430,0
259000100,20141007T000000,430000,3,1.75,1610,7900,1310,300
1796360870,20141030T000000,225000,3,1.75,1460,8372,1460,0
923049440,20140717T000000,312000,5,4,2900,9779,1950,950
9144100298,20150302T000000,380000,3,1,1260,7980,1260,0
3223049158,20150417T000000,222200,2,1,1210,10000,1210,0
5456000025,20141201T000000,1.44E+06,5,3.5,3420,8000,3420,0
3558000120,20140702T000000,329950,4,2.5,2120,4558,2120,0
6133100120,20140923T000000,995000,3,2.5,2460,10300,2460,0
5608000590,20140714T000000,929950,3,3.5,3790,10829,3790,0
8651480090,20150327T000000,692000,4,2.5,2350,9779,2350,0
2768301490,20140626T000000,402000,2,1,620,2475,620,0
3325069060,20140912T000000,510000,3,1.75,1920,43560,1340,580
8802400411,20140619T000000,249000,3,1,1050,8498,1050,0
2953000090,20141202T000000,244900,3,1.5,1360,9980,1360,0
7657600025,20150219T000000,289900,3,1,1180,7068,1180,0
8118600025,20150331T000000,552500,4,1,1560,7980,1170,390
326069118,20140630T000000,760000,4,2.5,3300,165528,3300,0
2902200838,20141027T000000,440000,2,2.75,1100,1088,750,350
798000062,20140801T000000,286000,3,1.75,1770,9000,1090,680
3298700941,20140905T000000,260000,3,1,1200,4592,800,400
114100155,20140627T000000,355000,2,2.25,1330,10838,1330,0
5151600360,20150130T000000,318000,3,1.75,1570,12506,1570,0
523049106,20140826T000000,255000,2,1,1610,19965,1610,0
3751600025,20140514T000000,139000,3,1,1100,17334,1100,0
6918730230,20150401T000000,485000,4,2.25,1810,7068,1810,0
3226079059,20141019T000000,549950,3,1.75,2930,266587,2440,490
9521100880,20140916T000000,588000,3,1.5,1780,4200,1780,0
425049146,20140715T000000,975000,3,2.5,3050,7410,1950,1100
3630010040,20140523T000000,402000,3,2,1540,1827,1540,0
6620400025,20150501T000000,245000,3,1,1380,9875,1380,0
8886000021,20140616T000000,445000,3,1.75,1890,32340,1890,0
766800090,20140525T000000,195000,3,1.75,1570,8459,1570,0
4022900571,20150112T000000,385000,5,2,2540,11750,1480,1060
2206700165,20140716T000000,450000,3,1.5,1520,7903,1000,520
4151800530,20141028T000000,1.09E+06,4,2.5,2780,6837,2780,0
8122600195,20140520T000000,396675,2,1,1730,6375,1730,0
5379805160,20141002T000000,242000,5,2.25,2340,7494,1170,1170
323089095,20141031T000000,380000,3,1.75,1300,12378,1300,0
9000025,20141203T000000,496000,2,1,1420,4635,1420,0
8835200330,20141208T000000,399950,3,2.5,1470,4488,1470,0
1239400064,20150304T000000,895000,4,2.5,2850,8526,2850,0
2719100115,20141104T000000,690000,3,2,2360,6149,1560,800
5589300361,20140902T000000,270000,3,1.5,1610,8375,1610,0
2523069146,20140623T000000,349900,3,2,2420,38781,1210,1210
3630020090,20150504T000000,454280,3,2.5,1470,1741,1170,300
1775700011,20150512T000000,390000,3,2.5,1410,26375,1410,0
9264921110,20150115T000000,275000,3,1.75,1840,14005,1840,0
6837820330,20150429T000000,300000,4,2.5,2450,8932,2450,0
6822100750,20150508T000000,700000,3,1.75,1500,6000,850,650
6769200040,20141218T000000,520000,3,1.75,2080,6609,1280,800
1668500090,20150402T000000,715000,3,2.5,2770,39529,2770,0
5104530220,20150420T000000,404000,3,2.5,2370,4324,2370,0
726059048,20140926T000000,490500,3,2,3000,21883,1970,1030
8835401250,20150506T000000,1.49E+06,6,2.75,4430,6440,2680,1750
6821100090,20150409T000000,557800,4,1.75,1550,6000,1550,0
5072400100,20150413T000000,571000,4,2.25,2290,9900,1550,740
2781200090,20140708T000000,410000,4,2.5,2560,4020,2560,0
4006000580,20150313T000000,225000,3,1.5,1240,5506,1240,0
3825310530,20140716T000000,700000,4,2.5,2590,4498,2590,0
3797000745,20150209T000000,500000,3,1,1370,3500,1370,0
7550801207,20150428T000000,536500,2,2,1360,1860,680,680
2468800040,20150410T000000,330000,3,2.5,2060,25046,1600,460
8092700230,20150211T000000,249950,3,1.75,1120,15210,1120,0
4435000490,20141015T000000,249000,4,1.75,1630,8410,1630,0
3686900025,20150408T000000,249000,3,1.75,1590,7535,1590,0
2450500110,20140508T000000,780000,4,1.75,2480,9195,1390,1090
1257200315,20140705T000000,1.20E+06,4,2.5,2700,4275,2700,0
3876312370,20140915T000000,434500,3,1.75,1930,7210,1110,820
2821079081,20141010T000000,590000,4,2,2490,339332,2490,0
7550800915,20150219T000000,417200,2,1,1000,4000,1000,0
7504010750,20140924T000000,649990,4,2.25,2130,11900,2130,0
1175000110,20141202T000000,506000,2,1,1060,3588,960,100
9320990090,20150421T000000,348000,3,2.5,1730,4004,1730,0
3791400100,20140728T000000,301000,4,2.5,2810,6146,2810,0
6021503885,20140708T000000,427550,2,1,880,4000,880,0
7979900552,20150501T000000,361000,3,1,1040,6720,1040,0
5101405340,20140821T000000,460000,2,2.5,1830,8107,930,900
5016003146,20140710T000000,958000,4,3.5,1800,6400,1800,0
2734100065,20140612T000000,445000,5,1.75,2460,6846,1340,1120
8029650040,20140519T000000,373000,3,2.5,1670,3565,1670,0
6204410150,20150414T000000,525000,4,2.25,2660,7957,1750,910
662310620,20140826T000000,364988,3,2.5,2850,12593,2850,0
924000040,20140814T000000,324000,2,1,820,8370,820,0
3333500096,20150305T000000,625000,4,3,2350,5627,1490,860
349400100,20140908T000000,237500,3,1.75,1480,7830,1480,0
3876000970,20140806T000000,429300,6,2.25,2930,15949,1730,1200
7883603425,20140529T000000,155000,3,1,1250,6250,1030,220
923000580,20150223T000000,614000,4,2.75,2760,8160,1780,980
6635000110,20150331T000000,650000,3,2.5,2380,3332,2380,0
7000100775,20140721T000000,625000,3,2,1730,12219,1730,0
6383000690,20150325T000000,587100,3,2.25,1670,6414,1670,0
9113600210,20140617T000000,380000,4,2.5,2150,37647,2150,0
5249804760,20150505T000000,479500,2,1,930,5760,730,200
3364900156,20150317T000000,382888,1,1,620,2380,620,0
117000001,20140527T000000,540000,4,4.25,1960,3565,1960,0
7555200230,20140521T000000,691000,4,2.75,2550,8632,1700,850
9178600360,20140604T000000,760500,3,2,1990,3990,1130,860
7853301570,20150430T000000,685000,4,2.5,3550,10968,3550,0
5066400564,20140929T000000,199129,3,1,860,33664,860,0
9264950600,20140724T000000,335000,3,3,2031,7702,2031,0
4010800110,20140609T000000,305100,3,2,1590,35988,1590,0
1546600120,20150325T000000,830000,4,2.25,3010,12202,3010,0
4139440100,20150128T000000,810000,3,2.5,2610,8481,2610,0
1939050110,20150113T000000,500000,3,2.25,1440,15661,1180,260
6126601445,20140530T000000,490000,3,1.75,1920,5405,960,960
9274200620,20141028T000000,490000,2,1.75,1670,4200,1670,0
2868300061,20140918T000000,272000,4,1.75,1390,10660,1030,360
3831200210,20140910T000000,280000,3,2.25,2140,7200,2140,0
7301300150,20140625T000000,233000,3,1,1250,6180,1250,0
3368900084,20140623T000000,275000,3,1,1080,6000,1080,0
8856500220,20140728T000000,375000,3,3.25,2760,6420,2110,650
9527310110,20140826T000000,445000,3,2.75,2180,3703,2180,0
2767604712,20140919T000000,437500,3,2.5,1260,1125,1260,0
3336001515,20150511T000000,426250,4,1,1610,6000,1510,100
5103900015,20140626T000000,358000,3,1.5,2450,12497,2450,0
1025069255,20141023T000000,1.18E+06,4,3.5,4150,49503,4150,0
2724069010,20150430T000000,305000,2,1,960,8276,960,0
8682262170,20140530T000000,415000,2,1.75,1340,4664,1340,0
1773100755,20140821T000000,520000,11,3,3000,4960,2400,600
8691390770,20141013T000000,733000,4,3.5,3080,5974,3080,0
7771300085,20150309T000000,411500,3,1,1130,8159,1130,0
9194101388,20140919T000000,540000,3,1.75,2280,16671,1760,520
7633400110,20150224T000000,270500,3,1.5,1952,8613,1652,300
2767704302,20150410T000000,422250,2,1.5,1280,1256,1200,80
8562970040,20140516T000000,655000,5,3.25,3690,12353,3690,0
8562720410,20140807T000000,1.20E+06,5,3.25,4610,10576,3310,1300
120069059,20140804T000000,550000,3,2.5,2920,169448,2920,0
9828702513,20140506T000000,460000,2,2.25,1230,929,1020,210
7812800515,20141025T000000,159075,4,1.5,1580,6200,790,790
3363900155,20141209T000000,470000,2,1,1220,4000,1220,0
9448300061,20140708T000000,235000,2,1,1020,7920,1020,0
1840300100,20140918T000000,309950,2,1.5,1510,9843,1510,0
4246000180,20140523T000000,433000,4,1.75,1830,9600,1010,820
7856000110,20150203T000000,895000,3,2.5,2750,10000,1650,1100
2422059111,20140620T000000,291000,3,1.5,1860,60960,1140,720
1925069199,20150209T000000,835000,3,2.5,2720,13124,2720,0
2771603940,20150109T000000,640000,2,1,1360,5000,1200,160
6028000090,20150126T000000,438000,3,2.25,2340,14279,1340,1000
5126310110,20140722T000000,540000,4,2.5,2600,9935,2600,0
7520000616,20150309T000000,325000,4,2.5,2090,7434,1090,1000
3343900120,20150126T000000,380000,4,1.75,2260,7200,1360,900
714000195,20141113T000000,510000,2,1,1390,5544,930,460
2310100230,20140812T000000,380000,4,2.5,2300,7707,2300,0
7856600900,20140616T000000,825000,4,2.5,2810,9800,1710,1100
926069192,20140926T000000,880000,4,3.25,4060,52707,4060,0
3343302110,20150306T000000,1.80E+06,3,3,2790,13295,2370,420
5100403405,20150107T000000,790000,3,1,1290,6380,1290,0
3298700302,20141212T000000,287000,2,1.5,720,4346,720,0
3333001430,20140912T000000,509000,3,3,2130,5000,1570,560
8849700040,20140908T000000,270000,3,2.25,1750,8400,1350,400
3256400051,20140708T000000,210000,3,2,960,9380,960,0
7283900551,20141124T000000,415000,3,1,1570,11752,1570,0
5067400032,20141205T000000,550000,3,2.5,3070,14400,1720,1350
1370801020,20140709T000000,1.25E+06,4,2.5,2920,5500,2030,890
3852900026,20140801T000000,499950,3,1,1870,4984,1120,750
1189000025,20140905T000000,659000,3,1.5,1540,5040,1540,0
4047200580,20150302T000000,265000,2,1.5,1440,22081,1440,0
2607720150,20140605T000000,492000,4,3.75,2810,10840,2070,740
5459300040,20140813T000000,715000,4,2.5,2450,7700,1250,1200
2613200025,20150313T000000,175000,2,1,1330,28270,1330,0
686050100,20141128T000000,975000,4,3.5,3130,52322,2430,700
2117700065,20141009T000000,306950,1,1,730,5005,730,0
5742600115,20150407T000000,630000,4,2,2480,3680,1470,1010
2064800600,20150109T000000,367500,3,1,1270,8792,1270,0
34001765,20150325T000000,699950,3,3.25,2230,5460,1430,800
1186000065,20150416T000000,1.00E+06,3,3,2880,3750,2220,660
1687000220,20141016T000000,285000,4,2.5,2434,4400,2434,0
7985400133,20150114T000000,215000,2,1.5,1120,1312,1000,120
3303980090,20150306T000000,1.05E+06,4,2.5,4080,11054,4080,0
7855200120,20140509T000000,1.37E+06,4,2.75,3720,9450,1960,1760
2800031,20150401T000000,235000,3,1,1430,7599,1010,420
2306400040,20150416T000000,604000,3,2,1560,2589,790,770
5035300834,20140530T000000,750000,3,1.75,1700,8400,1460,240
9542300530,20141124T000000,800000,4,2.25,2510,9963,2200,310
9191201250,20150107T000000,580000,5,2,2600,3750,1400,1200
7950300775,20141204T000000,350000,1,1,790,4590,790,0
2934800025,20141216T000000,353750,4,2,1710,7490,1320,390
7855400330,20140604T000000,1.10E+06,5,2.75,2660,8737,1470,1190
259600330,20150209T000000,465000,4,2,1470,10291,1470,0
3723800409,20140507T000000,568000,3,2,2350,5080,1780,570
5191100180,20141106T000000,1.01E+06,5,2,2440,3080,2440,0
257000057,20140916T000000,213500,3,1.5,1150,11571,1150,0
1771100330,20140605T000000,250000,3,2.5,1510,10384,1030,480
1782500035,20140703T000000,357000,2,1,870,4600,870,0
7104100065,20140926T000000,425000,2,2,1280,4095,1280,0
200500610,20140611T000000,571000,3,2.5,2600,7465,2600,0
7199320600,20140519T000000,588000,3,2.25,2030,7350,1190,840
3322049201,20140523T000000,275000,4,1.5,1930,15531,1930,0
5153200100,20150225T000000,565000,3,2.75,3210,15939,3210,0
726059349,20150319T000000,460000,3,1.75,1970,9135,1370,600
8833510230,20140604T000000,603500,4,2.5,4060,9734,2150,1910
7298000090,20140703T000000,490600,3,2.5,3316,11447,3316,0
3885804225,20140624T000000,1.01E+06,2,2,1460,9052,1460,0
2558600100,20140827T000000,500000,4,2,2100,12620,2100,0
7697920450,20140625T000000,249000,4,2.25,1830,6136,1830,0
8899200110,20140603T000000,235000,3,2,1530,8700,1530,0
3992700775,20150121T000000,410000,4,2,1490,13736,1490,0
6384500035,20140701T000000,370000,2,1,860,6050,860,0
2787700210,20140916T000000,360000,5,2.5,2130,7111,1330,800
2524049018,20141205T000000,1.41E+06,5,2.25,3580,16789,3580,0
7569450090,20141121T000000,298000,4,2.5,2420,3825,2420,0
123039570,20140708T000000,485000,4,2.25,1900,7200,1370,530
6071300090,20140826T000000,400000,3,1.75,1330,9143,1330,0
4221250100,20140805T000000,580000,3,2.5,2150,4604,2150,0
8730000210,20140807T000000,355000,2,2.5,1370,1140,1080,290
4178600100,20140721T000000,650000,3,2.5,2430,12997,2430,0
9476200485,20140929T000000,261490,4,1,1640,8467,1220,420
3205400230,20140716T000000,347000,3,1,1010,7200,1010,0
9307300100,20140519T000000,485000,3,1,1500,4100,1370,130
2770600930,20141022T000000,601000,3,2.5,1740,1251,1180,560
2817900180,20150411T000000,380000,3,3.25,2090,51212,1510,580
7504001340,20140829T000000,565000,3,3,1850,12556,1850,0
3121500330,20150323T000000,750000,3,2.5,2790,21043,2790,0
1099760230,20150107T000000,291000,3,2.25,1480,7200,1190,290
3904920600,20141105T000000,560000,3,2.5,2280,12498,2280,0
7504100590,20150325T000000,725000,4,2.25,3180,9600,3180,0
1725079025,20140903T000000,539000,3,2,2350,209088,2350,0
9406540150,20140722T000000,470000,5,3.25,3910,7077,2710,1200
6163900032,20150109T000000,264950,2,1,770,7434,770,0
844000180,20150225T000000,200000,4,1.5,1780,8000,1080,700
7229800175,20140604T000000,453500,5,2.5,2300,23345,1170,1130
325059086,20140825T000000,811000,2,2.5,2510,17986,2510,0
4310701565,20140916T000000,425000,3,3.25,1410,1350,1410,0
2524049257,20140918T000000,1.53E+06,4,2.25,4250,16940,2380,1870
1226059161,20141229T000000,562000,4,2.75,2560,83200,1860,700
7212660900,20140723T000000,281000,3,2.5,1760,7601,1760,0
6147650300,20141016T000000,270000,3,2.25,2100,14027,2100,0
8945300090,20140811T000000,205950,3,1,1490,8239,1490,0
7452500365,20140625T000000,310000,2,1,870,5400,870,0
3629960600,20150312T000000,350000,3,1.75,1260,1111,1260,0
540100056,20140601T000000,843500,4,2,2630,16475,2630,0
1109000175,20150508T000000,370000,4,2,1950,3757,1160,790
8645500900,20140620T000000,279000,4,2,2200,7700,1100,1100
722069057,20150102T000000,408000,3,1.75,1600,313672,1600,0
2660500365,20150106T000000,392000,3,1,1230,9600,1230,0
2516000475,20140929T000000,455000,2,1,1030,5000,1030,0
522039103,20141113T000000,310000,2,1.5,1040,83199,870,170
7689600650,20140917T000000,323500,3,3,2240,11536,2240,0
9285800801,20140926T000000,364500,3,1,1600,4489,800,800
3750607974,20140509T000000,280000,4,2,2190,14439,1180,1010
1622049154,20141215T000000,289900,3,1.75,1899,11325,1899,0
9530100555,20140613T000000,585000,3,1,1870,2807,1580,290
4178500300,20140916T000000,269000,3,2.5,1730,6653,1360,370
8856960720,20140808T000000,280000,3,2.25,1860,9210,1860,0
9117000230,20150409T000000,287000,3,1.75,1940,9000,1290,650
8122100835,20140812T000000,183000,2,1,670,5140,670,0
2788500090,20141219T000000,309000,3,1,1820,8142,1040,780
324059161,20141013T000000,920000,4,2.5,3810,13579,3810,0
4217400540,20140929T000000,815241,5,2.25,2060,4800,2060,0
3876312290,20141121T000000,405000,3,1.75,1520,7252,1140,380
8556800090,20150430T000000,525000,5,3.5,3450,19080,3450,0
2113701095,20140717T000000,150000,2,1,830,4045,830,0
3750603940,20140925T000000,240000,4,1.75,1880,9600,1020,860
1245003160,20140502T000000,698000,4,2.25,2200,11250,1300,900
2600010360,20150309T000000,440000,3,2,1800,10950,1800,0
7893200900,20150414T000000,204000,3,1,1200,12500,1200,0
269000615,20140516T000000,875000,3,2,2220,6641,1220,1000
2174503441,20140703T000000,650000,3,1.5,1380,4500,1380,0
4025300371,20150408T000000,392500,3,1,1660,8839,1660,0
3101500090,20141017T000000,400000,4,1,2320,4000,1310,1010
3447000090,20150428T000000,653000,3,2.25,2800,17300,1420,1380
917000300,20140520T000000,452000,4,1,1210,3760,1210,0
9510400100,20140506T000000,345000,4,2.5,2331,3826,2331,0
4058801225,20141202T000000,350000,4,1.75,1820,6930,1320,500
3578600201,20140731T000000,650000,4,2.5,2860,5576,2860,0
5282200015,20140527T000000,525000,5,3,2750,3800,1750,1000
5282200015,20150126T000000,840000,5,3,2750,3800,1750,1000
4219400555,20141124T000000,1.33E+06,3,2.5,2280,5000,2280,0
104550540,20150120T000000,259950,4,2,1610,6650,1610,0
3317500100,20150220T000000,998000,5,3.5,3760,10207,3150,610
2436200395,20140610T000000,1.07E+06,3,3,2940,4622,2230,710
1118001560,20140710T000000,1.91E+06,4,3,4460,6833,3140,1320
8728100775,20150309T000000,190500,3,1.5,1110,1150,940,170
2223069112,20141112T000000,465000,3,2.25,2560,117176,1280,1280
7278100665,20150204T000000,370000,3,1,1060,7419,1060,0
822059038,20140731T000000,290000,6,4.5,2810,11214,2010,800
7977201065,20141104T000000,350000,3,1.75,1380,4590,930,450
7977201065,20150305T000000,740000,3,1.75,1380,4590,930,450
5255000110,20141007T000000,460000,3,1.75,2560,8400,1970,590
9407001790,20140826T000000,290000,3,1,1010,10800,1010,0
1120069059,20140918T000000,475000,3,1.5,1790,229125,1790,0
2048000330,20140926T000000,214000,3,2.5,1600,2231,1600,0
8820903080,20150508T000000,455000,2,1,910,5759,910,0
1687000210,20140725T000000,275000,3,2.5,2497,4400,2497,0
621049103,20140709T000000,305000,3,1.5,1800,12196,1800,0
1321059052,20150409T000000,449000,5,2.5,2570,61855,1470,1100
2114700540,20141021T000000,366000,3,2.5,1320,4320,660,660
4307330180,20150328T000000,348000,3,2.5,1670,5090,1670,0
114100304,20141203T000000,515000,4,2.5,2800,21370,2800,0
7501000220,20140620T000000,950000,4,2.5,3360,11548,3360,0
8562901910,20140730T000000,815000,3,2.5,2590,21494,2590,0
1442800150,20150120T000000,199950,3,3,1530,2132,1530,0
3715500220,20140605T000000,386000,3,2,1330,8100,1330,0
8647800150,20150102T000000,273000,3,2.25,2160,7964,2160,0
2508800220,20150325T000000,284000,4,2.5,1830,6360,1830,0
106000044,20140826T000000,399950,3,1,1470,7930,1070,400
5652601035,20150115T000000,285000,3,1.75,1150,6423,590,560
4142450490,20150403T000000,315000,3,2.5,1790,6452,1790,0
2788400090,20140807T000000,250000,3,1,1700,7700,1120,580
7524200330,20150316T000000,290000,4,2,1630,7618,1630,0
9359300220,20140623T000000,725000,4,2.5,3420,30410,3420,0
3840700455,20140523T000000,410000,3,2,1650,9641,1650,0
6790950150,20140817T000000,855000,4,2.5,2810,52062,2810,0
3303950760,20140728T000000,399900,4,2.5,2710,8127,2710,0
2600000210,20140611T000000,852600,4,2.5,3320,11901,2650,670
2341300115,20140808T000000,235000,2,1,720,6321,720,0
8655900100,20140807T000000,230950,2,1,930,12724,930,0
4345000210,20150330T000000,230000,3,2.25,1490,8722,1490,0
8929000330,20140729T000000,404763,3,2.5,1690,1609,1150,540
6700390150,20140923T000000,245000,3,2.5,1720,3407,1720,0
1645000100,20150129T000000,188000,3,1.5,1140,8500,1140,0
8078350100,20141204T000000,626100,4,2.5,2280,7219,2280,0
6430500008,20150302T000000,428750,3,1,1100,4080,900,200
3902300100,20140512T000000,522000,4,2.25,1800,8623,1360,440
2193330090,20150311T000000,684000,4,2.5,2500,8434,2500,0
3524039202,20150420T000000,1.07E+06,3,2.25,2950,7232,1520,1430
59000201,20150505T000000,611206,1,1,1940,6300,1940,0
1782000085,20140915T000000,350000,2,1,1280,5250,1140,140
3121500150,20150423T000000,894000,4,2.5,3800,22029,3800,0
5207200360,20140903T000000,420000,2,1,930,5368,930,0
2570500230,20140529T000000,400000,5,2,1930,9747,1020,910
2481600110,20140525T000000,675000,3,3,2980,28000,1820,1160
5104520150,20140520T000000,426000,4,2.5,2800,8494,2800,0
7504110760,20140627T000000,750000,4,2.25,3190,11597,2300,890
3649100276,20140609T000000,368000,3,1.75,1710,10800,1710,0
4302700559,20150327T000000,342000,3,1,1980,6450,1120,860
2883200961,20140605T000000,700000,3,1.75,1910,4800,1080,830
2767601280,20140722T000000,848750,6,3.75,3160,5000,3160,0
625049274,20150303T000000,720000,3,2,1590,5200,1320,270
686400210,20140922T000000,525000,4,2.25,1890,8549,1890,0
121059038,20150324T000000,397900,3,2.75,2500,35245,1580,920
3649100264,20140815T000000,405000,3,2,1740,18000,1230,510
6743700015,20150128T000000,392800,3,2,1080,11856,1080,0
217500015,20150224T000000,394999,3,1.5,1730,7800,1330,400
8691500410,20140619T000000,340000,3,2.5,2480,6112,2480,0
9828702667,20140519T000000,482500,3,2.25,1450,1445,980,470
2597531110,20140909T000000,812500,4,2.5,2750,10159,2750,0
1126049095,20140926T000000,450000,3,2.5,2820,10208,1410,1410
126049100,20141104T000000,398000,3,1.75,1830,27468,1830,0
1724069060,20150507T000000,1.08E+06,2,3.25,1550,1767,1550,0
9530101385,20141014T000000,540000,2,2,1640,3021,840,800
7243500015,20141003T000000,275000,4,2,1720,5472,860,860
1498303700,20140822T000000,780000,5,2,2880,12000,2880,0
3352400325,20140724T000000,225000,3,1.5,1220,8345,1220,0
8021700495,20140722T000000,503045,3,3,1560,2250,1560,0
9406500530,20140912T000000,249000,2,2,1090,1357,1090,0
9468200100,20140710T000000,569950,4,1,1140,5940,1140,0
3179100482,20150126T000000,450000,2,2.25,1040,1377,1040,0
5035300650,20140603T000000,1.10E+06,4,2,2580,6000,1300,1280
6431000015,20140530T000000,700000,4,2.5,2310,3570,1490,820
5366200210,20140819T000000,454000,3,2.5,1590,4094,1590,0
9512501450,20150429T000000,555000,3,1.75,1270,9170,1270,0
8651411460,20150106T000000,214000,3,1.5,1240,5200,1240,0
8078380230,20140808T000000,590000,3,2.5,2210,8622,2210,0
1523069096,20140811T000000,459900,3,1.75,2340,51836,1510,830
7893203480,20150512T000000,205000,3,1.5,1420,5000,920,500
7795810110,20150512T000000,390000,3,1.75,1430,9857,1140,290
191100410,20140620T000000,970500,3,2.75,2470,10125,2470,0
6151800330,20150421T000000,790000,3,2.5,2390,15084,2390,0
1771100360,20140707T000000,320000,3,1,1120,10576,1120,0
1556200265,20140723T000000,552500,3,2.25,2700,4025,1760,940
6742700210,20141119T000000,1.05E+06,3,3,3490,4500,3170,320
1423800210,20140923T000000,230000,3,1,1640,7187,1640,0
2125049131,20140729T000000,680000,3,1.75,1620,5500,1110,510
5318101765,20140602T000000,985000,3,1.75,1670,5400,1670,0
6624300110,20140623T000000,375000,4,2.5,1870,7471,1870,0
5160700035,20150422T000000,431000,2,1.5,1300,4000,1300,0
1472800220,20140909T000000,463000,3,2.5,2190,17108,2190,0
3755000090,20141006T000000,350000,3,1.75,1320,10500,1320,0
259601010,20150414T000000,485000,3,1,1250,7200,1250,0
7939000090,20140929T000000,355000,4,1.75,2040,15000,1360,680
2675600025,20150327T000000,603500,3,1.75,2140,7280,1070,1070
5700000975,20140819T000000,860000,5,1.75,2510,6000,2010,500
9407150360,20150306T000000,259875,5,2.5,2200,6250,2200,0
8146300015,20140716T000000,685000,4,2.5,2170,8680,1220,950
9406570300,20140930T000000,382500,4,2.5,2980,8786,2980,0
7518500301,20150301T000000,490000,3,1,1180,2250,1180,0
3739500096,20150126T000000,229000,3,2,1540,6000,1540,0
3739500096,20150505T000000,430000,3,2,1540,6000,1540,0
267020090,20140818T000000,580000,5,2.5,3110,15783,1720,1390
534000195,20141113T000000,510000,3,1.75,1370,6700,1370,0
5469502700,20140508T000000,489990,5,2.25,2440,20828,2440,0
7010700110,20140916T000000,440000,3,2.25,1760,1800,1330,430
8106300090,20150428T000000,479950,3,2.5,2810,4984,1750,1060
225069013,20140623T000000,806000,4,2.5,2500,206474,2500,0
1685800100,20140624T000000,875000,4,2.5,3220,22588,3220,0
293800870,20140911T000000,710800,3,2.5,2880,36820,2880,0
7852190580,20150210T000000,565000,3,2.5,2700,6037,2700,0
5636000210,20150223T000000,359999,5,3,2680,9624,1870,810
1623301185,20150123T000000,625000,3,1.75,1780,4500,920,860
3260810590,20140912T000000,349950,3,2.5,2240,7565,2240,0
8589100090,20140617T000000,415000,4,2,1610,9600,1610,0
7579200767,20141105T000000,435000,2,2,1440,1170,960,480
623049273,20141121T000000,225000,3,1.75,1550,9060,1550,0
1186000035,20140512T000000,770000,3,1.75,1720,5000,1720,0
2228900191,20150106T000000,340000,3,1.75,1740,10800,1740,0
2597450120,20150312T000000,965000,5,2.75,3280,12673,2050,1230
3339400515,20150113T000000,667000,3,2.75,2216,31215,2216,0
1221000395,20140507T000000,250000,1,1,1100,4373,820,280
1526300015,20140612T000000,397990,3,1,1180,11862,1180,0
6163901772,20140918T000000,535000,3,1.75,2020,10031,1370,650
1180007005,20140625T000000,265950,3,1.5,1150,8450,1150,0
5420300210,20141007T000000,258000,3,1.75,2090,7461,1200,890
476000331,20141202T000000,505500,3,2.5,1300,1187,1300,0
2558700090,20140506T000000,455000,5,2.5,2240,7770,1340,900
4151800410,20141031T000000,1.35E+06,5,3.25,3540,5971,2000,1540
3586501075,20150109T000000,600000,4,2.25,2840,31720,1780,1060
4136870110,20150205T000000,329800,4,2.5,2080,7047,2080,0
6623400090,20150421T000000,222000,2,1,1550,38449,1550,0
1560800150,20150405T000000,450000,4,2.5,1900,9240,1900,0
2770605548,20141218T000000,952000,3,3.5,2760,4500,2120,640
2023700040,20140723T000000,625000,4,2,1410,4480,1410,0
1164000040,20150312T000000,226800,2,1,1240,11393,1240,0
7135520650,20141212T000000,1.21E+06,5,4.25,4420,13497,3510,910
3528400180,20141003T000000,350000,4,2.75,3390,16153,1970,1420
7820000015,20150312T000000,395000,3,1.75,1400,8640,1400,0
1105000229,20140919T000000,285000,5,3,2110,5260,1670,440
3625059166,20150107T000000,553000,3,1,1310,18135,1310,0
8108600442,20150505T000000,254000,3,1,1270,16800,1270,0
8143600015,20140826T000000,348140,2,1.5,2060,10880,1190,870
8731900790,20140626T000000,354950,4,2.75,2530,7350,1280,1250
6079500230,20140612T000000,706000,3,2.75,1900,6400,1410,490
7853302370,20140505T000000,499000,4,2.5,2910,6479,2910,0
122069107,20141204T000000,427500,3,1.5,1900,43186,1300,600
4204400175,20150217T000000,439000,5,3.5,2880,10000,1980,900
2896310120,20141117T000000,545000,4,2.5,2820,25995,2820,0
4083301380,20141017T000000,842000,3,1,1620,4774,1620,0
1332000100,20141210T000000,685000,4,2.5,3320,38043,3320,0
3622069122,20140903T000000,665000,4,3.5,3770,47480,3770,0
6052401215,20140609T000000,255000,2,1,1200,9000,1200,0
7010700245,20141231T000000,565000,5,2.25,2130,4360,1240,890
1311100490,20150225T000000,274000,5,1.75,1950,8720,1050,900
9510900360,20140509T000000,260000,3,2,1920,8075,1510,410
8679600150,20140507T000000,581000,4,2,2510,13695,1280,1230
7203600040,20140725T000000,625000,3,1.5,1990,5978,1990,0
2212900180,20141229T000000,220000,3,1,1230,9720,1230,0
2124079010,20141028T000000,765000,3,2.25,3190,324086,3190,0
2424059052,20140710T000000,1.33E+06,6,4.25,5720,10213,4170,1550
6746700615,20150318T000000,700000,8,2.5,2280,3000,1210,1070
3298300530,20140924T000000,351000,4,1,1550,7260,1550,0
8929000360,20140805T000000,413565,3,2.5,1690,1613,1150,540
2291400236,20140612T000000,363000,3,3.25,1651,1779,1341,310
6445800120,20150404T000000,679000,4,1.75,2260,41236,1690,570
8682261010,20140910T000000,473000,2,1.75,1510,4555,1510,0
8045000180,20150421T000000,585888,3,2,1490,7431,1490,0
9475700220,20140626T000000,405000,4,2.5,2220,4652,2220,0
3222049055,20150116T000000,650000,3,1.75,2800,19386,1400,1400
1222069133,20150224T000000,415000,4,2.5,2210,213008,1210,1000
9165100230,20141222T000000,575000,3,2,2150,3880,1080,1070
8091411120,20140717T000000,220000,3,2.25,1400,7205,1140,260
1777600230,20140506T000000,610000,4,3,2450,10117,1580,870
5101400862,20140512T000000,499950,3,1,980,6380,760,220
5317100325,20150303T000000,883000,4,2.5,2800,6874,2170,630
9324800455,20141023T000000,436000,2,1,1240,8100,1240,0
880000208,20141213T000000,320000,3,2.5,1610,1356,1240,370
1223089081,20140530T000000,425000,3,1.75,1510,44000,1240,270
5556800150,20140515T000000,204700,4,2,1670,9987,1670,0
4174600331,20140717T000000,384000,6,3,2320,4502,1200,1120
5419801120,20150113T000000,314000,3,2.75,1900,8200,1900,0
3649100674,20150430T000000,535000,3,2.5,2390,6263,2390,0
1525069058,20140626T000000,568000,4,1.75,2110,265716,2110,0
7202000220,20150501T000000,426000,4,1.5,1470,5850,810,660
7129301001,20141209T000000,675000,4,2.75,2670,6780,1630,1040
8860500150,20140613T000000,380000,4,2.5,2540,6365,1870,670
7384500110,20140723T000000,685000,3,2.5,3450,8000,2970,480
622069123,20140819T000000,429000,3,2,1700,52826,1700,0
164000361,20150421T000000,799000,4,1.5,1810,6583,1500,310
3438500790,20140920T000000,318500,5,1.75,1550,6986,1030,520
2024059110,20150420T000000,925000,3,3.25,4110,20900,2630,1480
7338400945,20150224T000000,420000,3,1.5,2080,5000,1300,780
809003160,20141218T000000,570000,2,1,1100,4000,1100,0
8650700090,20140813T000000,1.05E+06,4,2.75,3950,12840,3950,0
8151600663,20140917T000000,333000,3,1,1250,8450,1250,0
7352200100,20150224T000000,1.36E+06,2,1.75,2620,14138,2120,500
1952200220,20140603T000000,660000,3,2.5,2290,2798,2290,0
1568100300,20140917T000000,350000,6,4.5,3500,8504,3500,0
1568100300,20150121T000000,682500,6,4.5,3500,8504,3500,0
2113700485,20141210T000000,399990,5,2.75,1690,4000,970,720
1454600156,20140625T000000,860000,5,3.25,4500,9648,3000,1500
4204400201,20141021T000000,216180,2,1,1120,7797,1120,0
8856890330,20140915T000000,300000,4,2.25,1740,9613,1740,0
1922059278,20141014T000000,145000,3,1,1010,11880,1010,0
1922059278,20150305T000000,255000,3,1,1010,11880,1010,0
6623400356,20140702T000000,250000,3,1.75,1200,24805,1200,0
9407111250,20141029T000000,245000,3,1,1020,8625,1020,0
5422570760,20141014T000000,445000,3,1.75,1850,7056,1850,0
4036800910,20140514T000000,562000,3,1.5,1830,8000,1830,0
259600530,20140505T000000,501000,4,1,2070,7519,1160,910
6303400981,20150113T000000,190000,3,1.75,1160,5850,1160,0
7701990300,20140516T000000,862500,4,2.75,3280,24440,3280,0
5700002510,20140611T000000,1.09E+06,5,2.5,2340,6000,2340,0
2011400230,20140626T000000,575000,5,3,3690,49709,2690,1000
1921069059,20141230T000000,250000,1,1,720,123710,720,0
1471700410,20150506T000000,310000,7,1.5,2660,15111,2660,0
2102700025,20141009T000000,1.40E+06,5,3.25,4300,9270,2910,1390
4222300040,20141216T000000,284850,3,1.5,1590,8256,1090,500
3649100676,20150219T000000,570000,4,2.5,2590,7910,2590,0
372000040,20141003T000000,304000,3,1.75,1720,6000,1000,720
7312200040,20141216T000000,560000,4,2.5,1790,9787,1240,550
6052400975,20140826T000000,325000,3,1,1590,8160,1090,500
826000495,20150206T000000,557510,4,2,1580,4800,1580,0
8731900880,20150420T000000,305000,4,2.25,2580,8820,1620,960
1523059100,20140902T000000,320000,5,1,1740,27350,1740,0
2597550090,20140905T000000,455000,5,2.25,3470,28212,2790,680
3581000210,20140904T000000,383001,3,1,1180,7210,1180,0
4048400191,20140605T000000,545000,3,1.75,1700,51649,1700,0
7578200025,20150408T000000,487500,2,1,1190,5000,1190,0
2379300330,20140702T000000,345000,5,2.5,2450,6994,2450,0
8917100180,20140604T000000,583000,6,2.75,2630,16411,1650,980
3395300180,20140812T000000,534950,3,2.25,2130,12286,2130,0
369000690,20140812T000000,403504,4,1,1060,5750,950,110
7977200720,20150427T000000,500000,3,1.75,1480,6120,1480,0
2322069175,20150224T000000,319502,3,1.75,1610,38707,1610,0
2324039100,20141112T000000,525000,4,2.75,2440,5080,1750,690
5631500866,20140506T000000,563000,4,3,3100,15480,2400,700
2877101745,20140804T000000,898500,4,2.75,2890,5000,1990,900
721069087,20140507T000000,651000,3,2.5,3240,108366,3240,0
7934000145,20141201T000000,450000,4,2.75,2900,6400,2040,860
6072760360,20150321T000000,665000,4,2.25,2650,8149,1610,1040
6021501635,20141102T000000,825000,4,2.5,2560,4000,1610,950
1821059067,20140625T000000,200000,3,1,1150,4800,1150,0
3295750610,20140904T000000,295000,3,2,1760,6092,1760,0
2926059146,20141215T000000,748000,4,2.5,3220,8379,3220,0
9429500146,20140714T000000,580000,3,2.5,3200,18750,2660,540
7893207490,20150212T000000,275000,3,1,1250,10744,1250,0
8945300110,20150326T000000,196000,3,1,1000,8470,1000,0
8151600610,20140522T000000,235750,2,1,740,11250,740,0
2923049399,20150323T000000,315000,3,2.25,2170,8480,2170,0
3260810110,20140825T000000,338000,4,2.5,2370,10631,2370,0
5104530770,20150121T000000,353000,4,2.5,2300,4249,2300,0
8661000033,20140627T000000,235000,3,1.75,1400,6300,1400,0
4017050820,20150320T000000,569999,3,2.5,3080,13880,3080,0
226039279,20140918T000000,505000,4,2.25,2350,12540,2350,0
1338800785,20150306T000000,1.23E+06,4,3,2660,4600,1820,840
2921049079,20140514T000000,299000,2,1.75,1250,34395,1250,0
5113260040,20141016T000000,240000,3,2,1100,6360,1100,0
3124059023,20150213T000000,1.96E+06,3,1.75,3330,12566,1940,1390
5351200265,20140911T000000,1.27E+06,4,3.25,3640,3604,1960,1680
2591010150,20150414T000000,405000,2,1.75,1350,2653,1350,0
6163900821,20140624T000000,304000,4,2,1310,8454,1310,0
2310060230,20141010T000000,272000,4,2.25,1800,5555,1800,0
4449800315,20140620T000000,412000,2,1,1260,3960,690,570
3299600120,20140718T000000,698000,4,2.5,2990,7231,2990,0
2490200615,20140609T000000,400000,2,1,1140,5100,1140,0
1565950230,20141120T000000,305000,3,2.5,2100,6825,2100,0
6402700110,20140910T000000,585000,4,2,2400,12753,2400,0
5029450100,20140812T000000,190000,2,1.5,1400,9031,960,440
7525530590,20140720T000000,760000,4,2.5,2990,12788,2990,0
226059103,20140527T000000,570000,3,1.75,1930,36210,1930,0
6197200021,20141106T000000,144000,3,1,980,6800,980,0
7227500910,20140624T000000,139000,2,1,690,5280,690,0
5100402644,20141119T000000,525000,4,1.5,1430,6380,1130,300
748000205,20140716T000000,293000,1,1,1110,5421,1110,0
7899800476,20150427T000000,267100,2,2.5,1250,1580,1030,220
3885804390,20150421T000000,1.50E+06,4,3.25,3470,5222,2830,640
1796370150,20141028T000000,240000,3,2.25,1500,15334,1500,0
7935000625,20150409T000000,975000,3,2.5,2530,7000,2530,0
1761300100,20140618T000000,279950,5,1.75,2150,7171,1460,690
1112700150,20150127T000000,405000,3,1.75,1260,7373,1260,0
2622049052,20140516T000000,400000,3,2.5,2740,83199,2740,0
423000035,20141124T000000,225000,3,1,960,6500,960,0
1555300490,20141229T000000,250000,3,1,1520,7800,1120,400
6802210450,20150331T000000,272950,3,2.25,1570,9096,1180,390
7853310150,20140722T000000,625000,5,1,3240,5324,3240,0
4086300065,20140718T000000,670000,3,1.75,1280,2147,1280,0
809003085,20150401T000000,1.07E+06,3,2.5,2130,3545,2130,0
259100110,20140618T000000,540000,3,1.75,1970,8200,1420,550
2316800100,20141105T000000,525000,3,2.5,2990,6725,2990,0
6414600051,20150303T000000,425000,2,1,1160,17700,1160,0
1704900206,20140602T000000,465500,3,1.75,1890,7004,1290,600
7853301240,20140717T000000,443500,3,2.5,2170,5866,2170,0
3420069055,20141203T000000,350000,4,2.25,1570,499571,1570,0
1726069198,20140918T000000,850000,3,2.5,3260,91911,3260,0
4468400211,20150220T000000,205000,3,2.25,1250,952,1250,0
1864900230,20140626T000000,315000,4,2.5,1940,10200,1140,800
8079040490,20140623T000000,470000,3,2.5,2150,8221,2150,0
7856400410,20140729T000000,1.10E+06,4,2.25,3310,8540,1660,1650
1825079018,20141120T000000,340000,3,1.75,3400,46382,2050,1350
5151600120,20140618T000000,310000,4,2.5,2660,12672,1740,920
4024101050,20140602T000000,305000,3,1,950,13475,950,0
2854800090,20140710T000000,307150,3,1.5,1480,6752,1480,0
1726600120,20140701T000000,729032,4,2.5,2840,12866,1780,1060
627300195,20150303T000000,750000,5,2.5,3240,9960,2020,1220
2140900100,20150203T000000,289000,4,2.5,1961,3207,1961,0
446000150,20150415T000000,480000,3,1,1100,5700,1100,0
7436500120,20150219T000000,529000,3,1.75,1500,7367,1500,0
6917700195,20140728T000000,585000,3,1.75,1480,4800,1140,340
4377000100,20140925T000000,704000,4,2.75,2510,12500,2050,460
925049278,20150304T000000,607000,4,2,1490,4054,1490,0
7558750120,20150310T000000,580000,3,2.25,2190,8188,1810,380
7856610490,20140805T000000,875000,5,2.5,2530,8564,2530,0
9346930100,20141015T000000,610000,4,2.5,2440,9350,1560,880
114100763,20140728T000000,230000,3,0.75,1040,15000,1040,0
7214700580,20140608T000000,510000,4,2.25,2450,62290,2450,0
4237901075,20150305T000000,733000,4,2.5,2210,5002,1370,840
302000375,20140814T000000,169100,3,2,1050,18304,1050,0
302000375,20150506T000000,250000,3,2,1050,18304,1050,0
6843300090,20141103T000000,500000,4,2.25,2730,35100,2730,0
3524039144,20141007T000000,700000,2,1,1620,9855,1320,300
1787250210,20141222T000000,379000,4,2.75,2410,5225,2410,0
3022079080,20140715T000000,650000,4,2.5,3420,222156,3420,0
2402100205,20141119T000000,412133,2,1,920,4400,920,0
1973800150,20150402T000000,480000,4,2.25,2330,14190,1740,590
5315100805,20141218T000000,650000,3,1.75,1940,10245,1940,0
8682262240,20150330T000000,505000,2,2.5,1900,5065,1900,0
9541600490,20150505T000000,931088,4,2.5,3510,17400,1930,1580
686200490,20140926T000000,570000,4,1.75,1860,7700,1860,0
8121101380,20140813T000000,475000,3,1,1380,4635,1380,0
9198600035,20140805T000000,240000,6,1.75,2210,8594,1310,900
322069141,20150114T000000,462000,4,2.5,2640,47480,1590,1050
2523039054,20150210T000000,1.12E+06,3,2.5,4530,22873,3220,1310
1446401540,20140916T000000,243000,3,1,1500,6600,1500,0
9541600015,20150211T000000,660000,4,2.25,2010,15375,2010,0
7352200025,20141013T000000,1.19E+06,2,1.75,2080,8112,1040,1040
853600150,20140524T000000,1.68E+06,4,4.25,5584,68257,5584,0
9208900037,20140919T000000,6.89E+06,6,7.75,9890,31374,8860,1030
7853230720,20140910T000000,368000,3,2.5,2080,4307,2080,0
8562750220,20141120T000000,811500,5,4.25,3970,4500,2860,1110
3995700325,20140604T000000,275000,2,1,770,8149,770,0
2387400120,20140929T000000,650000,4,2.5,2500,6005,2500,0
822039146,20150219T000000,485000,3,2,2410,50654,2410,0
1925069183,20140815T000000,425000,3,2.5,1340,10018,1340,0
6205500580,20141210T000000,530000,3,2.5,2640,13775,1550,1090
8835400805,20140522T000000,657000,4,1.75,2740,8520,1370,1370
1518000230,20141231T000000,315000,4,2.75,1580,3770,1080,500
4053200410,20140513T000000,273000,4,1.5,2180,22870,1280,900
2141300620,20140915T000000,550000,3,2.75,1960,13252,1240,720
3278602170,20141215T000000,347000,2,2.25,1560,1705,1270,290
3876310300,20140606T000000,525000,5,2.75,2440,8000,1240,1200
8141200027,20140925T000000,490000,3,1.5,990,1343,840,150
3034200543,20141229T000000,500000,3,2.25,2210,7916,2210,0
7787050180,20150128T000000,585000,3,2.75,3080,7282,3080,0
3760500475,20141106T000000,926500,4,2.75,2900,17802,1750,1150
9301301145,20141024T000000,465000,1,1,1020,3200,1020,0
5615100330,20150327T000000,200000,4,2,1900,8160,1900,0
4139500410,20150126T000000,1.68E+06,6,4.75,5770,16747,4500,1270
722039087,20140923T000000,220500,2,1,990,57499,990,0
722039087,20150504T000000,329000,2,1,990,57499,990,0
8129700644,20140703T000000,715000,3,4,2080,2250,2080,0
8129700644,20150424T000000,780000,3,4,2080,2250,2080,0
4443800385,20140818T000000,410000,2,1,1480,4080,1050,430
4443800385,20150506T000000,778100,2,1,1480,4080,1050,430
7405700015,20150330T000000,406000,3,1,1090,11292,1090,0
2780400035,20140505T000000,665000,4,2.5,2800,5900,1660,1140
5562100325,20141125T000000,305000,2,1,1000,8212,1000,0
7437101030,20140822T000000,265000,3,2.5,1640,7668,1640,0
3856904610,20141002T000000,485000,4,1,1620,4080,1620,0
1423069095,20140507T000000,600000,3,2.5,2460,108900,1860,600
2523400205,20150421T000000,510000,2,1.5,1860,5100,1060,800
3530420110,20140521T000000,195000,2,1,1080,3899,1080,0
6046401030,20140528T000000,432500,3,1.75,1980,5100,1270,710
8563000770,20141210T000000,490000,3,1.75,1510,8433,1220,290
2215900180,20140711T000000,270000,3,2.5,1690,7165,1690,0
2771602450,20140826T000000,370000,2,1.5,1010,2102,1010,0
722059233,20141215T000000,327500,3,2.5,2090,12027,2090,0
1257201095,20150323T000000,826000,2,1,1060,6120,1060,0
4391600035,20140701T000000,510000,3,1.75,1750,7020,1750,0
625049310,20150311T000000,587750,2,1,890,4730,890,0
424059100,20150327T000000,449228,5,2.5,3020,24750,1650,1370
1422029138,20140902T000000,565000,3,2.5,2030,217805,2030,0
2723069146,20150424T000000,660000,4,2.5,3170,186436,3170,0
5112800042,20141203T000000,400000,5,2.75,2470,19200,1250,1220
579002870,20140506T000000,612500,4,2,2060,5000,1030,1030
2461900790,20150313T000000,560000,4,1.75,2120,6250,1060,1060
6788200360,20140903T000000,727000,3,2.25,2180,4200,1520,660
1018000110,20150423T000000,224000,4,3,2300,7609,2300,0
7701960720,20141017T000000,1.08E+06,4,2.5,4200,35267,4200,0
9477201530,20150423T000000,439000,3,2.25,1480,7565,1220,260
1821069072,20140508T000000,335000,3,1.5,2240,87625,1480,760
5035300572,20141016T000000,779000,4,1.5,2740,4912,1370,1370
1023089019,20140730T000000,452000,5,1.75,1830,47916,1830,0
2710600015,20150327T000000,775000,4,3,2000,5304,2000,0
1502400300,20140916T000000,235000,3,1.75,1380,8362,1380,0
4045700115,20141028T000000,370000,3,1.75,1620,37913,1620,0
7504010590,20141114T000000,790000,4,3,3180,12070,3180,0
4389200610,20141201T000000,903000,2,1.5,1140,7800,1140,0
1321039076,20140627T000000,209950,3,1,970,9583,970,0
4123800180,20140827T000000,309000,3,2.5,1780,7859,1780,0
6415100410,20140609T000000,440000,3,1.75,2240,8153,1120,1120
4420600015,20141006T000000,571500,4,2.25,2810,25990,1860,950
3856901880,20140815T000000,514000,2,1,920,4000,920,0
3878900395,20140728T000000,323000,3,1.75,1830,12500,1200,630
9183701345,20141103T000000,290000,2,1.75,1560,7575,1560,0
7768700300,20141205T000000,2.58E+06,4,4.25,5540,15408,4280,1260
3536900110,20141009T000000,1.36E+06,3,2,2310,21318,2310,0
7518503830,20140723T000000,551000,4,1.5,1470,5100,1470,0
2125059161,20141023T000000,960000,4,2.5,3430,43560,3430,0
2597520720,20141103T000000,720000,5,2.5,2900,9525,2900,0
109200730,20140506T000000,218000,3,1.75,1850,7684,1320,530
2621750110,20141223T000000,334950,4,2.5,2190,7000,2190,0
8644400040,20140729T000000,605000,4,2.25,2510,31584,2510,0
4237901345,20141217T000000,825000,4,3.25,3200,4477,2390,810
8731982250,20140812T000000,268500,4,1.75,1670,8000,1670,0
7942100180,20140627T000000,230000,3,1.75,1010,9600,1010,0
3324079089,20141121T000000,1.34E+06,4,4,5050,202554,3260,1790
7147800015,20150401T000000,245500,2,1.5,1430,9782,1430,0
2826049023,20140729T000000,440000,3,2.25,1880,7989,1280,600
3905081530,20141007T000000,571500,4,2.75,2180,5799,2180,0
9543000945,20150427T000000,182500,3,2.25,1830,4744,1830,0
402000145,20141028T000000,217000,2,1,970,5600,970,0
4364200015,20150109T000000,335000,2,1.5,1170,5248,1170,0
2979800845,20140524T000000,501000,2,1,1010,4320,1010,0
7230900120,20141027T000000,339950,3,2.5,2140,7641,1290,850
5018200155,20150121T000000,340000,3,1.75,2230,10403,1630,600
6743700317,20150204T000000,582500,2,1,1140,23779,1140,0
3738900035,20140825T000000,298800,2,1,860,8189,860,0
1328300040,20150312T000000,317500,6,1.75,2540,8400,1340,1200
952000495,20150402T000000,598000,4,2.5,2420,5118,1550,870
7996700220,20150430T000000,375000,2,2.25,1640,2240,1640,0
7972601445,20150116T000000,465000,4,2.25,2550,7650,2550,0
3751601785,20150225T000000,551870,3,2.5,2507,18400,2507,0
7212650650,20140508T000000,295000,3,2.5,1920,7229,1920,0
2413300730,20140924T000000,263500,4,1.75,2210,6375,1640,570
8127700735,20140616T000000,1.10E+06,4,4,3530,8400,2630,900
2113701080,20141112T000000,300000,2,1,1100,4010,1100,0
5700000120,20140722T000000,780000,4,1,3390,4500,2190,1200
3172600031,20150327T000000,325000,3,1.5,1590,7936,1590,0
66000265,20140807T000000,370000,2,1,820,6550,820,0
4045800040,20140725T000000,715000,4,2.5,2370,10000,1660,710
1430800100,20150116T000000,356000,4,2,1600,12500,1600,0
2473411240,20150324T000000,329950,4,1.75,1740,7208,1740,0
2877100985,20140623T000000,490000,3,2.25,1470,2500,1080,390
4310701575,20140610T000000,429000,3,3.25,1410,1246,1410,0
7715801030,20150331T000000,510000,4,2.5,1620,8125,1620,0
7202331050,20140924T000000,550000,3,2.5,2360,4080,2360,0
8820903555,20150105T000000,467500,3,1,1830,6453,1830,0
5708500315,20140623T000000,615000,5,2,2130,4180,1270,860
526059103,20141013T000000,325000,2,1,990,15120,990,0
1352300315,20140808T000000,219950,2,1,1010,4120,1010,0
3307700150,20150413T000000,950000,3,1,1720,9830,1720,0
809001400,20140922T000000,925000,3,1,1630,3200,1630,0
6123600090,20140519T000000,251200,4,1.5,1310,8250,1060,250
8651401720,20140918T000000,215000,3,1.5,1610,5304,1610,0
6386700110,20140805T000000,245000,3,2,1850,8208,1180,670
8100900115,20150206T000000,259000,3,1.75,1270,4815,980,290
7549801395,20141113T000000,349950,4,1.5,1420,6720,1420,0
226059096,20141118T000000,1.57E+06,5,4.5,5220,67319,5220,0
6021502070,20150508T000000,600000,2,1,1410,4500,1020,390
2767603608,20141002T000000,405000,2,1.5,1170,1274,1170,0
425059103,20141202T000000,625000,3,2.5,1860,10027,1860,0
1624079057,20140717T000000,430000,4,1,1620,37075,1620,0
1931300688,20150429T000000,533000,3,3,1280,1085,1280,0
7732650120,20140728T000000,1.05E+06,4,2.5,2750,9949,2750,0
179001425,20141024T000000,230000,3,1.75,1420,3000,710,710
5469300330,20140905T000000,275000,4,1.75,2000,8700,1010,990
3678900110,20140610T000000,403000,2,1,1100,3598,1100,0
3388300730,20140910T000000,550388,3,3,1720,70567,1720,0
4037600115,20140922T000000,415500,3,1.5,1240,12400,1240,0
4083302485,20150420T000000,913000,3,1.75,2170,4000,1110,1060
7857000716,20150313T000000,334998,2,1,1800,5182,900,900
8857600490,20140509T000000,201500,3,1,1160,8320,1160,0
925069100,20150327T000000,820000,3,2.5,3030,46538,3030,0
4077800518,20140611T000000,371000,3,1,890,7200,890,0
2212200100,20141022T000000,229950,4,2.5,2150,7670,1240,910
2212200100,20150422T000000,344900,4,2.5,2150,7670,1240,910
5100403876,20140820T000000,840000,3,2.5,2060,9715,2060,0
821049191,20140916T000000,285000,3,1.5,1380,12196,1380,0
126039599,20150326T000000,475000,4,2.25,1800,7200,1230,570
1218000195,20150303T000000,420000,2,1,1460,7832,1460,0
9287800375,20141030T000000,685000,3,2,2210,5000,1710,500
926069140,20140721T000000,879000,4,3,3590,89640,3590,0
2407000145,20150120T000000,197200,3,1,1140,8775,990,150
452001280,20140703T000000,529950,3,1,1240,5000,1240,0
425069020,20140505T000000,1.09E+06,4,2.5,4340,141570,4340,0
4232901120,20140520T000000,792000,3,1.5,1570,1050,1570,0
4233400490,20140820T000000,262000,3,2.5,1680,10300,1680,0
4302201005,20141007T000000,353900,3,1.75,1560,5760,780,780
2026079055,20140818T000000,380000,1,1.5,1200,44866,1200,0
5104510120,20150327T000000,305000,3,2.5,1690,5175,1690,0
7857003851,20150420T000000,440000,4,2,2310,5004,1430,880
1257202430,20140617T000000,1.01E+06,4,3.5,2650,3060,2060,590
5104511530,20140919T000000,549900,5,3,3610,7555,3610,0
522069111,20150127T000000,678500,4,3,2620,214750,2620,0
5379804537,20140826T000000,270000,3,2.25,1760,8287,1160,600
3034200410,20150330T000000,430000,3,1,940,12521,940,0
5700003630,20140630T000000,1.93E+06,5,4.25,4830,8050,3710,1120
7203220410,20140813T000000,790500,4,2.75,3350,5416,3350,0
2426049168,20141017T000000,447450,3,2.25,1570,7200,1570,0
9828701565,20150209T000000,375000,3,2,2240,5200,1630,610
259600620,20150206T000000,565000,4,2,1950,9940,1950,0
5312100040,20150423T000000,400000,2,1,1010,3916,810,200
1938400040,20150220T000000,246000,3,1.5,1630,10200,1300,330
6632900405,20141029T000000,329922,3,1.75,1420,6289,1100,320
2125059123,20150414T000000,1.25E+06,5,3.25,3950,44431,2100,1850
6411600113,20150420T000000,375000,3,1,1210,7425,1210,0
6381500035,20140508T000000,385000,3,1.75,1890,9920,1230,660
7518500985,20140903T000000,591500,4,2.5,1690,4080,1140,550
5149800040,20140918T000000,255000,4,2,2560,12155,1350,1210
3211000930,20150316T000000,275000,3,1.5,1350,7800,1350,0
1853081250,20141229T000000,800000,4,2.75,3120,5000,3120,0
6632300040,20150425T000000,327000,2,1,1140,7435,1140,0
6117501755,20141230T000000,355000,4,1.5,2230,11536,1220,1010
6163900411,20141003T000000,310000,2,1,1050,8220,780,270
1924069039,20140519T000000,869000,5,3.25,4180,49222,2880,1300
4058801065,20140808T000000,272000,3,2,1200,5700,1200,0
1223089038,20140711T000000,665000,5,2.25,3320,60984,3320,0
5420800090,20141117T000000,225000,3,2.5,1590,8449,1590,0
2591720360,20141226T000000,375000,3,2.5,2750,37096,2750,0
9286750100,20140610T000000,375500,3,1.5,1530,7200,1530,0
2392100090,20150402T000000,550000,3,1.75,1570,6500,920,650
4302201085,20140918T000000,248000,3,1,1470,7680,1220,250
4302201085,20150506T000000,546940,3,1,1470,7680,1220,250
7215730580,20140902T000000,680000,4,3,3150,6175,3150,0
2095500120,20140718T000000,350000,4,2.5,2380,6124,2380,0
136000220,20150325T000000,593000,2,2.5,2000,2500,1810,190
3834000720,20150319T000000,390000,2,1,1140,8147,1140,0
3523029077,20141007T000000,297000,3,1,1340,18000,1340,0
42000065,20150305T000000,355000,2,1,1450,9150,1450,0
3275330120,20140814T000000,309900,3,2.5,2020,26670,2020,0
2312400230,20140924T000000,257000,3,2.25,1810,12000,1810,0
3472800065,20140826T000000,1.70E+06,4,3,3600,9687,3600,0
7518501140,20150113T000000,300000,3,2,1260,2550,1260,0
9126100815,20141217T000000,500000,3,2,1560,1156,1560,0
2769600590,20141016T000000,900000,8,4,4020,7500,2010,2010
7215730040,20140515T000000,695000,4,3,3150,9130,3150,0
8155760040,20141218T000000,213400,4,2.5,1680,6655,1680,0
1376800220,20140709T000000,425000,2,1,1320,8830,1020,300
3623059101,20140811T000000,420000,3,3,2700,47050,1570,1130
7010701016,20150209T000000,411000,1,1,1080,5000,1080,0
1025069210,20150209T000000,762500,4,2.25,3130,41382,3130,0
721049096,20140527T000000,569950,5,4.5,4850,40902,4850,0
7347600210,20150424T000000,258000,4,1,1220,8500,1220,0
3630030180,20150224T000000,499000,3,2.25,1780,3665,1780,0
9353300820,20150511T000000,310000,3,1,1250,10723,1250,0
4310702876,20141103T000000,398500,2,2.5,1780,1311,1350,430
5647900120,20140613T000000,250600,4,2.5,1930,8660,1120,810
4123800580,20140812T000000,352000,4,2.5,2470,6116,1420,1050
6169901006,20140715T000000,600000,2,1,1180,2160,940,240
3735901080,20150324T000000,645000,3,1,2270,4182,1170,1100
5104520620,20140724T000000,291500,4,2.5,1770,5000,1770,0
2422049107,20140508T000000,350000,4,1.75,2250,13515,2150,100
3260700360,20140919T000000,279000,3,2.5,1540,7280,1080,460
1862400057,20150304T000000,320000,2,1,820,5400,820,0
8682262720,20150310T000000,495000,2,2,1580,5203,1580,0
3183110180,20140828T000000,490000,4,2.5,2430,42646,1450,980
7986400360,20140717T000000,770000,5,1.5,2160,5000,2160,0
1789900065,20140709T000000,215000,3,1.75,1770,29004,1770,0
222069057,20150330T000000,665000,3,3.5,3580,95832,3580,0
3822200164,20140819T000000,423500,3,2.25,1890,7498,1190,700
1931300665,20141009T000000,850000,3,3,1910,4800,1910,0
1443500385,20140513T000000,155000,2,1,910,6232,910,0
259600410,20150413T000000,505000,3,2.25,1460,7210,1460,0
3630120880,20150227T000000,780000,3,3.5,3310,5558,3310,0
2822049210,20140825T000000,165000,3,1.5,1630,22764,1630,0
6821100015,20140828T000000,707000,2,2.5,2130,5001,1330,800
2267000458,20150501T000000,497000,3,2.5,1220,1475,1220,0
2976800115,20141105T000000,349170,4,1.75,1670,8856,1070,600
7436600090,20150102T000000,287000,4,1.5,1300,10050,1300,0
6072800205,20141119T000000,2.38E+06,4,2.5,3220,20251,3220,0
3296000110,20140602T000000,645000,4,2.5,2430,14400,1670,760
5054800110,20141016T000000,238000,5,2.25,2240,9652,2240,0
5054800110,20150213T000000,328000,5,2.25,2240,9652,2240,0
7443000652,20141103T000000,365000,2,1.5,790,1123,700,90
3995700220,20150317T000000,380000,3,1,1380,8147,1380,0
4191400090,20150310T000000,525000,4,1.5,1680,10500,1680,0
7518505070,20140625T000000,402000,4,2.25,2000,3672,1650,350
9144300110,20150424T000000,308000,2,1,1680,9250,860,820
7853301930,20141009T000000,405000,3,2.5,1960,6997,1960,0
3586500770,20140923T000000,808000,3,1.75,2590,32380,2590,0
7203100730,20150210T000000,875000,4,3.5,3790,6874,3790,0
8644400180,20150319T000000,860000,3,2.5,2370,55321,2370,0
2071500011,20140811T000000,367500,4,2.25,1930,7925,1300,630
5423600100,20140805T000000,604000,6,3.5,2580,13572,1290,1290
3734900110,20150204T000000,230000,2,0.75,890,19703,890,0
2126049154,20141217T000000,435000,4,2.75,2160,8148,1410,750
1864700300,20141010T000000,347500,4,2.5,1970,7098,1970,0
1310930100,20150318T000000,525000,4,1.75,1570,16697,1030,540
8103000110,20140603T000000,280000,2,1.5,1480,15641,1480,0
8103000110,20150205T000000,490000,2,1.5,1480,15641,1480,0
7227501765,20150323T000000,265000,4,1.75,1430,5490,1430,0
824069188,20140902T000000,645000,4,2.25,2720,18295,2000,720
1402000210,20150427T000000,390000,3,2.25,2420,31497,1750,670
5412400180,20150417T000000,267500,3,2.5,1400,7629,1120,280
8894200150,20141217T000000,1.28E+06,4,3.5,5844,10766,5844,0
4037500110,20140506T000000,404000,4,1.75,1840,10720,960,880
1843100540,20150429T000000,380000,3,2.25,2530,12042,2530,0
7856620210,20140808T000000,812500,4,2.75,2810,10300,1810,1000
425200145,20140703T000000,265000,3,1,1020,8610,1020,0
6073300750,20140709T000000,480000,5,2.75,2550,7725,1390,1160
6450301220,20140916T000000,264000,1,1,710,4725,710,0
3401700150,20150423T000000,1.35E+06,5,3,5530,38816,5530,0
7200001254,20140709T000000,550000,4,1.75,2150,9000,1110,1040
9828201745,20150504T000000,615000,2,1.5,880,2400,880,0
9238500410,20140519T000000,464000,3,1.75,1630,28600,1630,0
2587910180,20140716T000000,365000,3,1,1380,30940,1380,0
8663200450,20140715T000000,490000,4,2.25,2800,10800,1680,1120
1310960220,20140626T000000,280927,4,2.25,2070,7350,2070,0
396100110,20140516T000000,282613,2,1,830,6017,830,0
7785350490,20141023T000000,675000,3,2.25,2770,15886,2770,0
1795900210,20140518T000000,575550,4,2.5,2060,7475,1440,620
1796370730,20140520T000000,259900,3,2,1490,7770,1490,0
7787100210,20141209T000000,450000,4,2.25,2120,8267,2120,0
1137450120,20140729T000000,487500,4,2.5,2810,6296,2810,0
1921059303,20150128T000000,275000,4,2.25,2400,17842,2400,0
6699000610,20140811T000000,305000,3,2.5,2460,5027,2460,0
3621059048,20141010T000000,395000,3,1.75,2030,217800,2030,0
2620069077,20150422T000000,215000,3,1,880,7648,880,0
3083000910,20140708T000000,410000,3,2,1320,6000,1320,0
192600100,20140626T000000,440000,4,2.5,2160,7826,1390,770
5608010750,20140829T000000,1.16E+06,4,3.5,4190,15724,4190,0
6140100150,20141125T000000,500000,4,2,2280,7200,2280,0
9550203690,20141120T000000,961000,5,2.75,2590,6120,2590,0
5423010180,20140724T000000,825000,4,2.25,2770,9340,2770,0
2919200665,20141103T000000,734000,3,1.75,2145,3840,2145,0
2122059199,20141002T000000,490000,4,4.25,4480,5715,3680,800
3601200017,20140702T000000,175000,4,2.5,1780,6000,1780,0
2658000115,20140618T000000,190000,1,1,720,4800,720,0
7349400610,20140812T000000,305000,4,2.25,2050,12581,2050,0
868001790,20150316T000000,1.30E+06,3,1,2040,7936,1680,360
1105000015,20140609T000000,417000,2,1,920,6600,920,0
2919201385,20141113T000000,275000,2,1,680,4190,680,0
7202470100,20141210T000000,661000,3,2.5,1940,8196,1940,0
2832100910,20140708T000000,435000,4,2.75,2230,9640,1320,910
4100000040,20141023T000000,788000,5,2.25,2910,9454,1910,1000
9320100090,20140610T000000,1.80E+06,5,3.25,5270,17232,4010,1260
2589300180,20140630T000000,408000,5,3.25,2820,6589,2320,500
357000025,20141020T000000,570000,2,1,1790,3760,1490,300
3179100180,20150507T000000,1.54E+06,5,3.25,2920,6960,2120,800
2487700065,20140505T000000,400000,2,1,840,5510,840,0
8732040820,20141017T000000,247000,3,1.75,1820,8740,1820,0
1160000300,20150304T000000,453000,3,1.75,1550,7200,1100,450
3904100035,20140508T000000,235000,2,1,1270,3008,650,620
5288200230,20150421T000000,675000,4,1.75,2460,5750,1620,840
3331500820,20140610T000000,516200,3,2,2110,5150,1080,1030
3023039231,20140714T000000,650000,1,1,920,91476,920,0
5595900355,20141216T000000,257100,3,1.5,1500,10227,1000,500
8682290360,20150330T000000,457000,2,2,1440,9985,1440,0
5200100115,20141117T000000,540000,3,1.75,1610,3478,1060,550
1310700210,20140603T000000,268000,3,1.75,1970,10270,1970,0
3298500690,20140708T000000,300000,3,1,1150,7314,1150,0
722059002,20140909T000000,380000,2,2.5,2110,114127,1590,520
1022069183,20140627T000000,725000,3,2.5,3580,54450,3580,0
4053200933,20140623T000000,249000,3,1,1000,19204,1000,0
5589300205,20140805T000000,274000,5,1,1680,9383,1400,280
644000040,20150429T000000,1.78E+06,4,3.25,3950,10912,3950,0
1787600165,20140623T000000,396500,3,1.75,2390,7149,1350,1040
405100165,20141119T000000,460000,2,1.5,1820,7800,1240,580
223049087,20140616T000000,277000,3,1,1100,8536,1100,0
2742100085,20141104T000000,449500,6,4,2280,5275,1270,1010
3204300625,20140903T000000,785950,4,3,2530,4560,1540,990
6619910230,20140616T000000,545000,3,2.5,1940,9775,1440,500
3275310220,20141222T000000,244000,3,2,1360,9688,1360,0
5466310730,20140822T000000,165000,3,2.5,1660,2415,1660,0
2767704055,20140609T000000,435000,2,1,800,5000,800,0
7504100110,20140530T000000,642000,3,2.5,2670,10082,2670,0
9320990110,20150409T000000,340000,3,2.5,1720,4120,1720,0
1400700150,20140722T000000,730000,4,2.5,3550,35689,3550,0
1186000150,20150123T000000,563250,3,1.75,1370,2800,800,570
1024069009,20140502T000000,675000,5,2.5,2820,67518,2820,0
464001115,20140512T000000,620000,3,1.5,1620,6630,1280,340
886000015,20141210T000000,275000,2,2,1290,9041,950,340
3578600062,20140512T000000,270000,3,1,1830,8209,1830,0
1402950450,20150415T000000,325000,4,2.5,2040,5472,2040,0
3629970620,20141003T000000,476100,4,2.5,1850,1836,1600,250
3537900180,20141020T000000,700000,2,1,1300,12000,1300,0
8651442510,20140926T000000,220000,4,2,1620,5200,1620,0
114700150,20141114T000000,236000,3,1.75,1560,10919,1560,0
472000620,20140502T000000,790000,3,2.5,2600,4750,1700,900
5491200210,20140820T000000,350000,3,1,2010,6000,1210,800
7973202712,20150324T000000,130000,2,1,780,5300,780,0
7970800100,20140527T000000,283200,4,2.5,1982,6406,1982,0
8122600165,20141015T000000,273000,3,1,1500,6250,890,610
686530110,20141215T000000,599000,5,2.25,2460,8710,1330,1130
5151600530,20150423T000000,460000,4,2.5,2680,11998,1510,1170
1926069192,20140509T000000,1.16E+06,4,4.25,5860,52889,4910,950
5649000150,20140610T000000,385000,4,1.75,1720,8750,860,860
7812800775,20140910T000000,264250,3,1,1420,7420,1420,0
2770604410,20141029T000000,608000,3,2.5,1760,1472,1640,120
9485951510,20140915T000000,450000,3,2.5,2790,48994,2790,0
1337800805,20140703T000000,1.76E+06,3,2,2360,4800,2360,0
4059400265,20141114T000000,339950,5,2,1890,6050,1890,0
993000100,20150410T000000,760000,6,3.75,3810,6150,3810,0
2917200085,20150408T000000,350000,2,1,1160,5395,860,300
3914000090,20150421T000000,541500,3,1.75,2320,55847,2320,0
4157600150,20150327T000000,730000,6,2.75,3280,16449,1910,1370
3624039111,20150429T000000,215000,3,1,980,5600,980,0
8099900490,20140515T000000,420000,3,2,1640,9972,1640,0
1687910100,20140530T000000,655000,4,2.25,2060,8470,1440,620
5419800330,20150115T000000,240000,3,2.5,1500,10652,1500,0
5035300085,20140602T000000,730000,4,2,2360,6000,1260,1100
325059131,20141013T000000,390000,4,1.5,1940,12100,1940,0
2201500450,20141028T000000,473000,3,1,1280,10000,1280,0
3342101270,20150324T000000,698000,4,3.5,3630,5670,3630,0
3574750150,20140514T000000,511000,3,2.5,1820,4883,1820,0
9828702055,20140508T000000,358000,2,1.5,960,1808,960,0
2207100650,20150410T000000,499990,3,1.75,1630,8400,1060,570
240000031,20150313T000000,322000,4,2.25,1940,10200,1360,580
2953000300,20141008T000000,201000,3,1,980,9682,980,0
6119700150,20141112T000000,765000,4,2.5,3140,16200,2570,570
9274200365,20140606T000000,920000,4,2.75,2880,5750,1710,1170
6187700501,20150415T000000,360000,4,2,1650,7552,860,790
4137020910,20150507T000000,297300,3,1.75,1980,9220,1980,0
1233100720,20140925T000000,399000,3,1,860,9403,860,0
3034200530,20140620T000000,400000,3,1,1430,10005,1430,0
1463400081,20140827T000000,230000,3,1.75,1260,10164,1260,0
1773101050,20150220T000000,290000,3,1,960,4560,960,0
1895450090,20150430T000000,323800,3,2.5,2060,7658,2060,0
5101406384,20141020T000000,574500,4,1.5,1430,6380,1430,0
6821102346,20140522T000000,505000,3,2.25,1670,1596,1220,450
1926049210,20150422T000000,372500,2,1,880,10950,880,0
1842200040,20140701T000000,425000,3,1.5,1300,19163,1300,0
2623089002,20150416T000000,446250,3,2.5,2380,214315,2380,0
4391600065,20140814T000000,330000,2,0.75,520,6862,520,0
3760500602,20150427T000000,608095,3,2.5,2680,17707,2680,0
6071000265,20150125T000000,550000,3,2.5,2140,10136,1320,820
3222059206,20140828T000000,265000,4,2.5,1820,16103,1820,0
3034200933,20140619T000000,399888,4,2.25,1820,8255,1320,500
2028701165,20140627T000000,430000,2,1,1050,2570,850,200
5634500234,20150513T000000,554990,3,2.5,2100,6092,2100,0
2310100180,20141107T000000,359950,3,2.5,2210,6280,2210,0
2767600921,20140623T000000,405000,2,1,860,2599,860,0
8835200790,20150406T000000,280000,2,1,870,4025,870,0
2473000410,20150408T000000,479950,4,2.25,2570,11070,2570,0
3286800110,20140904T000000,575000,5,1.75,2980,53578,2230,750
1402600110,20150226T000000,392000,4,2.25,2360,7733,2360,0
1126059170,20150225T000000,760500,4,2.25,2310,36136,2310,0
8035350090,20140616T000000,435000,3,2.5,2300,9521,2300,0
4389200753,20140819T000000,1.57E+06,4,2.75,2810,8570,2810,0
6818400110,20141203T000000,261000,4,1.5,2040,10488,1190,850
4217401035,20150507T000000,1.48E+06,3,2.25,3290,5000,2730,560
1683400165,20150430T000000,853800,7,4,2960,2665,1950,1010
1939120450,20140522T000000,657500,3,2.5,2670,10496,2670,0
4137010530,20140504T000000,331950,4,2.5,2530,9933,2010,520
2624039133,20140611T000000,514000,3,1.75,1720,5899,1220,500
2794700120,20140912T000000,496000,3,3.5,3090,27598,2020,1070
2944010210,20150218T000000,1.09E+06,4,2.5,3930,21894,3930,0
8651443360,20141106T000000,195700,3,1,1120,5200,1120,0
1338300180,20140729T000000,1.40E+06,4,2.25,3960,8640,2630,1330
624110540,20141205T000000,1.18E+06,4,3.25,4060,20822,4060,0
4039700090,20140923T000000,643403,3,2.5,2350,9648,2350,0
6752601110,20140512T000000,357000,4,2.5,2380,7066,2380,0
8861000210,20150408T000000,865000,3,1.75,1480,8163,1040,440
1088700100,20141118T000000,905000,3,2.5,2930,9280,2930,0
7893207925,20141022T000000,265000,3,1.5,1290,7100,1290,0
3449820100,20141224T000000,535000,2,2.5,2730,7246,2730,0
1588600110,20140811T000000,450000,3,1,1290,5440,790,500
8079040300,20150218T000000,460500,4,2.5,2170,7533,2170,0
7390400026,20141124T000000,315000,4,1.75,1850,8580,1140,710
2425059144,20150213T000000,607500,4,2.5,2110,13939,1270,840
7821200375,20150126T000000,432000,2,1,960,3235,960,0
1370800700,20150209T000000,1.70E+06,3,4,3910,5350,2610,1300
8857640710,20140820T000000,479000,4,2.5,2590,6139,2590,0
9558020240,20150320T000000,475000,5,2.75,3080,6600,3080,0
3834000400,20141119T000000,415000,3,1,1630,8146,1630,0
461002050,20140826T000000,450000,2,1,910,5000,910,0
724069065,20140703T000000,1.14E+06,3,2.5,2780,33503,2110,670
4307351180,20140915T000000,430000,5,3,3880,8432,3880,0
984100340,20140903T000000,296000,3,1.75,1360,10742,960,400
8159620260,20140711T000000,303000,4,2.25,2560,8927,1790,770
7559600200,20141021T000000,641000,4,2.5,2600,6015,2600,0
1995200320,20150210T000000,280000,3,2.25,1220,5739,790,430
4223000140,20140805T000000,260750,3,2,1560,9635,1260,300
7215730200,20141119T000000,601000,4,2.5,2080,5191,2080,0
1900600105,20140828T000000,255000,3,1.5,1490,6604,1490,0
8644300200,20140605T000000,555000,4,2.75,2020,10720,1420,600
3262301610,20141118T000000,865000,3,1.5,1530,10827,1530,0
524059250,20140922T000000,1.39E+06,4,2.5,3450,17400,2180,1270
8594400350,20140520T000000,315000,3,2.25,1400,31626,1140,260
4031000260,20140606T000000,200000,2,1,1730,9610,1380,350
1454100260,20141117T000000,357000,3,1,1370,6450,1370,0
1934800138,20141204T000000,390000,2,1.5,1050,934,960,90
9508500075,20140729T000000,462000,5,1.75,2840,10220,2210,630
2946003415,20140516T000000,174500,2,1,1010,5200,1010,0
1926049326,20150210T000000,305000,2,1,1210,7140,1210,0
7655900187,20150205T000000,449000,5,1.75,1720,14040,1150,570
7452500565,20140829T000000,260000,3,2,2710,5000,2710,0
2871000400,20140512T000000,751000,4,2.5,3110,6142,3110,0
6150200060,20150401T000000,370037,2,1,1250,9270,1250,0
3668000830,20140825T000000,229950,3,1.75,1900,8910,1900,0
2473460060,20150422T000000,349000,3,1.75,1740,7682,1330,410
9558021000,20150120T000000,348000,4,2.5,2070,3808,2070,0
1250201610,20150417T000000,1.22E+06,3,3.25,3030,5600,2220,810
1321720160,20150102T000000,510000,4,3,3610,18948,3610,0
5029450200,20150323T000000,265000,3,1.5,1520,6805,1040,480
723000226,20141028T000000,1.25E+06,3,2.75,2780,4815,2780,0
225079036,20150107T000000,937500,4,4,5545,871200,3605,1940
5255700160,20140805T000000,485000,3,1.75,2590,8384,1590,1000
5683500030,20150320T000000,489000,4,1,1150,5217,1150,0
312000295,20150122T000000,400000,2,1,920,5120,920,0
9510970520,20140616T000000,638000,3,2.5,2110,3600,2110,0
193600200,20140619T000000,440000,3,1.75,1170,8740,1170,0
2568300045,20140625T000000,305000,6,2,1900,8240,1200,700
2568300045,20150319T000000,649950,6,2,1900,8240,1200,700
8691410310,20150213T000000,680000,4,2.5,3290,6012,3290,0
1656600310,20140714T000000,629000,4,2.5,2660,22050,2660,0
3904940160,20140904T000000,555000,3,2.5,2160,7584,2160,0
1774200060,20140617T000000,669000,4,2.75,2700,35362,2700,0
4137070030,20140808T000000,272000,3,2.5,1980,6608,1980,0
2144800117,20140626T000000,270000,4,2.25,2600,9900,1600,1000
3392100140,20150106T000000,215000,3,1,1280,9775,1280,0
2581900060,20150402T000000,690000,3,1.5,1710,17707,1180,530
4058801230,20150305T000000,256000,4,1.75,1270,6825,1270,0
2787320140,20150324T000000,255000,3,2.25,1890,7314,1100,790
263000324,20140513T000000,550000,7,4,3440,8100,3440,0
254000695,20150508T000000,410000,3,1,1190,5280,1190,0
3013300830,20141106T000000,410000,2,1,1030,4366,1030,0
2475201070,20140716T000000,259000,3,1.75,1240,4000,1240,0
798000421,20150327T000000,292000,3,1,1730,21183,1030,700
4104500181,20140812T000000,1.65E+06,4,3.5,4610,12500,4610,0
8701600030,20141113T000000,518000,5,1,1590,5000,1190,400
8944360390,20150305T000000,485000,3,2.5,1760,3097,1760,0
7968460270,20150303T000000,259500,3,2,1330,35060,1330,0
9406570350,20150423T000000,354000,4,2.5,2340,5420,2340,0
686900030,20150323T000000,999950,3,2.25,3740,22464,2330,1410
6071300030,20140624T000000,464500,3,1.75,1150,10466,1150,0
5416500520,20140825T000000,300000,3,2.5,1750,4200,1750,0
1102000270,20140701T000000,1.08E+06,3,2.75,3890,7216,3260,630
5422430320,20140721T000000,309950,4,2.5,1770,6666,1770,0
3157600340,20140917T000000,315000,3,1,1160,3700,1160,0
2061100435,20140724T000000,499950,3,1,1440,5580,1440,0
7011201550,20140707T000000,780000,4,2,2600,4800,1400,1200
2581300055,20141121T000000,885000,3,3.25,2640,16090,1960,680
1344300045,20140507T000000,500000,2,1,1010,3885,1010,0
7575620640,20141219T000000,329000,3,2,1840,6755,1840,0
8645500270,20141028T000000,246000,4,1.75,1720,7455,1020,700
1246700136,20141223T000000,405000,3,1.5,1280,9600,1280,0
3211100240,20140529T000000,349000,4,1.75,1700,7800,1120,580
8078100140,20150323T000000,374950,4,2.5,1980,12062,1980,0
6675500105,20140729T000000,306000,3,2,1160,7217,1160,0
4040700310,20140805T000000,416000,4,1.75,1980,7840,990,990
6388910160,20140623T000000,560000,3,2.5,1960,12476,1960,0
4023500990,20140617T000000,260000,3,1.5,1270,20700,1150,120
2921049121,20140516T000000,306500,3,2.25,2060,38377,1560,500
7229210060,20141211T000000,299950,3,1.75,1980,11274,1480,500
4137040060,20150406T000000,265500,3,2.5,1450,8977,1450,0
7982600030,20140812T000000,219000,3,1.5,1200,12000,1200,0
1775930140,20150505T000000,365000,3,1.75,1830,17349,1230,600
3222079083,20140514T000000,499000,3,2,2090,42689,2090,0
3585210200,20140602T000000,366000,3,1.75,1510,8301,1510,0
2705600069,20150501T000000,514950,3,2.25,1310,1264,1310,0
8691360200,20140604T000000,875000,4,2.75,3790,10669,3790,0
9541600350,20150120T000000,831000,3,2.25,2240,8800,2240,0
8562740400,20140515T000000,689900,4,3.25,2740,7266,2060,680
705700960,20140724T000000,315000,3,2.5,1660,10763,1660,0
3374500520,20150429T000000,355000,0,0,2460,8049,2460,0
2645500013,20140624T000000,336500,3,1,1480,7284,970,510
5318100200,20140527T000000,1.10E+06,3,2.75,2640,4050,1750,890
2224700045,20140804T000000,375000,6,2,1900,8057,1170,730
4047200135,20140811T000000,289275,3,2,2860,24046,1700,1160
2009000830,20140708T000000,455000,4,3.5,3440,6000,3440,0
6619910240,20140625T000000,505000,3,1.75,1640,10695,1640,0
5288200070,20140730T000000,450000,3,1,1450,3350,1450,0
7852110070,20140608T000000,567500,3,2.5,2300,7398,2300,0
740500070,20141006T000000,265000,3,1.5,1460,8505,1460,0
4046601420,20141230T000000,340000,3,2,1570,14992,1570,0
2130700860,20150430T000000,375000,3,2,1540,8885,1540,0
3975400045,20141226T000000,920000,6,3,3300,4218,2200,1100
5451200520,20140612T000000,850000,4,2.25,2130,11843,2130,0
6600400270,20141210T000000,202000,3,1,1010,9750,1010,0
624100990,20140929T000000,725000,4,3,2420,12000,2420,0
2424059139,20150206T000000,900000,3,3.25,3870,33980,3150,720
2883200875,20150206T000000,680200,2,1.5,1960,6000,1210,750
1917300105,20150414T000000,216500,3,1,1170,9000,1170,0
7203000200,20141212T000000,325000,3,1.5,1890,7650,1890,0
9510971070,20140812T000000,675000,3,2.5,2250,4134,2250,0
3760500240,20150512T000000,435000,2,0.75,750,16321,750,0
4068300160,20150122T000000,263500,3,1.75,1610,14000,1050,560
1774220070,20150507T000000,550000,4,2.25,2590,36256,2590,0
1563102685,20150422T000000,875000,3,2.5,2520,3750,2520,0
395800370,20150411T000000,246600,4,1,1340,8400,1340,0
3918400013,20140701T000000,337000,3,2.25,1460,941,1460,0
1545804820,20141111T000000,240000,3,1.75,1380,7500,1380,0
7811220070,20140910T000000,490000,3,1.75,1510,11120,1510,0
5561100431,20140806T000000,510000,5,2.5,2510,83231,1260,1250
5145100310,20150307T000000,305000,3,1,910,8008,910,0
255550270,20150403T000000,350000,3,2.5,1970,3655,1970,0
1123049129,20150224T000000,284200,3,1.75,1540,6632,1070,470
9407150310,20150128T000000,357000,4,2.5,1980,9757,1980,0
7732501000,20140617T000000,854000,4,2.75,3150,38865,2480,670
1024069205,20150114T000000,1.18E+06,4,2.5,4700,49658,4700,0
5426300060,20141008T000000,1.00E+06,3,2.25,2300,15952,1150,1150
3797000400,20141125T000000,616500,4,2.25,1880,3000,1760,120
2877102196,20141125T000000,750000,4,2.75,2640,3750,1840,800
9265200060,20141007T000000,650000,6,4.5,3900,9100,2870,1030
2894700270,20140715T000000,275000,4,2.25,2670,10050,1420,1250
2862100260,20141003T000000,540000,4,1.75,1840,4280,920,920
2730000070,20140814T000000,225000,3,1,1120,10665,1120,0
4139400060,20150409T000000,845000,4,2.5,2970,9072,2970,0
4365200520,20150312T000000,490000,3,2.25,1410,7740,1410,0
3629980350,20141209T000000,753000,4,2.5,3060,8167,3060,0
3211600140,20150209T000000,475000,3,1.75,2490,7210,1290,1200
3598600049,20141003T000000,124000,1,0.75,840,7203,840,0
3598600049,20150424T000000,224000,1,0.75,840,7203,840,0
1232001070,20140814T000000,485000,2,1,1130,3800,1130,0
7812801925,20140624T000000,230000,4,1.75,1850,6000,1270,580
522059062,20141105T000000,372000,4,2.75,2330,14175,1800,530
4178500640,20150507T000000,306000,4,2.5,1880,9426,1880,0
9528104660,20140827T000000,905000,4,3.5,2980,3000,2340,640
5013500400,20150326T000000,440000,4,1,1440,6678,1040,400
2550820060,20150428T000000,280000,3,1.75,1630,10001,1100,530
425079046,20140729T000000,435000,3,2.5,1778,147823,1778,0
3905050240,20140624T000000,425000,3,2.5,1930,4500,1930,0
5381000070,20140826T000000,204950,2,0.75,1130,11429,1130,0
1245002445,20140714T000000,670000,2,1.75,1650,7500,1000,650
6865200831,20140507T000000,475000,2,1,820,2723,820,0
1446801000,20150320T000000,352000,5,2.5,2900,6650,1450,1450
4038700830,20150409T000000,575000,4,1.75,2330,8800,1260,1070
4094800260,20141126T000000,1.73E+06,4,3.5,4440,20668,3240,1200
2742100152,20141013T000000,491000,3,2,1660,5070,1660,0
8691410060,20140709T000000,750000,4,2.5,3020,7465,3020,0
1325059083,20140527T000000,830000,4,2.5,1850,50662,1430,420
7852011070,20150109T000000,1.14E+06,6,3.75,5960,20197,3900,2060
2323059074,20140709T000000,137124,3,1,960,27442,960,0
7950304075,20140813T000000,225000,4,1,1150,6000,1150,0
3260000340,20140622T000000,732600,4,2.5,2130,7300,1230,900
9552701000,20150316T000000,818000,4,2.25,2460,8001,2460,0
5469501200,20140820T000000,431000,3,2.25,2360,14950,2360,0
6300500105,20141002T000000,304000,2,2.25,1320,1034,1320,0
4400200060,20141021T000000,650000,5,2,1910,4667,1010,900
5422560860,20150410T000000,450000,2,2,1610,6160,1610,0
7789000260,20140822T000000,269000,4,1,1610,8401,1610,0
8861000060,20141231T000000,875000,3,1,1160,10732,1160,0
9350900550,20150429T000000,890000,4,2.25,2870,8393,1480,1390
9560800310,20141009T000000,565000,4,2.5,2280,9725,2280,0
9187200228,20150313T000000,448175,2,2,1370,1339,1150,220
7849202190,20141223T000000,235000,0,0,1470,4800,1470,0
7215730070,20140911T000000,680000,5,3,2970,6500,2970,0
121039083,20150206T000000,629000,3,1.75,1460,12367,1120,340
2770601677,20150422T000000,494000,3,3.5,1570,1486,1330,240
3720800070,20150127T000000,1.10E+06,4,3,2880,5500,1920,960
3558910570,20150116T000000,450000,5,2.5,1900,9460,1190,710
1081300390,20141030T000000,330000,3,1.75,2020,11050,1320,700
7805450560,20140820T000000,960000,4,2.5,3110,11397,3110,0
6648770240,20141224T000000,360000,4,2.5,2390,7056,2390,0
5104520810,20140810T000000,378000,3,2.5,2150,11672,2150,0
2719100400,20140912T000000,499950,3,1.75,1340,6250,1090,250
255000320,20140724T000000,450000,3,2.5,1990,12866,1990,0
5398600075,20140825T000000,523500,2,2,1600,5969,800,800
7695470200,20141208T000000,600000,3,2.5,2680,43995,2680,0
6892510200,20140602T000000,290000,3,2.5,2080,4828,2080,0
4123800320,20150206T000000,176000,3,3.25,1340,5434,1340,0
809001505,20140918T000000,885000,3,2,2590,3750,1790,800
3856905185,20140624T000000,483000,2,1.75,1240,3000,1240,0
4051100390,20150508T000000,240000,3,1,1310,7125,1310,0
579003240,20140925T000000,720000,4,2.25,2530,5200,1530,1000
2333230060,20141105T000000,311000,4,2.5,1780,5822,1780,0
7129303240,20150102T000000,332500,3,2,1600,7995,1600,0
1219000473,20140626T000000,164950,3,1.75,1570,15330,1080,490
1219000473,20150323T000000,371000,3,1.75,1570,15330,1080,490
5469700060,20150123T000000,264500,3,1.75,1650,16200,1650,0
1118000935,20140705T000000,1.74E+06,4,2.25,2920,6513,2260,660
8819900055,20150330T000000,503000,2,1,870,4280,870,0
1995200338,20141029T000000,738000,4,2.5,2830,5010,2170,660
91000320,20140923T000000,393000,2,1,980,3350,980,0
8887001600,20150412T000000,280000,2,1,990,45528,990,0
7183000060,20150325T000000,260000,4,2.5,2360,9647,1530,830
194000565,20150409T000000,505000,2,1,1000,4640,1000,0
3830610320,20150105T000000,241000,3,1.5,1660,8000,1120,540
7922710320,20150316T000000,530000,3,1.75,1520,9605,1520,0
1231000310,20140812T000000,713000,1,1,1180,4000,840,340
173000140,20140722T000000,487000,3,1.75,1770,10125,1770,0
8651411260,20141113T000000,128000,2,1,980,5393,980,0
7272000260,20141113T000000,210500,3,1,1840,10178,1040,800
2787700060,20150115T000000,420000,3,2.5,1810,7210,1210,600
5499700045,20141030T000000,679000,3,2.5,1780,4320,1780,0
9433000390,20141218T000000,784950,4,2.75,2840,4227,2840,0
7300400200,20141119T000000,352000,4,2.5,2650,6366,2650,0
2771101963,20140611T000000,386000,3,1.5,1270,1318,1080,190
123039346,20150430T000000,335000,3,1.75,1260,17000,1260,0
524069116,20140602T000000,472500,3,2,1750,15500,1490,260
3583300075,20141103T000000,599950,5,2.25,2680,13292,1340,1340
7203220030,20140724T000000,963990,4,3.25,3830,6765,3830,0
1250201550,20140925T000000,735000,3,2,1610,3600,1610,0
8651611260,20150317T000000,858450,3,4.25,3840,9751,3840,0
1797501275,20150507T000000,665000,5,2.75,2670,4000,1800,870
2215900800,20140731T000000,290000,3,2.5,2000,7414,2000,0
7883602650,20150413T000000,250000,2,1,860,4320,860,0
3546000340,20141008T000000,192500,3,1.75,1420,7205,1420,0
6118600045,20140825T000000,350000,4,2,2060,13400,2060,0
1123059116,20150319T000000,518000,4,2.5,2790,9910,2790,0
124000160,20140701T000000,563000,4,1,1410,3376,1410,0
8733000045,20141007T000000,375000,4,3,2420,9566,2420,0
263000327,20150227T000000,400000,3,2.5,1460,1319,1460,0
5153200358,20141029T000000,240000,5,1.75,2460,16000,1230,1230
2258500045,20140923T000000,317500,2,1,1000,5120,1000,0
6137500310,20150213T000000,1.32E+06,5,4,4420,36342,2740,1680
3323069045,20141110T000000,234000,3,1,1240,239144,1240,0
8563070030,20140513T000000,645000,3,2.5,1740,13750,1740,0
425049036,20150309T000000,649000,2,1,1280,4840,1200,80
8562750550,20150417T000000,605000,4,2.5,2520,3980,2520,0
767000159,20140821T000000,337900,3,3.5,1500,1471,1500,0
5366200030,20150205T000000,535000,3,2.75,2490,3600,2290,200
7857000861,20140922T000000,325000,4,1,1530,5684,1130,400
1094000030,20141215T000000,429950,4,2.25,1740,10875,1740,0
1853000030,20150416T000000,775000,3,2.5,3550,32807,3550,0
5318101040,20140731T000000,650000,2,1,1280,6000,1280,0
3623500049,20150501T000000,1.20E+06,4,2.25,2320,13114,2320,0
1026049036,20140910T000000,275000,2,1,1140,10404,1140,0
8568030030,20140729T000000,575000,4,3.5,3930,16970,3930,0
4022906531,20140806T000000,540000,3,2.5,2370,16455,1640,730
5700002325,20140605T000000,640000,3,1.75,2340,4206,1170,1170
2473100510,20140923T000000,275000,3,1.5,1240,9125,1240,0
629811600,20140724T000000,672800,4,2.5,2740,10533,2740,0
7923300310,20140527T000000,495000,4,2.25,1940,9144,1430,510
4054560140,20140926T000000,820000,3,2.5,2950,35108,2950,0
4027700632,20140609T000000,475000,4,2.75,1980,11443,1980,0
2818100060,20140520T000000,1.28E+06,4,2,2850,7861,1450,1400
1771000960,20150429T000000,380000,3,1,1160,9375,1160,0
2591830350,20140820T000000,397500,3,2,2130,8225,2130,0
8842400071,20140507T000000,352000,5,2.5,2420,8560,1620,800
7856700060,20150413T000000,893880,6,2.5,2820,8600,1430,1390
9186300060,20140916T000000,635000,5,3.25,3710,34200,2510,1200
3275740030,20140507T000000,420000,3,2.25,1770,8165,1770,0
452001860,20150321T000000,503000,3,2,1260,2500,750,510
7779200075,20140909T000000,689000,2,1.75,2330,10143,1220,1110
3975400260,20140902T000000,749500,4,2.75,2490,3840,1610,880
2225059336,20141006T000000,1.15E+06,6,3.75,4090,49542,3100,990
8567450060,20140609T000000,563500,4,2.5,2800,12831,2800,0
6178930340,20140630T000000,480000,4,3,2440,9664,1890,550
8731990370,20150422T000000,374950,4,3,2540,8800,1620,920
9407150350,20150410T000000,308950,3,2.5,1600,6250,1600,0
3438502200,20140917T000000,445000,4,2.75,2680,16934,1340,1340
1274500700,20150421T000000,237200,3,1.5,1220,9000,1220,0
5667100045,20140902T000000,453500,3,1.75,1550,7270,1550,0
2887700560,20150507T000000,616500,3,2,2080,4549,1040,1040
7215720070,20140806T000000,1.25E+06,5,5,5000,32909,5000,0
6638900550,20150407T000000,396000,1,1,630,5150,630,0
723049307,20140708T000000,210000,3,1,1070,8179,1070,0
7577700521,20141001T000000,539000,2,1.75,1900,5175,1200,700
7888700030,20140825T000000,605000,3,2.5,2960,18600,2960,0
3501600135,20140707T000000,437500,3,2,1490,4800,1490,0
1822059331,20140716T000000,215000,3,1.5,1500,15000,1500,0
7852030310,20140618T000000,440000,4,2.5,2410,4780,2410,0
8901001090,20141117T000000,525000,3,1,2000,22500,1680,320
192450200,20140821T000000,319900,3,1.5,1140,20383,840,300
1771100030,20150106T000000,335000,3,1,1120,9075,1120,0
1560920370,20141107T000000,485000,3,2.25,2900,35273,2900,0
8731981360,20140925T000000,359999,4,2.25,3220,7700,3220,0
9541600060,20140807T000000,799000,5,2.75,2500,19783,2500,0
2923049468,20140912T000000,280000,3,2.25,1610,10454,1610,0
8722100810,20140708T000000,1.05E+06,4,2.75,2250,3433,1500,750
7840800135,20141119T000000,290000,1,2,1240,4800,1240,0
8083350070,20141217T000000,235000,2,2.25,1660,2748,1660,0
1923800135,20141001T000000,495000,3,1.75,2080,3000,1040,1040
1310980070,20150224T000000,290000,3,2.25,1880,7488,1880,0
3110800030,20141028T000000,230000,4,1.5,1050,9516,1050,0
8731801260,20150220T000000,234000,3,1.75,1480,8475,1480,0
7202270700,20141003T000000,597400,4,2.5,2420,4500,2420,0
7230300060,20140805T000000,370000,4,2.5,2190,17600,1110,1080
11510700,20140519T000000,755000,4,2.5,2660,10452,2660,0
586470350,20150403T000000,342000,3,2.5,2430,5715,2430,0
6840700036,20140728T000000,497000,2,1,770,3325,770,0
1824069083,20150429T000000,835000,3,1,3060,30166,3060,0
1836980240,20141015T000000,730000,4,2.75,2920,4500,2920,0
3528900160,20141001T000000,655000,3,1,1370,5250,1070,300
1442800060,20141120T000000,205000,3,2.5,1870,3118,1870,0
8722100030,20150407T000000,632750,4,2,1800,4800,1800,0
1723049624,20140512T000000,330000,5,3,2100,7715,1250,850
4040400200,20141007T000000,527500,5,2.25,2530,8250,2530,0
8691391090,20140508T000000,716500,4,2.5,3290,6465,3290,0
7853302190,20141217T000000,388500,4,2.5,1890,5395,1890,0
3260000700,20140904T000000,530000,3,1.75,1680,7770,1680,0
5126300510,20150108T000000,419000,3,2.5,2170,4517,2170,0
7199330370,20150309T000000,385000,3,1.75,1200,7360,1200,0
1854900240,20140528T000000,655000,4,2.5,2990,5669,2990,0
6738700335,20140701T000000,1.70E+06,4,2.75,3770,10900,3070,700
322059264,20140926T000000,279000,2,1,1020,47044,1020,0
5557500270,20150209T000000,262000,3,1.5,1700,9579,1100,600
9164100125,20140807T000000,533000,4,1,1550,4750,1550,0
7370600045,20150402T000000,640000,3,1.75,1680,8100,1680,0
8594400060,20140609T000000,285000,3,2.25,1680,35127,1680,0
7818900060,20140708T000000,458400,4,2.5,1910,10300,1910,0
2126059139,20150318T000000,620000,5,3.25,3160,10587,2190,970
1759701600,20140512T000000,465000,3,1.5,2020,11358,1190,830
1795920310,20140804T000000,690000,4,3.75,3210,7054,3210,0
1626069139,20140821T000000,462500,3,2.25,2350,51400,1390,960
3303951600,20140820T000000,369950,4,2.5,1910,10221,1910,0
3353402400,20150326T000000,124500,2,1,840,6480,840,0
2332700060,20140806T000000,950000,4,2.25,2620,10920,2620,0
4040800260,20140616T000000,418000,4,1.5,1220,10580,1220,0
1202000140,20141210T000000,160000,3,1,1060,8000,1060,0
4022902050,20150415T000000,457000,4,2.5,2200,10800,1500,700
4364200125,20150129T000000,530000,2,1.75,2120,7680,1130,990
4036801245,20140522T000000,385000,3,1,1250,7300,1250,0
7375100070,20150318T000000,491000,3,1.75,1440,7800,1440,0
686400060,20140820T000000,521000,4,2.25,1890,8034,1890,0
1645000710,20150410T000000,255000,3,1,1140,8528,1140,0
5476800069,20140527T000000,292050,5,3,2840,7199,1710,1130
823059185,20140520T000000,326000,6,3,1880,7200,1880,0
4364200075,20140624T000000,300000,2,1,750,5120,750,0
2473420070,20150430T000000,291600,3,1.75,1630,7480,1330,300
5706201360,20150219T000000,435000,5,1.5,1720,12551,1720,0
4442800012,20141218T000000,465000,3,2.5,1600,1311,1600,0
3339900640,20140620T000000,200000,3,2.25,1230,7420,1230,0
425400070,20140717T000000,238000,3,1.5,1610,6132,1090,520
4036800370,20141103T000000,455000,4,2.5,1320,7000,1320,0
2412600070,20141030T000000,230000,6,3,2180,7220,2180,0
8805900570,20140911T000000,808000,4,2.25,2190,4104,1410,780
9178600810,20141217T000000,578500,3,1,1490,5700,1490,0
2979800764,20140605T000000,390000,3,2,1463,868,1463,0
3904980270,20150505T000000,517500,3,2.5,1800,3933,1800,0
6738700075,20140626T000000,755000,4,2.75,2880,4000,2100,780
1646501920,20141030T000000,579500,3,1.75,1250,4120,980,270
2997800075,20140929T000000,649950,3,2.75,1670,1350,1350,320
4440400125,20140508T000000,228000,4,1.75,2000,6120,1100,900
3423600060,20141202T000000,665000,4,1.75,2280,3680,1470,810
1523560030,20150325T000000,689000,4,2.5,2110,6069,2110,0
2896000710,20141022T000000,560000,4,2.5,2520,11240,1440,1080
9238900060,20140529T000000,529000,3,1,1590,6420,1590,0
1081310060,20150108T000000,375000,5,2.5,2100,14858,2100,0
3256400060,20140923T000000,325000,4,2.75,2090,9240,2090,0
8914200060,20150115T000000,583000,4,2.5,3390,10519,3390,0
732000160,20150429T000000,330000,2,1,790,9784,790,0
1592080060,20150417T000000,262000,3,2.5,1970,8727,1970,0
7852190320,20150313T000000,555000,4,2.5,2870,6776,2870,0
7950303270,20150302T000000,585000,2,1,1110,6000,1010,100
7853340960,20150227T000000,425590,3,2.75,1940,3088,1770,170
7312900060,20140603T000000,235000,2,1,720,4840,720,0
1231001090,20140724T000000,362362,2,1,710,4000,710,0
1545805460,20150204T000000,252000,3,2,1370,7500,1370,0
1473120390,20141224T000000,439000,4,2.5,2690,9551,2690,0
1657300070,20140812T000000,465000,4,2.25,3360,10810,3360,0
104501040,20141003T000000,249900,4,2,1500,7854,1500,0
9345400350,20140718T000000,665000,2,2.5,2600,5000,1300,1300
2592400400,20141014T000000,370000,3,1.75,1160,8774,1160,0
6788200295,20140612T000000,620000,2,1,1430,3000,1300,130
7308900445,20140724T000000,375000,3,1,1870,7671,1720,150
3034200435,20140827T000000,552625,4,2,2560,9390,1280,1280
3755000060,20140930T000000,315500,3,1,1160,10500,1160,0
7524950710,20140919T000000,620000,2,1.75,1680,8187,1680,0
6071200400,20141125T000000,510000,4,2.5,2010,9075,1310,700
1939000030,20140627T000000,652500,4,2.5,2540,38677,2540,0
6979900370,20141114T000000,574000,4,2.5,3240,22795,3240,0
3303860160,20150224T000000,430000,3,2.5,2670,12806,2670,0
6413100311,20140603T000000,390000,3,2,1080,7236,1080,0
1232002015,20140605T000000,466500,3,1,1430,3840,950,480
5116060030,20141028T000000,315000,2,2.25,1290,2436,1290,0
1898700310,20140505T000000,220000,4,1.5,1240,9600,1240,0
1079600270,20150306T000000,325000,3,1.75,1840,17286,1440,400
1073100030,20150428T000000,365000,3,1,1120,8443,1120,0
1157200189,20140514T000000,356000,3,3.5,2100,12384,2100,0
3822200105,20140923T000000,380000,4,1.75,2030,12518,1610,420
8121200700,20140713T000000,579000,4,2.25,2030,8764,2030,0
4221900030,20150501T000000,682000,2,1,890,5000,890,0
9475200030,20140616T000000,499000,3,1.75,1750,12325,1470,280
3585220070,20150423T000000,333760,3,1,1300,5880,1300,0
8644220070,20140910T000000,745000,4,2.5,2650,18903,2650,0
9225900055,20140722T000000,380000,3,1.75,1750,10870,1750,0
1972202010,20140801T000000,435000,3,3,1440,1350,1440,0
9547200340,20150120T000000,520000,3,2.75,1700,3264,1060,640
2481630030,20150427T000000,965000,4,2.5,3920,41206,3920,0
3092000030,20140808T000000,270000,3,2.25,1470,16728,1350,120
3592500340,20150313T000000,1.10E+06,5,2.75,2520,4643,2120,400
3447000060,20141008T000000,577500,3,1.75,2140,13286,1220,920
2767704860,20140728T000000,650000,3,1.75,1550,5000,1250,300
4141000060,20141205T000000,1.23E+06,4,2.5,3180,10319,3180,0
7767000060,20140912T000000,1.90E+06,5,4.25,6510,16471,3250,3260
2061100390,20140721T000000,475000,2,2,1440,3720,1440,0
4388000260,20150330T000000,200000,3,1,1150,10132,1150,0
7787110510,20140620T000000,397000,4,2.5,2320,11717,2320,0
4024100982,20150219T000000,383610,3,2,1230,8450,1230,0
2621420060,20140728T000000,275000,4,2.5,2060,5742,2060,0
4319200060,20140709T000000,840000,3,2,2783,11177,2783,0
2473480310,20140918T000000,365000,4,2.5,2140,7350,2140,0
3629960060,20140904T000000,362000,3,2.75,1420,955,1160,260
7857000732,20141101T000000,350000,3,1.75,2090,6258,1390,700
7805600070,20141111T000000,200000,2,1.75,1320,13052,1320,0
109200140,20150506T000000,299000,4,2.5,2300,8100,1360,940
3224059033,20141007T000000,555000,4,1.5,3050,82764,1650,1400
868002015,20150225T000000,1.33E+06,3,2.25,2960,8330,2260,700
321100260,20140630T000000,896000,5,2.75,2520,16100,1570,950
2325039084,20141217T000000,550000,2,1.75,1740,7290,1280,460
2126049083,20150508T000000,324500,2,1,1300,6617,1300,0
3298400350,20150105T000000,312500,3,1,1170,7350,1170,0
7558800240,20150414T000000,485000,4,3.25,1946,17786,1946,0
5100402782,20141020T000000,511000,2,1,1250,5413,1250,0
5466310060,20150324T000000,139500,2,1.5,1230,1561,1230,0
8079010310,20140611T000000,464000,4,2.5,2180,7203,2180,0
8581200240,20150429T000000,255000,3,1.75,1740,8800,1140,600
7853250070,20150417T000000,679975,4,2.5,3830,4644,2900,930
7785000260,20140709T000000,624800,3,2,2250,14274,1500,750
3525069037,20141120T000000,920000,3,2.75,2590,223027,2590,0
4217401180,20140530T000000,1.37E+06,3,2.5,2090,6000,2090,0
8861700030,20141212T000000,510000,3,1.5,2400,10275,1540,860
2287400030,20140626T000000,289659,4,2.25,2260,7200,2260,0
7852010510,20150424T000000,585000,4,2.5,2910,6250,2910,0
5104512180,20140626T000000,555000,5,3,3640,6930,3640,0
9201000030,20150313T000000,940000,4,2.75,3770,24897,2550,1220
7199340560,20140909T000000,460000,3,2,1600,7350,1600,0
5561700340,20141121T000000,319000,3,2.5,2110,7434,2110,0
1657530350,20140519T000000,280000,3,2.5,1720,1916,1720,0
9423800030,20141118T000000,250000,3,1,1100,7470,1100,0
1939100560,20150116T000000,749950,4,2.5,2620,8312,2620,0
626059276,20140530T000000,458000,5,2.5,3090,23265,2990,100
7852020800,20150402T000000,465000,3,2.5,1890,4808,1890,0
1994200012,20150413T000000,580000,3,1.75,1850,2797,1150,700
6626100260,20140806T000000,700000,4,2.5,3100,36562,3100,0
4166800320,20141110T000000,350000,4,2.5,2506,7206,2506,0
5490210200,20140905T000000,456000,4,1,1700,7689,1080,620
5067400162,20150218T000000,290000,3,2,1550,18958,1550,0
4306500070,20140711T000000,475000,4,2.75,2200,16288,1290,910
5416500260,20140908T000000,285000,3,2.5,1890,3629,1890,0
1446800710,20150227T000000,309000,3,1,1140,6400,1140,0
2324800350,20140506T000000,860000,4,2,3740,32417,3740,0
6648500390,20150226T000000,219000,3,2.25,1940,6500,1440,500
8078440140,20141009T000000,546500,3,2.5,2130,7199,2130,0
2624049050,20150213T000000,338000,2,1,1470,5566,770,700
1862400226,20150311T000000,505000,2,1,1070,8130,1070,0
4046700140,20141002T000000,340000,4,1.75,1680,15084,840,840
3066410810,20140822T000000,678000,3,2.25,2730,10675,2730,0
5453700140,20141208T000000,800000,3,1.75,1890,10292,1890,0
2648500030,20140725T000000,112000,1,1,1080,3230,1080,0
4167100240,20150310T000000,252000,3,1.75,1440,16819,1440,0
2460700030,20140604T000000,335000,4,2.75,2540,7210,1600,940
682000030,20140703T000000,610000,3,2,2300,13418,1430,870
9211500560,20141028T000000,245000,3,2,1690,6790,1360,330
3211800140,20150205T000000,493500,3,1.75,1800,16026,1390,410
2193340260,20150107T000000,596500,4,2.25,1770,8505,1770,0
3419600125,20140701T000000,245000,3,2,1190,4072,1190,0
1357300240,20141027T000000,333500,3,1.75,1320,7200,1320,0
3876820140,20141110T000000,373000,3,1,1290,8974,1290,0
9526600710,20140724T000000,759900,4,2.5,3000,5639,3000,0
2291400350,20140826T000000,317000,3,2.25,1358,1204,1358,0
9834200390,20150512T000000,670000,3,1.5,1220,4080,1220,0
7631200310,20141106T000000,985000,2,2.5,2720,26761,2720,0
3438500796,20150430T000000,310000,3,1.5,1060,6954,1060,0
11520200,20141015T000000,750000,4,2.5,3020,13122,2540,480
339600070,20140721T000000,408000,3,2,1640,3440,1640,0
629810800,20140617T000000,900000,5,3.75,3870,8225,3870,0
8665900070,20150123T000000,460000,4,2.25,2860,15054,1460,1400
9282800075,20150317T000000,339000,4,2.5,1740,6000,1740,0
809002675,20150413T000000,660000,3,2,1140,6000,1140,0
6305900350,20150422T000000,449950,4,3,3290,10783,3290,0
1180002075,20140825T000000,235000,3,1,1210,6000,1210,0
8832900135,20150113T000000,769000,5,2.25,3320,13138,1900,1420
8682230400,20140507T000000,428000,2,2,1350,3900,1350,0
9560800390,20140516T000000,445000,3,2.25,1990,7340,1990,0
2558630350,20150321T000000,462000,4,2.5,2060,6958,1220,840
7517500310,20150506T000000,775000,3,1,1460,6198,1460,0
4141400030,20141201T000000,605000,4,1.75,2250,10108,2250,0
8570900162,20141016T000000,193500,2,1,950,15996,950,0
6837820030,20140522T000000,389950,4,2.5,3140,8060,3140,0
98030400,20140711T000000,790000,4,3.5,3560,6098,3560,0
7312400030,20150130T000000,442000,2,1,1410,5000,940,470
5452800800,20140613T000000,890000,4,2.25,2770,13500,2770,0
7889000125,20150319T000000,235000,3,1,1864,6978,1864,0
5101402276,20141217T000000,495000,4,1.75,1930,6720,1130,800
1621069045,20150105T000000,600000,4,2.5,3870,50965,3870,0
1370800935,20140618T000000,1.40E+06,3,2,2020,5500,1790,230
7522600030,20140826T000000,251000,3,2,1300,8400,1300,0
123059046,20150326T000000,471000,4,2.25,3410,57063,2410,1000
5201000030,20150323T000000,597000,4,2.5,2370,41338,2370,0
8965500030,20140923T000000,804000,5,3.5,2770,9305,2770,0
4019300030,20141013T000000,357000,3,1.75,1250,17493,1250,0
8929000030,20140821T000000,419990,3,2.5,1690,1689,1150,540
7880020030,20141110T000000,725000,4,2.5,3040,35201,3040,0
806800400,20150209T000000,275000,3,2.5,2710,5733,2710,0
7327500270,20140925T000000,445000,3,2.25,1190,13630,1190,0
8568010310,20140912T000000,510000,3,2.5,2300,27566,2300,0
1126049105,20140527T000000,330000,4,1,1360,13372,1360,0
3438501662,20140818T000000,270000,3,1,1500,5605,750,750
293000036,20150403T000000,495000,4,2,1610,4770,1230,380
2648000071,20150306T000000,225000,4,1.75,1420,10300,1420,0
5273200060,20150504T000000,716528,3,1.5,1750,5400,1050,700
2025701360,20141014T000000,260000,3,2.5,1510,6095,1510,0
7787120260,20140609T000000,471000,4,2.5,2330,9928,2330,0
4154305085,20150226T000000,690000,5,3.5,2690,4800,1930,760
967000400,20150428T000000,548000,5,1.5,1700,7200,1700,0
5101401816,20140726T000000,505000,3,1,1020,5410,880,140
3755000310,20141217T000000,325000,3,1,1160,11799,1160,0
7300200400,20141105T000000,682000,4,2.25,2450,34092,2450,0
1795920350,20140617T000000,605000,3,2.25,2010,10760,2010,0
3530440140,20150505T000000,276200,2,1.75,1370,4495,1370,0
6690500060,20140724T000000,530000,3,1,1370,4040,1370,0
3568200060,20140902T000000,245000,3,3,1990,9600,1440,550
3530200160,20140603T000000,654950,4,2.5,2790,45902,2790,0
40000228,20141015T000000,221900,2,1,780,6727,780,0
3878900270,20150429T000000,466000,4,2,2240,4508,1340,900
8029600400,20150213T000000,383150,3,2,2210,6387,2210,0
4083300510,20140505T000000,657100,4,1,1390,4240,1050,340
1026069155,20150312T000000,539000,3,2,1800,43995,1800,0
3298600340,20140905T000000,400000,6,3,3320,15600,1660,1660
1921059235,20140620T000000,215000,4,2.5,1960,11600,980,980
2887701420,20141124T000000,489000,2,1,850,2850,850,0
2553300270,20141105T000000,649000,4,2.5,2980,12764,2980,0
6206100075,20150512T000000,700000,4,1.75,1980,10800,1320,660
1397300055,20140520T000000,268500,2,1,790,8424,790,0
1357900060,20140610T000000,515000,3,2.5,1800,5001,1800,0
9346700030,20150223T000000,685000,4,2,2260,10800,2260,0
730000139,20141016T000000,305000,2,1.5,800,2142,800,0
4219400465,20150112T000000,950000,4,2,2490,4600,2090,400
8947250060,20150326T000000,292500,4,2.5,1610,4568,1610,0
3293700496,20140814T000000,270000,4,1.75,1850,7730,1100,750
3293700496,20141204T000000,450000,4,1.75,1850,7730,1100,750
2921700060,20141027T000000,535000,4,1,1920,6480,1920,0
3629870200,20150306T000000,550000,3,2.5,1740,3082,1740,0
6909200335,20140624T000000,457500,3,2.25,1430,2003,980,450
8945100320,20140506T000000,136500,3,1.5,1420,8580,1420,0
8945100320,20141008T000000,224097,3,1.5,1420,8580,1420,0
6792200282,20140922T000000,254000,3,2.5,1560,10608,1560,0
1471701170,20140611T000000,335000,4,2.25,2030,13500,1230,800
8564850200,20150402T000000,594950,5,2.5,3280,6553,3280,0
1471610070,20140827T000000,350000,3,1.75,1360,18123,1360,0
3384300160,20140916T000000,169950,3,1,1180,9832,1180,0
6139800390,20141006T000000,432500,3,2.5,1940,10800,1340,600
8819900270,20140520T000000,440000,2,1.75,1300,4000,1300,0
8944290200,20140918T000000,233703,3,2.25,1650,3788,1650,0
4057300030,20141114T000000,310000,3,1.5,1140,3292,1140,0
1277000240,20150402T000000,735000,3,2.5,2540,6762,2540,0
3345100002,20141217T000000,730000,4,2.75,3440,8150,3440,0
179000505,20141024T000000,257000,3,1.75,1800,9000,1200,600
1972200751,20140519T000000,485000,2,2.25,1260,1240,1260,0
868002080,20140619T000000,899000,4,2.25,2370,6000,1440,930
4426600125,20141118T000000,279000,3,1,1520,8055,1520,0
1683500140,20141211T000000,225000,4,2,1750,7245,1050,700
1689401230,20140625T000000,1.36E+06,3,1.5,2680,4775,1880,800
7852060370,20140811T000000,355000,3,2.5,1590,4242,1590,0
3876200060,20140502T000000,382500,4,1.75,1560,8700,1560,0
2571910260,20141107T000000,324360,3,2.5,2000,9669,2000,0
8731900640,20150324T000000,315000,3,1.75,2380,10450,2380,0
1826049094,20140716T000000,426000,2,1,2230,11472,2230,0
2345700260,20150406T000000,395000,5,2.5,2820,6305,2820,0
3622069050,20141121T000000,212644,3,1,1570,9650,1570,0
3342100160,20141009T000000,510000,3,3,1845,5100,1845,0
2422049104,20140915T000000,85000,2,1,830,9000,830,0
2422049104,20141230T000000,235000,2,1,830,9000,830,0
6600350140,20150408T000000,295000,4,2.5,2030,5754,2030,0
510003230,20140810T000000,720001,3,2.5,1430,2200,1430,0
1995200200,20140506T000000,313950,3,1,1510,6083,860,650
1995200200,20141008T000000,415000,3,1,1510,6083,860,650
2473480350,20140519T000000,305000,3,1.75,1610,12247,1610,0
1189000700,20141001T000000,625000,3,1.5,1600,4128,1250,350
7923700030,20150414T000000,490000,3,1,1420,11040,1420,0
1796360340,20140722T000000,269950,3,2,1660,8641,1660,0
625059036,20140813T000000,2.70E+06,5,4,4230,27295,3230,1000
5694500200,20140813T000000,829000,4,3,3310,4500,2910,400
224069114,20140829T000000,635000,4,2.5,2470,77550,2470,0
5379802871,20150312T000000,217500,3,1,1040,9750,1040,0
1311600030,20140716T000000,270000,4,1.75,1850,7350,1050,800
669000350,20140926T000000,1.25E+06,3,3,4610,8400,2790,1820
2494000070,20150127T000000,480000,4,2.5,2480,5100,2480,0
2771600350,20140506T000000,575000,3,1.75,2130,6500,1170,960
1091310140,20141103T000000,426950,4,2.75,2350,5589,2350,0
1450100390,20140905T000000,125000,3,1,920,7314,920,0
1450100390,20150316T000000,208000,3,1,920,7314,920,0
2473250400,20140924T000000,325000,4,2,1780,10622,900,880
1420700030,20140922T000000,597157,7,4,2690,10880,2690,0
3630110340,20150107T000000,728725,4,2.5,3010,3120,3010,0
1313000240,20140818T000000,708000,5,2,3180,10800,1910,1270
1441600160,20140723T000000,1.30E+06,4,3,4120,14021,4120,0
8807600140,20150424T000000,405000,3,1,1280,11625,1280,0
8928100125,20141028T000000,550000,4,2.75,1690,6090,1400,290
7853302180,20150409T000000,451000,4,2.5,2320,5375,2320,0
9325200160,20140619T000000,540500,5,3.75,3090,7415,3090,0
98001000,20141007T000000,1.03E+06,5,3.5,5050,16500,5050,0
3306200240,20141125T000000,218000,4,1,1640,10455,950,690
7436500060,20141020T000000,562000,4,2.25,2170,7007,1540,630
1022059032,20140812T000000,401500,4,2.5,3140,94525,2280,860
1523049083,20141112T000000,196700,2,1,1090,9994,1090,0
9346920070,20140822T000000,583000,3,1.75,1930,10183,1480,450
5709200030,20141204T000000,309900,5,2.5,2100,17825,1400,700
5104470070,20141016T000000,485000,4,3,3110,18843,3110,0
3330500075,20150424T000000,465000,3,1,930,3348,930,0
200800200,20140812T000000,595000,4,2.25,2050,8372,2050,0
1432400570,20140718T000000,254000,3,1,1160,7560,1160,0
1552510160,20141030T000000,488500,3,2.75,1820,9490,1820,0
2473460860,20141027T000000,260000,4,2.5,2110,8990,2110,0
7812800681,20150102T000000,166000,2,1,870,8487,870,0
579000550,20141107T000000,440000,2,1.5,1080,6760,1080,0
2916200138,20150202T000000,375000,3,2,1260,7560,1260,0
6821100125,20150225T000000,529500,2,1,900,4800,780,120
1529300135,20141014T000000,338000,2,1,750,6439,750,0
4124000320,20150316T000000,335620,3,2.25,1800,15903,1340,460
1775910370,20150205T000000,464000,4,2.25,2220,15232,1690,530
4365200505,20141003T000000,354000,2,1,1390,7740,1390,0
7960100030,20140814T000000,601000,4,3.5,2160,3600,1660,500
9264900350,20150424T000000,285000,3,2.25,1840,9040,1370,470
955000060,20140930T000000,462500,2,2,1690,4200,1690,0
5205000160,20140711T000000,350000,4,2.5,2650,10459,2650,0
6145600955,20141224T000000,329000,4,1,1120,3844,1120,0
2472950350,20150411T000000,312500,4,2.5,2500,11983,1320,1180
9475710060,20140613T000000,370000,4,2.5,2220,5338,2220,0
1112700060,20150311T000000,399900,3,1.75,1260,12750,1260,0
66000140,20141120T000000,398000,3,1,1480,6550,1480,0
1021000060,20150304T000000,550500,2,1.5,930,7400,830,100
4154304740,20150224T000000,709000,3,2.75,2780,7200,1870,910
7972604215,20141212T000000,402000,5,2.75,2770,7620,1700,1070
7979900126,20140626T000000,450000,3,1.5,1530,23660,1530,0
2821100125,20141120T000000,524000,3,2.25,2140,6720,1440,700
2323089065,20141217T000000,800000,4,2.75,4600,322188,2400,2200
6623400187,20140923T000000,185000,4,1,1760,8906,1230,530
6623400187,20150220T000000,365000,4,1,1760,8906,1230,530
325049234,20140909T000000,925000,4,2.5,3110,11422,3110,0
8016300240,20150402T000000,714000,3,1.75,2260,11781,1520,740
7955040160,20141016T000000,495000,3,2,1460,9759,1460,0
6414600232,20150420T000000,535000,3,2.25,2050,6648,1230,820
1824059070,20141024T000000,880000,4,2.5,2340,10800,2340,0
6031400013,20140616T000000,150000,3,1.5,1230,8056,1230,0
9557300570,20150327T000000,554500,3,2.25,1880,6565,1420,460
4443800960,20150408T000000,520000,3,1.75,1280,3880,1280,0
7203220310,20140822T000000,839990,4,2.75,3660,5637,3660,0
7202330030,20140822T000000,500000,3,2.5,1650,5683,1650,0
3353404510,20150107T000000,305000,2,1,1960,186872,1960,0
6064800550,20140802T000000,247800,3,2.5,1580,2170,1580,0
1786630160,20140711T000000,344200,4,2.5,2490,5812,2490,0
3709500140,20140623T000000,459950,4,2.5,2000,6107,2000,0
7942300070,20140915T000000,229900,4,1.75,1550,9899,1550,0
7525300240,20150219T000000,750000,4,2.25,2820,9602,1950,870
3579000800,20141024T000000,509000,4,2.5,2600,9355,1840,760
3577000116,20150325T000000,680000,4,1,2200,12137,1640,560
5490210320,20140627T000000,661500,5,2.5,2500,7200,1490,1010
3259400030,20141125T000000,370000,2,1,1270,1399,1270,0
3134100162,20140717T000000,785000,4,2.75,2900,17400,2410,490
9277700075,20140818T000000,355000,2,1,840,6720,840,0
1172000135,20140731T000000,446000,4,2,1940,6350,970,970
1025059094,20150128T000000,830000,5,3.5,3490,21780,3490,0
6705900070,20141028T000000,324000,3,2.5,1940,8347,1940,0
9522400350,20141008T000000,500000,4,2.25,2490,23478,2490,0
650000030,20141017T000000,745000,3,1,1390,9112,1390,0
8712100435,20141110T000000,1.20E+06,4,2.5,3940,4407,2620,1320
1530900560,20141215T000000,385000,2,2.5,1760,3710,1130,630
6868200060,20141211T000000,565000,3,2.25,2560,8040,1510,1050
7767400060,20141119T000000,465000,4,2.5,2300,7314,1420,880
820000012,20140827T000000,401000,3,3.25,1770,1977,1770,0
3308030060,20140619T000000,385000,3,1.75,2310,11200,1630,680
9485750240,20141017T000000,395000,3,2.5,2310,4930,2310,0
3826000550,20150414T000000,245000,5,1.5,2000,8100,2000,0
7960100075,20150325T000000,500000,3,2,1540,3600,890,650
7461400400,20141103T000000,334000,5,1.75,2590,6720,1750,840
6206100030,20150501T000000,550000,3,1,980,10960,980,0
7888300340,20141124T000000,216000,3,1,1730,7950,1180,550
1180000885,20141030T000000,340500,3,2.5,3070,5871,2510,560
1081330060,20140813T000000,375000,4,2.25,2100,12738,2100,0
9536600105,20150109T000000,600000,3,2.75,2080,16740,1580,500
2783100160,20140515T000000,375000,4,1.75,1890,8000,1250,640
9297301505,20140509T000000,536500,4,1.75,2000,4000,1450,550
5561300340,20140924T000000,599900,3,3,3030,35123,1760,1270
1794500695,20150304T000000,750000,2,1.5,1110,3600,1110,0
2797500030,20150211T000000,355000,3,1,1650,10075,1170,480
9214400125,20140701T000000,590000,3,2,1410,6413,910,500
6821101895,20150507T000000,680000,2,1,2140,6000,1070,1070
8079040140,20141006T000000,429000,3,2.5,1860,11122,1860,0
7518507580,20150502T000000,581000,2,1,1170,4080,1170,0
3863800030,20150331T000000,463800,3,1.5,980,7770,980,0
3303850390,20141212T000000,2.98E+06,5,5.5,7400,18898,6290,1110
7128300060,20140707T000000,443000,5,1.75,1650,3000,1650,0
104510340,20140925T000000,276200,3,2.5,1480,7210,1180,300
114101505,20150423T000000,630000,5,3.5,4060,8309,2960,1100
1928300350,20141222T000000,570000,3,1.75,1370,3300,1370,0
1370800560,20141013T000000,979700,4,2.25,2480,6000,2380,100
8825900310,20141211T000000,730000,4,2.5,2030,4080,1730,300
4167700240,20141204T000000,268450,5,2.25,2200,9600,1100,1100
2138800060,20150304T000000,490000,3,1.75,1770,7508,1270,500
579002220,20140827T000000,808000,3,2.5,2550,6240,1750,800
9144300060,20150430T000000,350000,3,1,1250,9786,1250,0
4441300416,20141028T000000,695000,4,1.75,2390,5880,1390,1000
3225069301,20140612T000000,1.23E+06,4,2.5,5730,44947,4280,1450
6620400400,20140813T000000,309950,1,1,1120,11800,1120,0
3361402041,20141030T000000,134000,3,1,1270,8508,650,620
1150000340,20141118T000000,645500,4,2.5,2390,9638,2390,0
7015200800,20150309T000000,750000,3,2,1760,5488,1540,220
5316100106,20141010T000000,1.40E+06,3,2.5,2560,3600,2110,450
3102700160,20140925T000000,344900,4,1.75,1820,7700,1100,720
8129700565,20141008T000000,601450,2,3.25,1840,1500,1840,0
9839300125,20150107T000000,575000,4,2,1810,4400,1700,110
2011400710,20140521T000000,405000,3,1.75,2470,9620,1570,900
1522700060,20140624T000000,518000,4,2.75,2520,14021,2520,0
7568700135,20140717T000000,265000,2,1,1600,7936,1600,0
8651411070,20140925T000000,180000,3,1,1280,4875,1280,0
2616700520,20150318T000000,285000,3,2.5,1590,9736,1590,0
4415600030,20150316T000000,433000,3,2.75,2000,7200,1000,1000
1072000260,20150223T000000,399000,3,1.75,1780,11440,1350,430
8045000340,20140802T000000,565000,3,2.5,1700,7210,1700,0
42000127,20150224T000000,406500,3,1.5,1970,10080,1970,0
2205500335,20140807T000000,420000,4,1.75,1940,11500,1090,850
1814800060,20150220T000000,965000,4,3.5,3290,5559,2290,1000
3885804260,20141024T000000,1.38E+06,4,3.5,3500,9523,2460,1040
9264920270,20141007T000000,353950,5,2.25,3260,7969,3260,0
1778350160,20140710T000000,847700,5,3.25,4230,10260,3860,370
623049185,20140702T000000,185000,5,1,1590,6700,1090,500
1180002735,20141119T000000,269000,2,1.5,1010,6000,1010,0
3876313100,20141224T000000,422800,3,1.75,1820,8400,1340,480
826000295,20141215T000000,379950,2,1,870,7500,870,0
3876311860,20141226T000000,525000,3,2,1620,7800,1200,420
2224079050,20140718T000000,810000,4,3.5,3980,209523,3980,0
8945000260,20140722T000000,209950,4,1,1630,8400,1630,0
2768301182,20141204T000000,439950,3,2,1230,1613,1010,220
1827200135,20140523T000000,554820,4,2,3510,12905,2210,1300
4307300520,20150423T000000,359000,4,2.5,2160,4500,2160,0
6632900354,20140910T000000,242500,3,1,1020,5870,1020,0
9540100060,20140926T000000,330000,3,1.75,1590,9417,1590,0
2424059116,20141105T000000,740000,3,2.25,3440,44374,2190,1250
7600125,20141218T000000,630000,5,1,3020,4800,3020,0
579003645,20140815T000000,750000,3,1.75,2280,7800,1360,920
3224600340,20141013T000000,695000,4,2.5,2790,6540,2790,0
7129800036,20150114T000000,109000,2,0.5,580,6900,580,0
3294700421,20150225T000000,389000,3,1.5,2030,10075,1080,950
6746700565,20141023T000000,447000,2,1,850,2700,850,0
742000060,20141230T000000,1.20E+06,3,2,2480,13310,2480,0
626059155,20141210T000000,315000,3,1.75,1010,12000,1010,0
1150000200,20150414T000000,640000,3,2.5,2420,8244,2420,0
1592000640,20141119T000000,570000,3,2.25,2180,9246,2180,0
3123039171,20140805T000000,495000,3,2.75,1830,208216,1830,0
3876312010,20140603T000000,449500,5,2.75,2040,7488,1200,840
5364200695,20150317T000000,1.08E+06,4,2.75,2640,5000,1840,800
7979900806,20150311T000000,294950,2,1,1060,7868,1060,0
8643200060,20140923T000000,170500,3,1,1640,13939,1040,600
7972602080,20141208T000000,312000,4,1,1190,7620,1190,0
7212650200,20141027T000000,350000,3,2.5,2180,15484,2180,0
8079100140,20140728T000000,690000,4,2.5,2120,8448,2120,0
8091800140,20140610T000000,375000,4,2.5,2210,9427,2210,0
7214720510,20140806T000000,575000,4,2.5,2510,47044,2510,0
9346920260,20140604T000000,646000,4,2.25,2500,8500,1600,900
3750603471,20150327T000000,239950,3,2.5,1560,4800,1560,0
3438502501,20140729T000000,400000,5,2.5,2510,7525,1710,800
1775500310,20150121T000000,455000,4,1.75,3060,94089,3060,0
1796380310,20140904T000000,240000,3,2,1310,8069,1310,0
1118000320,20150508T000000,3.40E+06,4,4,4260,11765,3280,980
3362401000,20140701T000000,695000,3,2,2500,4080,1680,820
7454000990,20140924T000000,304950,2,1,670,6720,670,0
5244800125,20140805T000000,650000,3,1.75,1840,2310,1140,700
789000520,20140715T000000,402500,3,1.75,1480,2211,1480,0
7852000340,20140625T000000,482000,3,2.5,2420,7307,2420,0
8827900560,20141031T000000,655000,3,2,1820,4480,1120,700
2768000390,20140926T000000,577000,5,2.75,1940,5000,1940,0
2475200370,20141020T000000,350000,3,2.5,1630,5996,1630,0
8731981940,20140908T000000,415000,4,2.25,2520,8000,1680,840
3626079032,20140730T000000,396400,4,2.5,2120,215186,2120,0
6646200710,20150409T000000,654300,3,2.5,2490,8582,2490,0
7167000060,20141124T000000,774950,4,2.5,3410,179419,3410,0
5249802085,20140902T000000,855000,4,2,2380,10800,2380,0
3528900060,20140626T000000,1.15E+06,3,2.5,2490,4000,1670,820
6056100295,20140530T000000,330000,2,2.5,1240,1546,1240,0
9392200030,20140923T000000,290000,4,2.25,1900,10950,1400,500
936000055,20141119T000000,519500,3,3,2390,19454,2390,0
3840700560,20140814T000000,450000,3,1.75,1810,12600,1400,410
333100295,20141124T000000,3.12E+06,3,3.5,4490,56609,4490,0
133000127,20140623T000000,265000,3,1,1620,9450,1620,0
4221970060,20150506T000000,359000,4,2.5,2640,7883,2640,0
1732800310,20150302T000000,2.00E+06,4,3.75,2870,4500,2510,360
2025069037,20150210T000000,1.05E+06,4,2.5,3250,48037,2030,1220
2516000486,20140701T000000,402500,2,1,800,2280,800,0
4037400070,20140825T000000,450000,3,1.75,1360,5445,1360,0
3375300370,20150306T000000,262500,5,2.25,1950,8086,1130,820
1682500240,20150225T000000,285000,4,2.25,1970,7200,1970,0
6806100340,20150304T000000,290000,3,2.5,2020,4861,2020,0
8682281070,20140807T000000,752500,2,2.5,2280,6230,2280,0
8691330260,20141208T000000,820000,4,2.75,3540,13515,3540,0
869700140,20140811T000000,292000,3,2.5,1560,2740,1560,0
7221400320,20141003T000000,213000,2,1,750,6089,750,0
7454001125,20141117T000000,400000,4,3,2240,7035,2240,0
7129304375,20140714T000000,202000,1,0.75,590,5650,590,0
203100435,20140918T000000,484000,1,0,690,23244,690,0
6189200260,20150504T000000,617450,3,2,1580,14398,1080,500
1430800162,20150114T000000,250000,3,1,1040,8000,1040,0
2570300240,20140529T000000,405000,5,1.75,1880,10000,960,920
3294700320,20150331T000000,325000,2,1,1070,8750,1070,0
2976800700,20140522T000000,301350,3,3,1860,7440,1040,820
7625704340,20150303T000000,425000,2,1.75,1550,7800,1050,500
9238900390,20140905T000000,460000,3,1,1860,6360,1470,390
4139430310,20150419T000000,938000,3,2.5,3090,10940,3090,0
1402630270,20140729T000000,348000,3,1.75,1720,8867,1320,400
3735901600,20140606T000000,435000,2,1,1260,4080,1260,0
739500270,20141113T000000,227950,3,1.5,1120,11430,1120,0
3566800125,20150330T000000,425000,2,1,1250,5880,900,350
2886200070,20140602T000000,550000,3,2,1810,4064,1810,0
3529300060,20140721T000000,347500,3,2.5,1890,7053,1890,0
3085001610,20140930T000000,397000,4,1.75,2020,6000,1620,400
9414500200,20140602T000000,410000,4,1.75,1790,11875,1490,300
8651611230,20140711T000000,780000,3,3.5,3190,6776,3190,0
8712100350,20140909T000000,1.35E+06,4,3.25,3030,5164,2700,330
7202350310,20141028T000000,476000,3,2.25,1630,3070,1630,0
1326059070,20140708T000000,390000,3,1.75,1180,16552,1180,0
1311900240,20141230T000000,226500,3,2,1560,7000,1560,0
7518503490,20140731T000000,495000,3,2,1340,2550,1340,0
6669200200,20150319T000000,1.50E+06,5,3.25,2590,11500,2590,0
3438501860,20150422T000000,385000,3,1,1020,5950,880,140
7852170570,20150309T000000,535950,3,2.5,2370,5344,2370,0
9290850060,20141022T000000,910000,4,2.5,3170,32430,3170,0
4206901505,20150326T000000,465000,2,1,1120,4000,1120,0
6600220550,20140626T000000,495000,3,1.75,1440,11787,1440,0
8699100160,20150210T000000,250000,4,2,2170,5404,1470,700
1068000520,20140506T000000,1.23E+06,4,2.25,3490,6906,2280,1210
2558610070,20150217T000000,400000,4,2.25,1970,8941,1970,0
1829300270,20140821T000000,715000,4,2.5,2780,13521,2780,0
7212650240,20150223T000000,342000,3,2,2250,7757,2250,0
3205200240,20150430T000000,420000,4,1.75,1340,8400,1340,0
1682000350,20140708T000000,148226,3,1,1400,7360,1400,0
7229900885,20141103T000000,313000,3,1,1510,10369,1010,500
7888000400,20140603T000000,150000,3,1,1320,8220,1320,0
523049195,20140522T000000,150000,2,1,820,10270,820,0
1423400160,20140618T000000,230000,2,1,1080,9435,1080,0
1766600075,20140902T000000,389100,2,1,840,5400,840,0
1088020070,20141216T000000,645000,4,2.25,2070,8720,1360,710
7893200486,20150302T000000,310000,3,1,1520,6500,990,530
8929000060,20141004T000000,351358,2,1.75,1210,1189,1210,0
8146200070,20150310T000000,1.70E+06,5,2.75,3810,9360,3810,0
624069050,20150407T000000,1.57E+06,4,3.5,5370,323215,5370,0
5318100935,20141020T000000,850000,3,2,1540,3600,1540,0
1313300340,20140514T000000,470000,4,2.5,2310,14023,2310,0
8032700070,20141118T000000,770000,3,2.25,1870,1900,1870,0
1072000240,20140624T000000,366000,3,1.75,1840,11440,1340,500
3904920390,20140710T000000,545000,3,2.5,2060,7184,2060,0
7345200400,20140909T000000,205000,3,1,1010,8800,1010,0
923000270,20140508T000000,405000,2,1,1020,8155,1020,0
7016310270,20150410T000000,467000,4,2.5,2220,7210,1270,950
3650100105,20140926T000000,392500,2,1,1050,4125,1050,0
3761100240,20141027T000000,901000,4,2.75,3030,18400,2360,670
2126049277,20141203T000000,500000,3,1.75,1800,7199,1300,500
253600160,20140530T000000,384950,3,2.5,1860,3690,1860,0
1623069046,20150312T000000,1.70E+06,4,3.5,4070,336283,4070,0
9235900030,20140717T000000,245000,2,1,860,6120,860,0
5451200370,20150209T000000,1.17E+06,4,2.25,3080,10487,3080,0
7338000270,20150421T000000,184500,3,1.5,1280,3640,1280,0
2115720270,20150414T000000,269000,2,2,1540,5000,1540,0
11200070,20140721T000000,570000,3,2.5,1530,3296,1530,0
8732300060,20140512T000000,850000,4,1.75,2350,11914,2350,0
8651410240,20150202T000000,209000,3,1,920,5200,920,0
3342102220,20140806T000000,327000,4,1.75,1840,5100,1840,0
7663700783,20140613T000000,369500,3,1.5,1650,9957,1100,550
9477201370,20150226T000000,440000,3,1.75,1760,8025,1230,530
1923000370,20140512T000000,947500,4,2.25,3290,12329,3290,0
6841700070,20150317T000000,510000,2,1,1270,4500,1270,0
3293700105,20150428T000000,385000,3,2,1600,10318,930,670
8001450060,20140820T000000,370000,5,3,2670,9920,1400,1270
2877104316,20141201T000000,660000,4,1.5,1960,4500,1960,0
1522039105,20150115T000000,729000,3,4.25,3300,308080,2520,780
924069190,20140819T000000,440000,3,1.75,2000,11880,2000,0
2722059185,20140910T000000,445000,4,2.5,2360,81892,2360,0
4073200575,20141201T000000,460000,2,1,1430,12092,1430,0
9542600070,20141202T000000,516000,3,3,2330,7304,1300,1030
2459960030,20140815T000000,343888,4,2.5,2060,5607,2060,0
259800640,20140609T000000,500000,4,1.75,2240,9886,2240,0
1223039195,20150508T000000,465000,5,1.75,2330,6450,1330,1000
1545804510,20140512T000000,302000,5,2.25,2180,7813,2180,0
1921059045,20141107T000000,195000,2,1,1280,7861,1280,0
8078460070,20140609T000000,640000,3,2.5,2140,8925,2140,0
7525300260,20140623T000000,502000,6,2.5,2890,8122,1630,1260
4249400270,20150417T000000,360000,3,2.5,1480,3851,1480,0
179000240,20150325T000000,290500,4,2.5,1680,3000,1680,0
8856004327,20140509T000000,248000,4,3,2163,5883,2163,0
8029550160,20140516T000000,433000,4,2.5,2280,7568,2280,0
5016001260,20150413T000000,480000,2,1,820,4200,820,0
1133000036,20150421T000000,410000,3,1,1330,5000,1120,210
5416510710,20140505T000000,309950,4,2.75,2310,5000,2310,0
1796380060,20141201T000000,253000,3,2,1290,7372,1290,0
1223089050,20140506T000000,280000,3,1.75,1630,11800,1630,0
7436900060,20150424T000000,440000,3,1,1410,8925,1410,0
2202500135,20141118T000000,333000,5,1.75,1240,8936,1240,0
224069195,20140616T000000,759950,3,2.5,3100,23790,3100,0
9407101180,20141224T000000,345000,3,2.25,2020,9000,2020,0
6699950310,20140926T000000,350000,4,2.5,2500,5831,2500,0
5379800810,20140807T000000,198000,2,1,790,14200,790,0
711000070,20140725T000000,730000,3,1.75,2040,11294,1340,700
5127001170,20140528T000000,266200,3,1.5,1430,9600,1430,0
191100140,20150316T000000,1.06E+06,4,2.5,2250,10160,2250,0
6198400218,20140919T000000,95000,2,1,1070,20450,1070,0
3578400270,20140623T000000,430000,3,1.75,1300,12731,1300,0
9573120260,20140610T000000,650000,4,2.25,2560,9731,2560,0
2310110070,20150317T000000,379900,3,2.5,2190,5071,2190,0
6413600192,20150427T000000,325000,2,1.5,940,1222,860,80
4037500335,20140606T000000,455000,4,2.25,1740,8449,1170,570
5141000510,20140915T000000,392000,4,3.75,2220,3797,1330,890
3876311180,20140904T000000,373000,3,1.75,1310,7811,1310,0
5036300575,20141016T000000,951250,5,3,2710,8227,1910,800
384000135,20140624T000000,502000,3,2,1300,14350,1300,0
322059326,20150427T000000,362500,3,2,1940,40588,1940,0
9530101670,20140623T000000,525000,2,1,1080,3500,1080,0
5490220030,20150225T000000,580000,4,2.5,2110,11680,1420,690
2459500070,20141222T000000,278000,3,2.25,1590,9425,1170,420
7312400075,20141216T000000,422500,2,1,910,4800,910,0
7011200830,20140909T000000,783200,4,2,1590,5400,990,600
8691390860,20140620T000000,715000,4,2.5,3290,6628,3290,0
8929000350,20140804T000000,472217,3,2.5,2010,2212,1390,620
1322049335,20140528T000000,244615,3,2.5,2060,4030,2060,0
7715600070,20141212T000000,385000,3,1.75,1560,14288,780,780
2985800070,20140725T000000,549995,3,1,1120,6600,1120,0
98000560,20140816T000000,959900,4,3.75,3550,15151,3550,0
125059179,20140723T000000,510000,6,4.5,3300,7200,3300,0
7558800570,20140813T000000,367000,3,1.75,2000,12669,1200,800
9378700200,20141008T000000,375000,5,3,2680,8410,1810,870
2767603612,20140512T000000,500000,2,2.25,1290,1334,1290,0
2767603612,20150113T000000,489000,2,2.25,1290,1334,1290,0
3259400024,20150427T000000,340000,3,2,1150,700,800,350
7954000125,20150501T000000,562000,3,1.75,1880,5978,940,940
5535600640,20140912T000000,489950,3,2.5,2400,7478,2400,0
1313000710,20141003T000000,652000,3,2.25,1920,9600,1560,360
1786700240,20141024T000000,472000,4,3.25,4350,7090,2870,1480
2739200160,20140612T000000,333000,4,2.5,1910,9244,1910,0
2874600335,20140530T000000,560000,3,1.5,2000,7350,2000,0
3222049159,20141201T000000,799000,4,3.5,3290,20107,2220,1070
7856550240,20140710T000000,860000,5,2.25,3480,9200,3480,0
2817910030,20150430T000000,449500,4,2.5,2410,55931,2410,0
8649900160,20141205T000000,692500,4,3,2820,11500,2820,0
7856610160,20140812T000000,925000,4,1.75,2710,11400,1430,1280
3705000070,20141021T000000,267500,3,2.25,2080,2856,1550,530
2619950400,20140714T000000,396800,4,2.5,2200,6018,2200,0
7749500160,20150409T000000,220000,4,1.5,1180,8058,1180,0
3585300445,20140822T000000,892500,3,1.75,2120,56192,1720,400
2909700070,20140527T000000,455500,3,2,1460,10311,1460,0
2581900036,20140612T000000,743000,3,1.75,2110,11250,2110,0
5589900400,20141205T000000,338000,4,1.5,1790,17925,1790,0
323089159,20141003T000000,332000,3,1.75,1340,13115,1340,0
5015000700,20150123T000000,563225,3,1,2460,4000,1370,1090
624110860,20150427T000000,1.15E+06,4,3.5,3760,20609,3760,0
9521100465,20141013T000000,645000,2,1,1240,5000,1000,240
3275790140,20141230T000000,739000,3,2.5,2750,16000,2560,190
1313300400,20140701T000000,435000,3,2.5,2530,13446,2530,0
8670900140,20140729T000000,995000,3,2.25,3200,3800,2650,550
2540850070,20150320T000000,520000,4,2.75,2020,7357,1350,670
1921069068,20150429T000000,400000,4,2.5,3030,180263,2030,1000
3574800860,20141007T000000,440000,3,1.75,2350,7641,1510,840
5652600069,20140917T000000,440000,3,1.5,1690,6010,1230,460
4083302625,20150324T000000,738000,3,1,1280,3900,1280,0
114100791,20150403T000000,250000,3,1.5,1170,9848,1170,0
9432900070,20140902T000000,338150,4,2.25,2700,8580,2700,0
7214820400,20140902T000000,425000,3,2.25,1800,7371,1280,520
2725069157,20140613T000000,883000,4,2.5,3670,54450,3670,0
1025079074,20141202T000000,510000,3,2,2350,266151,2350,0
724069070,20140913T000000,950000,4,1.75,3100,21303,3100,0
2206700070,20141013T000000,435000,3,1,1120,9656,1120,0
8564500240,20140527T000000,415000,5,1.5,1900,10226,1130,770
7579200765,20141006T000000,439000,2,2.5,1350,944,870,480
7893205525,20140527T000000,295832,5,1,1410,6400,960,450
9320700400,20141031T000000,285000,3,1.75,1560,9514,1560,0
3226049045,20150430T000000,350000,3,1.5,1090,5003,1090,0
9828701741,20141021T000000,489000,2,2.75,1465,972,1050,415
7205510370,20141124T000000,304500,3,2.25,1790,6930,1390,400
8899000310,20150317T000000,288000,3,1.5,1300,7313,1300,0
6804600240,20150211T000000,417000,3,1.75,1920,9512,1440,480
2902201126,20150401T000000,615000,3,3,1420,991,1040,380
5536500200,20140918T000000,730000,5,3.5,3760,4857,2820,940
3530490160,20140821T000000,178500,2,1,930,3447,930,0
2008000550,20140815T000000,300000,4,2,1580,9600,1050,530
2045400075,20140623T000000,415000,4,2.5,2170,8518,1350,820
616000200,20140822T000000,452500,3,1.75,2040,15695,2040,0
7852160310,20140814T000000,1.01E+06,4,2.75,3430,15877,3430,0
8079100640,20141201T000000,653000,4,2.5,2160,7000,2160,0
6662000070,20140514T000000,715000,4,2.25,2060,5649,1360,700
1928300640,20140828T000000,541000,3,1.75,1410,4080,1410,0
7888100240,20141209T000000,245000,4,1.5,1850,7547,1850,0
3034200516,20150217T000000,547000,2,1,1370,10038,1370,0
7504000510,20150402T000000,750000,5,2.75,3330,12408,1740,1590
9141100070,20150126T000000,575000,5,2.5,1970,12375,1570,400
921059200,20140813T000000,216000,3,1.75,1310,8670,1310,0
3645100240,20140922T000000,443000,3,1.75,1640,4579,1640,0
4123800260,20141103T000000,257700,4,2.25,1600,6202,1600,0
7334401000,20150414T000000,278000,3,1,1230,9440,1230,0
2111010890,20141105T000000,300000,3,2.5,2240,3691,2240,0
4137070830,20150213T000000,269100,3,2.5,2190,7904,2190,0
7283900036,20140818T000000,402500,3,1,990,10752,990,0
345700340,20140610T000000,306888,2,1.5,1010,7719,1010,0
4178300070,20141226T000000,795000,4,2.5,2920,14210,2920,0
3342103228,20140804T000000,525000,4,2.5,2310,5573,2310,0
5451300105,20140720T000000,1.05E+06,3,2.5,3470,12076,2560,910
5249803645,20140829T000000,452000,2,1,1220,6000,880,340
7326200030,20150413T000000,350000,3,2.25,1550,5401,1550,0
7227502075,20150409T000000,410000,4,2.5,2070,6180,2070,0
7011200160,20141113T000000,595000,3,1.75,2060,3600,1180,880
7202340390,20150407T000000,499000,3,2.5,1690,4851,1690,0
5412100240,20141022T000000,340000,4,2.5,2550,7555,2550,0
1245000685,20140625T000000,1.07E+06,5,3.25,3370,7947,3370,0
3222059187,20140528T000000,460000,4,3,2230,52983,2230,0
1822500270,20140819T000000,345000,4,2.5,2382,5899,2382,0
2310010270,20150218T000000,280500,3,2.25,1620,7566,1620,0
9547204930,20150225T000000,704000,3,1,1140,6120,1140,0
8137500400,20141007T000000,545000,3,2.5,2140,40173,2140,0
3343901242,20140807T000000,335000,3,1.5,1900,7584,1900,0
486000510,20140523T000000,1.33E+06,4,3,3370,7920,1860,1510
537000075,20140811T000000,420000,3,2.75,2300,8000,1430,870
3544400045,20150220T000000,705000,4,2,2040,5050,1160,880
9211520400,20141104T000000,274900,4,1.75,1840,10528,1210,630
2738600140,20140502T000000,499950,4,2.5,2860,3345,2190,670
3073500111,20150318T000000,415250,3,1.5,1400,7550,1400,0
7889000160,20150317T000000,222000,3,1,990,7520,990,0
1422059129,20140814T000000,375000,3,2,3120,42247,2150,970
9430000070,20150430T000000,300000,3,2.5,1640,5707,1640,0
2518400046,20141118T000000,456700,3,1.75,2820,8879,1540,1280
1315300070,20150319T000000,925500,3,2.75,1970,5200,1970,0
1081330030,20140723T000000,375000,5,2.5,2840,15598,1470,1370
4397010140,20141014T000000,420000,3,2.5,2370,15375,2370,0
8564700240,20141017T000000,575000,3,2.5,2610,7301,2610,0
597000566,20150428T000000,335000,3,2,1340,1951,670,670
9828202030,20150218T000000,428000,4,2,1300,7200,1300,0
7214711260,20141001T000000,655000,4,2.5,3340,34238,2060,1280
5569620550,20140627T000000,738000,3,3,2630,4896,2630,0
6145601890,20140819T000000,415000,5,1.75,1960,3748,980,980
9269200831,20140825T000000,392000,3,1,1090,6125,790,300
6021502470,20141106T000000,555000,2,1,1550,4600,1050,500
646910560,20150306T000000,260000,3,2.5,1770,2677,1770,0
2475900565,20150309T000000,392500,3,1,1390,10500,1390,0
4139430810,20140801T000000,912000,3,2.5,2979,17313,2979,0
2586800140,20141118T000000,135000,2,1,830,7609,830,0
226059121,20140813T000000,500000,3,2.75,1560,77536,1400,160
7696610270,20141229T000000,238000,3,1.5,1360,7488,1050,310
4279900140,20141001T000000,251000,4,2,1650,5974,860,790
5422560810,20140714T000000,406500,2,1.75,1510,5319,1510,0
1657300270,20150312T000000,433495,4,2.25,3010,10925,3010,0
8648210140,20141224T000000,265000,3,2.25,1510,6071,1150,360
3034200247,20150206T000000,360000,3,1.75,1950,7260,1520,430
2204500550,20140717T000000,425000,4,1,1800,12485,950,850
7390400069,20150327T000000,450000,2,2.75,2810,11205,1510,1300
1077100070,20150316T000000,449900,3,1.75,1760,8266,1760,0
423059360,20141017T000000,345000,4,2.5,2040,5875,2040,0
3316500200,20141009T000000,612500,4,2,1690,35346,1690,0
1328300990,20140805T000000,317000,3,1.75,1530,7650,1530,0
4443800505,20150507T000000,585000,3,1.5,1810,3880,1310,500
7327500200,20140618T000000,455000,3,1.75,1180,14292,1180,0
4054510310,20141201T000000,1.04E+06,4,4,4090,51908,4090,0
7525100060,20140820T000000,497000,4,2.25,2250,3463,2250,0
3065600270,20150422T000000,226750,3,1.75,1070,6315,1070,0
2881700273,20140819T000000,385000,4,2,1820,7102,1220,600
7889600685,20141211T000000,205000,3,0.75,1080,5025,1080,0
1137500070,20140929T000000,745000,4,2.5,2760,13093,2760,0
5104530810,20140620T000000,371000,4,2.5,2550,4770,2550,0
3905060070,20140829T000000,545000,4,2.5,2080,8504,2080,0
6450302545,20150508T000000,443000,3,1,1280,5460,1280,0
7972602435,20150318T000000,287000,2,1,950,6350,950,0
5423500240,20140624T000000,194000,3,1,1050,7577,1050,0
8074200160,20140629T000000,265000,3,1,1800,7650,1800,0
3317500070,20150408T000000,1.14E+06,4,2.75,3840,10004,2110,1730
6119700030,20150508T000000,699950,4,3.25,3674,12793,3674,0
2568800160,20141015T000000,433000,4,1,1710,7000,1710,0
2781250520,20141016T000000,200000,2,1.75,910,2693,910,0
7230200310,20150409T000000,289571,3,1.5,1340,25160,1340,0
4400900030,20140602T000000,440000,4,2.75,2340,11034,1720,620
4038300070,20141113T000000,400000,3,1.5,1510,8360,1120,390
5706000070,20141014T000000,589000,4,2.5,2630,15000,2630,0
825069078,20150324T000000,850000,5,2.25,3100,97661,3100,0
363000045,20150102T000000,520000,3,1,940,3000,940,0
1912100875,20150423T000000,555000,2,2.25,1370,1248,1200,170
7853230200,20150309T000000,470000,3,2.5,2480,5082,2480,0
9406500350,20141229T000000,207000,2,1.5,1068,1158,1068,0
5152960350,20141113T000000,379750,4,2.75,2390,9650,1620,770
6021500320,20150507T000000,709000,4,1.75,2170,4600,1270,900
7137910140,20140923T000000,240000,3,2.5,1520,9864,1160,360
6117500955,20150204T000000,445500,4,1.5,2210,10497,1650,560
269001331,20140909T000000,1.31E+06,5,2.5,3200,7863,1600,1600
1023059190,20150324T000000,210000,3,1.5,1160,10125,1160,0
8961970560,20140811T000000,603000,4,2.5,2670,5895,2670,0
3066400710,20150407T000000,720000,3,2.5,2520,10012,2520,0
795000765,20140616T000000,92000,2,1,760,5500,760,0
2767603535,20150126T000000,600000,3,1.75,1310,5000,1310,0
7774200070,20150408T000000,725000,4,2.5,2750,13950,1380,1370
4029400140,20141210T000000,409950,5,2.25,1790,10300,1270,520
1954400060,20140506T000000,515000,3,2.5,1790,7167,1790,0
2473002650,20150512T000000,495000,4,2.5,2400,11640,1800,600
5451220200,20140624T000000,998000,4,2.25,2420,10200,2420,0
1472700200,20140709T000000,630000,3,1.75,1710,8767,1710,0
1661000060,20140801T000000,410000,3,1.75,2000,7480,1320,680
2600110710,20140819T000000,602000,3,2.25,1580,11580,1580,0
2600110560,20141112T000000,750000,4,2.75,2310,10232,1310,1000
8617000060,20140708T000000,711600,4,3,3580,9316,2370,1210
8562720390,20140825T000000,1.05E+06,4,4,4320,8709,3190,1130
1137300890,20141217T000000,700500,3,2.5,2560,35265,2560,0
4104900340,20150204T000000,710000,4,2.5,3220,18618,3220,0
2616700560,20141204T000000,250000,3,2,1660,13085,1010,650
1061500510,20141015T000000,350000,4,1.75,2420,8400,1620,800
6411600370,20140515T000000,475000,7,3.5,2870,29699,1520,1350
4154302075,20150116T000000,200000,2,1,830,7200,830,0
1727500390,20141030T000000,450000,4,2.25,1710,7000,1040,670
2538410260,20140801T000000,316000,5,2.5,2600,4641,2600,0
9269200520,20141016T000000,310000,1,1,670,4920,670,0
7334400070,20150223T000000,392000,3,1.5,1500,11975,1500,0
1972200696,20141006T000000,521000,3,3.25,1460,1254,1460,0
2267000486,20140822T000000,495000,2,2,1540,7110,960,580
1311800560,20141121T000000,209000,3,1.75,1250,8084,1250,0
9542400075,20140606T000000,809950,4,2,2230,9900,2230,0
3223069065,20140917T000000,400000,2,1.75,1800,224769,1420,380
1724500030,20150312T000000,415000,4,2.5,2400,7292,1530,870
3751602797,20140702T000000,411000,4,2,2370,76665,2370,0
809002030,20140911T000000,825000,2,2,1830,3600,1230,600
993002127,20150223T000000,436000,3,2.25,1480,1384,1480,0
1473120140,20140708T000000,460000,4,2.5,2620,8331,2620,0
7849200861,20140714T000000,281000,3,1,1300,5782,1300,0
269000030,20140825T000000,976000,4,1.5,3120,7680,1660,1460
2607760700,20150420T000000,485000,4,2.5,2400,10364,2400,0
7715801090,20140725T000000,429000,3,2.5,1430,9240,1430,0
1999600320,20150304T000000,729000,3,2.5,2480,7428,2480,0
4221250340,20150409T000000,625000,3,2.5,2280,4757,2280,0
3668000810,20150116T000000,218500,3,1.75,1390,9328,1390,0
2337300370,20150206T000000,175000,3,1,1030,8395,1030,0
1453602065,20150205T000000,442500,3,1,1120,8200,1120,0
3359500960,20150321T000000,480000,3,2,1300,3000,1300,0
6133100125,20141008T000000,715500,3,2.25,2410,9668,1540,870
8562600260,20141120T000000,432500,3,1.75,1470,7350,1470,0
2325069032,20140731T000000,875000,5,4.25,4720,18741,3210,1510
1223039235,20141114T000000,605000,5,2.75,2910,13332,2910,0
4139480350,20150113T000000,1.69E+06,4,4,5000,12941,5000,0
3348401382,20150210T000000,318000,3,2.25,1690,12662,1090,600
164000267,20141016T000000,311300,2,1,1000,7228,1000,0
1099900030,20150415T000000,325000,5,2.75,2400,7904,1450,950
4139700260,20141117T000000,795000,5,3.5,3330,3705,2610,720
6071800310,20140619T000000,558000,4,2.25,2060,10358,1320,740
1321720140,20140528T000000,370000,4,2.5,3090,18645,3090,0
8078460320,20141118T000000,598850,4,2.5,2350,7245,2350,0
6388930570,20141023T000000,515700,3,2.5,2180,9722,2180,0
3709500060,20140620T000000,458000,3,2.5,1870,5013,1870,0
5469500640,20150224T000000,583500,3,2.25,3530,13000,3530,0
293910070,20140723T000000,653750,4,2.5,2460,4166,2460,0
3158500340,20140711T000000,299000,3,2.5,1650,4725,1650,0
2617300200,20140509T000000,532000,5,3,3480,57499,2340,1140
521049200,20140708T000000,819000,3,2.75,3176,13391,2726,450
7779200105,20140718T000000,945000,4,2.25,2420,9000,2000,420
8651500710,20141106T000000,608700,4,2.5,2260,9696,2260,0
871000435,20150509T000000,812000,4,2,2380,6122,1310,1070
217500140,20140513T000000,464000,5,2.5,3400,8970,1700,1700
9290850810,20140613T000000,950000,4,2.5,3770,35081,3770,0
6844700510,20141203T000000,700000,4,2.5,2672,4297,2020,652
1232001040,20141016T000000,435000,3,1,1180,4219,1060,120
3751601171,20141007T000000,229500,3,1.5,1810,14400,1810,0
6117502220,20141117T000000,1.58E+06,3,3,2610,22672,2610,0
4322300140,20141103T000000,265000,3,2.25,1450,13439,1180,270
1526059051,20140828T000000,995000,2,2,1600,64468,1600,0
3800000160,20140709T000000,590000,3,2.5,2650,9380,1680,970
1454600116,20140611T000000,740000,4,2.75,2490,17833,1490,1000
4174600055,20140521T000000,360000,2,0.75,850,7710,550,300
2594200566,20150406T000000,548500,4,2,1820,7200,1300,520
8825900465,20140507T000000,599000,3,1.75,1960,4788,1090,870
8562900310,20140613T000000,615000,3,1.75,2350,20820,1800,550
1446401555,20141208T000000,292000,3,1.75,1320,6600,1320,0
3528000140,20141023T000000,899000,4,2.5,3720,30649,3720,0
7625704500,20141208T000000,500000,3,1.5,2210,6500,1030,1180
3575302397,20141113T000000,580000,3,2.5,1910,11550,1910,0
6190500340,20140509T000000,580000,4,2.5,2840,6268,2840,0
475000510,20141118T000000,594000,3,1,1320,5000,1090,230
7199340320,20150409T000000,500000,3,2.5,2440,7600,1420,1020
3904940140,20141006T000000,550000,4,2.5,2420,8056,1680,740
2310030390,20150429T000000,275000,3,1.75,1180,6260,1180,0
2591800340,20150430T000000,390000,3,2.25,1820,7420,1820,0
3505100126,20140626T000000,1.25E+06,3,3,3760,8500,3060,700
3361401977,20140826T000000,250000,3,2.25,1560,15340,1560,0
5422570260,20140929T000000,405000,2,2.5,1790,5400,1790,0
100600320,20140813T000000,213950,3,1,1430,7000,1430,0
8099200030,20141222T000000,232000,3,1.5,1390,11340,1390,0
7140600055,20150411T000000,207000,3,1,990,10800,990,0
3422049276,20141211T000000,310000,3,1.75,1880,30346,1880,0
3157600240,20140903T000000,540000,3,2.5,2520,5000,2520,0
91000135,20150507T000000,750000,4,1.5,2060,4000,1580,480
423059369,20140604T000000,392500,4,2.5,2150,7303,2150,0
5152000030,20150204T000000,305000,5,2.5,2500,12220,1690,810
7732300390,20140523T000000,735000,3,2.5,2390,9157,2390,0
1954430390,20140707T000000,575000,4,2.5,2400,6137,2400,0
7891600260,20140618T000000,175000,2,1,660,5000,660,0
2329800140,20141203T000000,291000,4,2.5,1580,6633,1580,0
8653900070,20140804T000000,791500,4,2.5,3250,8970,3250,0
7740500070,20140710T000000,475000,3,2,1880,9659,1180,700
3352401090,20141113T000000,238950,2,1,1190,11400,1190,0
2767704756,20141020T000000,470000,3,3.5,1280,1257,1040,240
7504400710,20150427T000000,420000,4,1.75,2380,15324,1610,770
7787100390,20150420T000000,440000,3,2.5,2040,7605,2040,0
4240400140,20140820T000000,656000,4,1.75,1440,4300,1290,150
7202270570,20140714T000000,559950,3,2.5,2120,4310,2120,0
3037200045,20141113T000000,600000,2,2,990,5416,990,0
3750605247,20140804T000000,255000,3,1,1710,12000,1710,0
7972604425,20150401T000000,210750,4,1.5,1840,7076,1840,0
809002610,20140718T000000,485000,4,1,1150,2560,1150,0
4123840570,20141020T000000,390000,3,2.5,2250,8076,2250,0
1081200070,20150323T000000,405000,3,2.5,2460,12600,1810,650
9274204100,20140910T000000,462500,4,1,1540,4500,1540,0
1072010510,20150210T000000,435000,4,2.25,2210,14073,1630,580
7202330160,20141119T000000,440000,3,2.5,1440,5434,1440,0
8731990700,20140625T000000,299950,3,1.75,1790,7650,1790,0
9828200746,20150504T000000,440000,2,1.5,1120,1024,1120,0
9407100310,20141113T000000,312620,3,2.5,1260,11877,1260,0
6817800510,20140605T000000,372500,3,1.5,1180,12324,800,380
7212680860,20150209T000000,297262,3,2.5,1730,8076,1730,0
3260000570,20150210T000000,735000,4,3,2250,7245,1250,1000
1139000400,20140826T000000,430000,3,1.5,1550,5034,1550,0
8649401000,20141022T000000,241000,2,1.75,1070,9750,1070,0
6600400260,20140512T000000,201000,3,1,1460,9750,1460,0
1797500435,20150420T000000,570000,2,1,1060,4000,1060,0
2155000160,20140508T000000,538000,4,1.75,1840,9600,1220,620
9526600340,20150512T000000,729000,3,2.5,2440,4244,2440,0
2205500030,20150108T000000,331500,4,1.75,1700,14756,850,850
2123049114,20140519T000000,110700,2,1,680,8064,680,0
8078050140,20141002T000000,245000,3,2,1700,8448,1700,0
7617500075,20140721T000000,427000,3,1.75,2000,7111,1360,640
381000240,20140806T000000,650500,4,1.75,2340,5940,1290,1050
7568700260,20140814T000000,335900,2,1,1120,7440,1120,0
1370803925,20140903T000000,535000,2,2,1510,5133,1510,0
1250200786,20150122T000000,360000,5,2,2120,2400,1080,1040
7399300510,20150204T000000,294900,3,2.25,1500,8100,1210,290
5430300106,20150311T000000,460000,2,1,1030,5934,1030,0
2954400310,20140915T000000,1.77E+06,4,3.5,5440,38900,5440,0
9209900335,20140509T000000,463000,2,1,1150,4400,1150,0
1920079062,20141222T000000,332000,5,1.5,2420,43560,1500,920
7227800055,20140909T000000,199500,4,2,1750,8116,1750,0
7227800055,20141124T000000,247000,4,2,1750,8116,1750,0
3296900160,20140609T000000,442500,4,2.5,2170,14024,2170,0
3421069053,20140619T000000,600000,3,2,2540,237402,2540,0
7202380340,20140903T000000,449000,3,2.5,1690,3827,1690,0
6716700240,20150306T000000,725000,4,1,1600,4500,1600,0
1431400070,20150205T000000,215000,3,1,1060,7900,1060,0
9554200200,20141218T000000,582500,2,1.75,1990,6549,1170,820
1310900140,20140624T000000,305000,4,2.25,2210,9371,2210,0
9454200030,20140923T000000,734000,4,2.75,3090,7650,2340,750
1402810140,20140505T000000,300000,3,2,1050,10072,1050,0
1823069155,20140505T000000,525888,5,1.75,2550,71874,1810,740
2530800070,20140911T000000,711000,4,2.5,2095,4400,1295,800
4024100496,20140716T000000,360000,3,1.75,1520,12282,1220,300
5252000200,20141210T000000,357000,5,2.5,2750,12350,2750,0
7331900270,20140930T000000,235000,3,1.75,1200,9266,1200,0
1574700140,20140808T000000,550000,3,1.75,1830,9720,1150,680
162500030,20141205T000000,324000,3,1,1160,7202,1160,0
3705900292,20150428T000000,420000,3,2,1750,9239,1410,340
2141500070,20140619T000000,450000,4,2.5,2400,7693,2400,0
8562750060,20150420T000000,825000,5,3.5,4140,6770,3030,1110
7349620030,20140722T000000,272000,4,2.25,2115,6234,2115,0
2523039315,20141022T000000,481000,3,2,2580,15653,2580,0
2877101821,20140805T000000,500000,3,1,1220,3400,1060,160
1176000390,20140612T000000,448000,2,1.5,1630,3780,890,740
8682262190,20150319T000000,480000,2,2,1350,4220,1350,0
7202350060,20140908T000000,475000,3,2.5,1690,2890,1690,0
3630060070,20141021T000000,472500,2,2.25,1700,2383,1700,0
2413300810,20140923T000000,291000,4,2.25,1890,7616,1260,630
6450304260,20140722T000000,294000,2,1,850,5250,850,0
2025059204,20140730T000000,1.01E+06,4,2.5,2480,12688,1820,660
7202290240,20141017T000000,442500,3,2.5,1690,3129,1690,0
1788700070,20140627T000000,170000,2,1,810,8424,810,0
8085400055,20150428T000000,1.58E+06,4,2.5,3980,16304,2480,1500
5700002025,20150218T000000,665000,3,2.25,2580,6000,1780,800
853600310,20140828T000000,1.61E+06,5,4.5,6085,142725,6085,0
5332200320,20140714T000000,675000,2,1.75,2140,5000,1000,1140
2130701535,20150204T000000,279900,2,1.75,1360,10000,1360,0
510002010,20140630T000000,875000,4,1.5,1800,3245,1800,0
3630110510,20140804T000000,571000,3,2.5,1920,3867,1920,0
6300000400,20140617T000000,320000,3,1,860,5060,860,0
1560920200,20140826T000000,525000,3,2.5,2340,35021,2340,0
1652500060,20140711T000000,1.65E+06,8,2.75,4040,20666,2020,2020
9368700270,20150401T000000,137900,3,1.75,1160,5082,580,580
2223089053,20140603T000000,440000,3,2.25,1680,57063,1680,0
9828201920,20150304T000000,360000,3,1,1280,3870,640,640
7334401040,20150205T000000,271000,4,1.5,1800,9576,1800,0
5152700060,20140528T000000,465000,6,3.25,4250,23326,2150,2100
1460900030,20140926T000000,280000,4,2.5,2400,4596,2400,0
3626039250,20150428T000000,283000,2,1,940,6350,940,0
7199360320,20150213T000000,411500,3,1,1110,7208,1110,0
8731901610,20140917T000000,282000,3,2.25,2420,7548,1370,1050
6821102317,20141209T000000,535000,3,2.5,1850,1499,1790,60
3271300955,20140703T000000,554729,4,2.5,2020,4350,1730,290
3271300955,20150224T000000,868000,4,2.5,2020,4350,1730,290
2623089135,20140616T000000,427000,3,2.5,1830,65340,1520,310
2044500152,20141117T000000,455000,4,1.75,1920,6000,960,960
1725059187,20141029T000000,595000,2,1.75,1280,8500,1280,0
6699930260,20150320T000000,400000,4,2.5,3130,5240,3130,0
3295610200,20140625T000000,770000,4,2.5,3920,12415,3920,0
1186000125,20140509T000000,742500,4,2.75,3100,3773,2000,1100
6065300570,20140624T000000,1.25E+06,4,2.5,3220,15600,1680,1540
8039900400,20140812T000000,375000,3,2,1670,13775,1670,0
1925059200,20150407T000000,1.56E+06,4,2.5,2700,17853,2700,0
5729000070,20150128T000000,545000,4,2,5461,22880,3265,2196
98000960,20140513T000000,1.05E+06,4,3.25,4400,16625,4400,0
1330300451,20141217T000000,1.57E+06,3,1.75,2190,8500,2190,0
4312700340,20150318T000000,178000,4,1.5,1200,11163,1200,0
3797700030,20141009T000000,262500,3,1.75,1470,10390,1470,0
452001890,20150415T000000,730000,3,1.75,1650,5000,1650,0
2927600105,20140703T000000,395000,5,1.75,1840,10453,1360,480
3298300140,20141024T000000,355000,3,1,1210,6650,1210,0
1321700390,20140908T000000,299990,3,2.5,1870,8541,1870,0
1222069129,20150327T000000,1.13E+06,4,3.25,3890,422096,3150,740
1081800070,20141118T000000,425000,4,2.25,2660,11200,2660,0
6414100732,20150107T000000,349000,2,1,1150,7552,1150,0
513000445,20141111T000000,554950,4,1.75,1740,4816,870,870
6888900060,20141116T000000,326000,6,3,2580,8064,1880,700
7309100270,20140626T000000,580000,4,1.75,1720,6975,1420,300
2162000260,20140827T000000,699000,3,2.5,2740,18455,1510,1230
7732000045,20141125T000000,757000,3,2.75,2610,11290,1630,980
3764800510,20140723T000000,335000,3,1.75,1400,7920,1400,0
2481600030,20140701T000000,660000,3,2,2570,28500,1970,600
5126310060,20150417T000000,540000,4,2.75,2830,7334,2830,0
1310700390,20141010T000000,320000,5,2.25,2630,8625,2630,0
6402710070,20150421T000000,280000,3,2.5,1580,7918,1580,0
5702450260,20140723T000000,324000,3,2,1540,10931,1540,0
3243200310,20140520T000000,300000,3,1,2120,7735,1060,1060
2131200885,20140828T000000,360000,3,1.75,1830,10000,1830,0
8651480550,20140623T000000,600000,3,2.5,2260,10153,2260,0
3024059036,20140530T000000,950000,4,1.75,2500,92347,1500,1000
6382500079,20140709T000000,599950,3,3.25,1830,1804,1830,0
4363700200,20150325T000000,190000,4,1,1190,7920,890,300
3876310860,20150330T000000,350000,4,1.75,2310,9002,1780,530
2391602650,20150410T000000,522000,3,1,1230,4600,1230,0
2597530070,20150318T000000,850000,3,2.5,2940,10809,2940,0
1314300046,20140630T000000,308000,3,1,1010,8800,1010,0
3693900885,20141202T000000,1.02E+06,6,2.25,2550,5000,2550,0
6046400465,20141028T000000,397500,3,1,1480,5100,1480,0
4388000070,20150127T000000,186000,3,1.75,1460,7967,1040,420
8854000370,20140620T000000,436500,5,3,3110,12429,1790,1320
4459800075,20140603T000000,710000,3,2,2140,4923,1070,1070
7153200160,20150114T000000,1.38E+06,5,3.25,3450,6360,1860,1590
7752400075,20150428T000000,450000,3,2.25,1960,10682,1960,0
7604410030,20150121T000000,375000,4,2.75,1890,5240,980,910
2144800311,20141113T000000,315000,2,1,2080,14659,1040,1040
1705400550,20150213T000000,467500,3,1,1700,4165,1700,0
9485700136,20150227T000000,330000,3,1,1140,7316,1140,0
1822039225,20140725T000000,665000,3,2.5,3136,54450,3136,0
2625059301,20150324T000000,760000,4,3.25,2590,3889,2590,0
7625702440,20141230T000000,469000,3,1.75,1480,800,1000,480
9126100487,20140813T000000,408000,3,3,1500,1473,1120,380
7922900030,20141003T000000,851000,3,2.75,2660,10350,1330,1330
8682292180,20140725T000000,410000,2,2,1350,3926,1350,0
6730700260,20150313T000000,235000,2,1,860,10500,860,0
7225000045,20140828T000000,207100,2,1,1000,4500,1000,0
4140500055,20140626T000000,560000,4,2.5,2480,16360,1510,970
2592210370,20141031T000000,903000,3,2.75,3860,12786,3860,0
1337800830,20150107T000000,998500,3,1.75,2140,4800,1690,450
1951500055,20140730T000000,268500,4,1.75,1820,13600,1120,700
1136100045,20141015T000000,494950,2,1.75,2220,33000,2220,0
3860400060,20140801T000000,1.13E+06,4,2.5,2660,11200,2660,0
1657000070,20141118T000000,250000,3,2,1470,12096,1470,0
1423069129,20150320T000000,449000,4,1.75,2350,54450,1250,1100
1118001631,20150112T000000,1.23E+06,3,2.25,2980,7700,2530,450
7399200240,20150317T000000,325000,4,2,1870,7700,1870,0
4037000160,20140615T000000,506000,5,3,2430,8000,1370,1060
8562740370,20150325T000000,751000,4,2.5,2790,6538,2790,0
9407001620,20140812T000000,280000,3,2.5,1370,22326,1370,0
2481620310,20140514T000000,1.12E+06,4,2.25,4470,60373,4470,0
7511200350,20140919T000000,580000,3,1.75,2040,81021,2040,0
4039100350,20150423T000000,665000,4,2.25,2340,5300,1700,640
808300270,20140527T000000,450000,4,2.5,2520,8515,2520,0
3023059012,20140910T000000,389900,4,1,1710,117176,1710,0
4039300810,20141117T000000,427000,3,1,1200,5252,1200,0
8849300320,20150416T000000,265000,3,1.75,1330,12618,1330,0
272000320,20141105T000000,398000,3,1.5,1310,2996,1310,0
1180002470,20141104T000000,354000,6,3.5,3020,4500,3020,0
1330290160,20150413T000000,339950,4,2.5,2260,6086,2260,0
6392000570,20141112T000000,399000,2,1,790,4000,790,0
8835200160,20141010T000000,325000,2,2,970,5000,970,0
868000575,20140819T000000,998800,3,2,2250,8000,2250,0
597000550,20140919T000000,350000,4,2.5,1530,2248,1530,0
6669000070,20140805T000000,1.00E+06,4,1.75,1780,11436,1780,0
7202340860,20150318T000000,561000,3,2.5,2120,5277,2120,0
6141100320,20140707T000000,245000,2,1,1500,6685,1190,310
6141100320,20150213T000000,570000,2,1,1500,6685,1190,310
6815100370,20141030T000000,845000,4,3,2390,4000,1460,930
5636010560,20140929T000000,314500,4,2.5,2390,9600,2390,0
2592200030,20140618T000000,650000,3,1.75,2920,9370,1620,1300
1823059159,20150506T000000,298000,2,1,850,5000,850,0
2254501620,20150409T000000,500000,2,1,930,3200,930,0
9275700765,20140610T000000,870000,4,2.5,3340,12248,2470,870
7454000875,20150406T000000,299000,2,1,710,6732,710,0
7434500127,20140812T000000,527000,3,2.25,2240,6450,1440,800
646500070,20141106T000000,420000,3,1,1060,7638,1060,0
9432900560,20150212T000000,290000,3,2.5,2360,8764,2360,0
5154700060,20141015T000000,1.66E+06,4,2.75,3520,19200,1950,1570
3395300260,20140815T000000,499990,3,1.75,1730,9334,1220,510
2113700510,20141027T000000,315000,3,1.75,1170,4000,720,450
4053200566,20141020T000000,425000,4,2.25,3680,26266,3680,0
7214720400,20150217T000000,630000,3,2.5,2900,46609,2900,0
3211210200,20141118T000000,365000,3,1.75,1290,7205,1290,0
7010700810,20141106T000000,774000,4,2.75,2010,7000,2010,0
3971700390,20150406T000000,368888,3,1.5,1490,12186,1490,0
9406550060,20141002T000000,339500,4,2.5,1930,7862,1930,0
414100045,20140923T000000,344950,4,1.75,2240,7500,1120,1120
4276400030,20141112T000000,450000,3,2,2320,17688,2320,0
9433000060,20141118T000000,814950,4,2.75,2990,6626,2990,0
7885800160,20140905T000000,299900,4,2.5,2200,5730,2200,0
2473101070,20150227T000000,315000,3,2,1500,7828,1500,0
3701000060,20141216T000000,880000,3,1.75,3860,9000,1930,1930
8651441290,20141229T000000,195000,3,1.5,1430,5200,1030,400
255400060,20141208T000000,910000,5,2.75,3750,8279,3750,0
8567450140,20140827T000000,540000,5,2.5,3100,10189,3100,0
2517000140,20140516T000000,306000,3,2.5,1870,5874,1870,0
1938400520,20141016T000000,272000,4,2.25,2040,7600,1580,460
3179100055,20141209T000000,1.30E+06,5,3.5,3700,8504,2750,950
1924069105,20141017T000000,450000,3,1.75,3150,9258,2370,780
704450070,20140707T000000,450000,3,2.5,1990,12793,1990,0
2881700046,20140610T000000,310000,4,1,1740,11075,1740,0
8955800045,20150512T000000,530000,2,2.25,2080,11285,1180,900
3816300105,20150112T000000,435000,4,2.5,2060,10125,1560,500
6649900030,20150505T000000,485000,3,2,1590,11222,1590,0
1912100885,20140702T000000,690000,3,1.5,1760,4000,1760,0
9542840570,20150401T000000,305000,4,2.5,1620,4000,1620,0
2473381070,20141105T000000,300000,3,1.75,1210,7000,1210,0
7137950350,20150122T000000,289950,4,3,2040,5050,1490,550
1088800060,20141105T000000,575000,3,2.5,2270,9600,2270,0
4054530260,20140627T000000,1.82E+06,4,4.5,6640,53330,6640,0
248000240,20140715T000000,219000,3,1.5,1060,9600,1060,0
3995700435,20140702T000000,265000,4,3,1940,8170,1940,0
9287800135,20140714T000000,1.11E+06,5,3.25,3070,5000,2050,1020
4337000070,20150309T000000,200000,3,1,930,7590,820,110
8859000045,20150424T000000,545000,4,2.75,2180,8480,1210,970
8856920550,20150319T000000,378000,3,2.5,2130,8404,2130,0
5705500075,20150326T000000,388000,2,1.75,800,4800,800,0
6163901433,20141126T000000,425000,4,2.25,2200,8384,1250,950
475000004,20140707T000000,536000,2,1.5,1130,746,1030,100
7936500172,20140528T000000,1.18E+06,3,2.5,1970,23180,1100,870
2770604080,20150324T000000,629950,3,2.5,1680,1620,1120,560
5101408599,20140611T000000,465000,4,1.75,1470,5350,980,490
1226059105,20140827T000000,545000,4,2.25,2390,40510,2390,0
3211700045,20150128T000000,592000,4,2.5,2300,11165,2300,0
8567300270,20140818T000000,446000,4,2,2280,43692,1140,1140
6021503655,20140716T000000,375000,3,2.5,1330,816,1330,0
7202331160,20140616T000000,632500,5,2.5,2640,7096,2640,0
2763710060,20140808T000000,459950,4,1.75,2430,9747,1780,650
3211270160,20140612T000000,485000,4,2.5,2470,35073,2470,0
3365900106,20150115T000000,255000,3,1,1440,11330,1440,0
1761300340,20140610T000000,251750,3,2,1320,7200,1320,0
2909300240,20150501T000000,725000,3,2.5,2810,6300,2810,0
476000324,20141016T000000,460000,3,3.25,1370,1194,1370,0
2141200030,20140828T000000,625000,3,2.5,2000,6341,1040,960
9557300560,20140508T000000,530000,3,1.75,1980,6760,1980,0
2612000200,20150427T000000,394950,3,2.5,2050,8172,2050,0
6002400030,20140814T000000,324950,4,1.75,2320,9240,1160,1160
6064800060,20150506T000000,330000,3,2.25,1960,1985,1750,210
8091410390,20150217T000000,220000,4,1.75,1910,8171,1910,0
1786830060,20140707T000000,685000,3,3.25,2030,11070,2030,0
7277100055,20150224T000000,500000,3,2.25,2210,7680,1730,480
3392500060,20140904T000000,368000,4,2.75,2610,9426,1360,1250
3897100640,20141103T000000,825000,3,2.25,2520,7975,1550,970
7942602080,20140616T000000,660000,6,1.75,1840,2774,1060,780
2787311480,20140929T000000,253000,3,1.75,1570,7416,1570,0
5467200055,20150307T000000,392500,4,2.75,2400,19923,1320,1080
7277100510,20150214T000000,605000,3,1.75,1930,5400,1930,0
2525300200,20140515T000000,215000,3,1,1160,10384,1160,0
7732500270,20140925T000000,650000,4,2.5,2820,15000,2820,0
5700001920,20150219T000000,877500,4,2,3060,8000,2040,1020
5560000640,20140619T000000,232500,3,1,1320,8450,880,440
2781250560,20141202T000000,234000,2,2,1200,3624,1200,0
1122059037,20150413T000000,380000,3,1.75,1560,104108,1250,310
5515600163,20140916T000000,420000,5,2.25,3070,64033,2730,340
8807300570,20141229T000000,399950,3,1,1040,9600,1040,0
9412700550,20140521T000000,256750,3,2.5,1990,8991,1570,420
9202600060,20140602T000000,535000,3,2.5,1690,9626,1690,0
8857320030,20141107T000000,515000,3,2,1810,2738,1810,0
685000160,20150212T000000,770000,4,1.75,2520,8442,1640,880
8001100030,20150102T000000,256000,3,2.5,1570,5113,1090,480
9144100126,20140821T000000,489900,3,1,1680,8910,1680,0
7149410060,20140820T000000,165000,3,1.5,1250,7200,1250,0
3388000640,20150318T000000,220000,3,1.5,1280,7742,1280,0
1321700030,20140624T000000,575000,4,2.5,4620,20793,4620,0
6662400105,20141030T000000,375000,3,2.5,1580,5725,1580,0
3971700903,20150122T000000,422250,3,1.75,1650,7145,1300,350
6804600260,20140603T000000,420000,3,1.75,1660,9600,1380,280
8078460520,20140923T000000,608000,4,2.5,2410,7140,2410,0
2436700800,20140516T000000,620000,3,2.25,1720,4000,1450,270
2592210510,20150217T000000,850000,3,2.5,3120,12406,1940,1180
9414610320,20150116T000000,463000,4,2.5,2680,9928,1340,1340
7567600030,20150127T000000,750000,5,1.75,2640,13290,1400,1240
624110810,20150325T000000,1.07E+06,3,3.25,3730,13264,3730,0
4123800400,20140909T000000,290000,3,2,1700,6498,1700,0
9424400105,20140710T000000,525000,4,1.75,2280,5959,1250,1030
7941130140,20150217T000000,319000,3,2.25,1220,2980,1220,0
1568100295,20150202T000000,592500,6,4.5,3500,8504,3500,0
6683000295,20140513T000000,350000,3,2.5,2010,14298,2010,0
5710610520,20150226T000000,454900,3,1.75,2130,9775,1430,700
1565900390,20150415T000000,272000,4,2.25,1800,9018,1800,0
6608500260,20140716T000000,357500,3,1,1070,10125,1070,0
7338401230,20140828T000000,285000,3,1.75,1020,5000,1020,0
7212660520,20150326T000000,280000,4,2,1600,6861,1600,0
8901001290,20140903T000000,477000,4,1.5,1380,7800,1080,300
3345100030,20140722T000000,750000,3,2.25,3270,168000,3270,0
7986401275,20141119T000000,595000,4,2.5,2100,3125,1400,700
3047700045,20140717T000000,525000,3,2.25,2110,2850,2110,0
1422029117,20140711T000000,319000,3,1.75,1640,53400,1640,0
104530240,20140827T000000,225000,3,2,1320,5665,1320,0
8718500260,20140723T000000,485000,4,2.5,2420,10603,1210,1210
3735901040,20140703T000000,341000,3,1,1390,4814,1390,0
3448002180,20150116T000000,674000,3,3.25,2320,6744,1930,390
5126300960,20150127T000000,442250,3,2.5,2170,8169,2170,0
1774220400,20140513T000000,591000,4,2.25,2710,38180,2710,0
8648100030,20141113T000000,276000,3,2,1450,8928,1450,0
7940710070,20140822T000000,394000,3,2.5,1370,4400,1370,0
1518000070,20141119T000000,355000,3,2.5,1810,3192,1070,740
3832500260,20140509T000000,260000,3,2.5,1420,14850,1020,400
1139600270,20140701T000000,300000,3,2.75,2090,9620,1340,750
1139600270,20150324T000000,310000,3,2.75,2090,9620,1340,750
1099610830,20141202T000000,209000,3,1,1330,6900,1330,0
5647000060,20141211T000000,344950,3,2,1330,7419,1330,0
3352402272,20140611T000000,230000,5,2,1910,7200,1110,800
6669020640,20150424T000000,336950,3,1.75,2310,7680,1410,900
6154900070,20140611T000000,700000,3,2.75,2500,7378,1390,1110
1545802080,20140904T000000,230000,3,2,1310,7332,1310,0
8161020060,20140620T000000,443500,4,2.5,2040,21781,2040,0
8161020060,20150414T000000,471000,4,2.5,2040,21781,2040,0
443000060,20141210T000000,595000,3,2.25,2400,16301,1400,1000
4172100200,20141121T000000,470000,3,1,1400,4914,1400,0
7309100070,20141212T000000,600000,4,1.75,1700,7800,1700,0
191100672,20140527T000000,1.38E+06,4,3.75,3160,9525,3160,0
2125400160,20141114T000000,427800,3,1.75,1340,13241,1340,0
259800060,20140606T000000,445000,4,2,1470,8395,1470,0
4402700125,20140716T000000,382000,3,1.75,1790,7679,1790,0
7504180070,20141111T000000,577000,3,1.5,1560,20251,1200,360
2723069129,20150506T000000,427000,3,2.5,2620,108464,2620,0
3210400060,20141224T000000,255000,3,1,1580,8206,1100,480
8658301535,20140721T000000,240000,3,1,1090,10000,1090,0
8923100125,20140620T000000,1.23E+06,5,3.25,3240,6551,2500,740
5592900105,20150213T000000,435000,4,1.75,2520,7200,1260,1260
8964800695,20150327T000000,1.45E+06,3,1.75,2230,13529,2230,0
5104510860,20150506T000000,425000,4,3,2430,5502,2430,0
1090000075,20141216T000000,393000,2,1,1020,4200,1020,0
1446800181,20140620T000000,264950,4,1,1810,7500,1410,400
1829300520,20150412T000000,746500,4,2.5,3460,9699,3460,0
3992700070,20141124T000000,450000,3,1,2020,8100,1170,850
2472950160,20140617T000000,229950,3,2,1410,7466,1410,0
3468800310,20150113T000000,425000,2,1,750,4000,750,0
6613000935,20140513T000000,2.56E+06,4,2.5,5300,26211,4570,730
4054530240,20150427T000000,1.40E+06,4,3.5,4380,66613,4380,0
2600040160,20141031T000000,753000,3,2.25,2290,9047,2290,0
4229900140,20141006T000000,310000,2,1,720,5750,720,0
1005000240,20141219T000000,395000,2,1,1200,6014,600,600
4188000240,20141211T000000,725000,3,2.5,2620,28703,2620,0
1562100340,20140828T000000,295000,4,3,2120,7650,2120,0
7941600390,20140623T000000,225000,3,1.75,1580,8820,1580,0
2655500241,20140814T000000,1.70E+06,3,3.25,4160,35153,3690,470
8651720060,20150202T000000,431000,3,2.25,1830,8831,1460,370
2621750350,20150326T000000,358500,3,2.5,2000,8057,1360,640
2397101375,20150428T000000,595000,2,1,980,3600,980,0
808300200,20150319T000000,468000,4,2.5,3040,20682,3040,0
8645500370,20141203T000000,260000,4,1,1740,8100,1020,720
5668500045,20140917T000000,375000,3,2,1450,7300,1450,0
6679000370,20140525T000000,295000,3,2.5,1560,4200,1560,0
8699800070,20140731T000000,403900,4,2.5,2050,8909,1690,360
9500900060,20140722T000000,269950,3,1.75,1760,12823,1460,300
2255500060,20150218T000000,640000,3,3.5,1740,1975,1310,430
5071500140,20140627T000000,221000,3,1,910,8789,910,0
3546000070,20140617T000000,255000,3,1.75,1700,7532,1700,0
9478500570,20140623T000000,300000,4,2.5,2620,4469,2620,0
2473440070,20150320T000000,270000,3,2.25,1500,7410,1500,0
952001710,20150303T000000,575000,4,1.75,1630,5750,1160,470
7905400160,20150211T000000,246900,3,1.5,1370,9800,1370,0
6852700520,20150406T000000,635000,2,2.5,1390,1132,1130,260
625100004,20150317T000000,450000,3,2,1540,67756,1540,0
6600400370,20140910T000000,215000,3,1,1190,7500,1190,0
2025770310,20140611T000000,785000,3,3.5,4500,21870,4500,0
2126049290,20150220T000000,522500,4,3,2370,8154,1380,990
1843200350,20140722T000000,150000,2,1.5,1360,1934,1360,0
3750600566,20141215T000000,199950,2,1.75,870,18537,870,0
3761100045,20140618T000000,3.00E+06,4,4.25,4850,12445,3850,1000
7937600262,20140710T000000,379900,3,2,3110,44967,3020,90
3629921000,20141121T000000,950000,4,2.5,3700,7051,3700,0
7519000335,20141203T000000,865000,6,2.75,3500,5150,2430,1070
5459000240,20140604T000000,785000,3,1.75,1670,9600,1670,0
9835801000,20140625T000000,245700,3,2.25,1640,8400,1180,460
1102001274,20150415T000000,951000,3,2.25,3400,12825,3400,0
7950303290,20150402T000000,499950,3,1.75,2060,3500,1030,1030
7968460240,20150211T000000,257000,3,1.75,1330,36537,1330,0
9827700105,20140917T000000,549000,3,2,2330,3600,1580,750
3536900030,20150209T000000,1.60E+06,3,2.75,3040,21052,3040,0
328000160,20141211T000000,1.40E+06,5,3.75,3700,7920,2900,800
6909700340,20140820T000000,619000,3,2,1990,3000,1430,560
829000160,20141009T000000,311000,5,3,2020,5917,1220,800
4077800376,20140701T000000,600000,5,2.25,2980,7781,1580,1400
6154500030,20140626T000000,1.08E+06,4,3.5,3990,5267,3990,0
9828202325,20140619T000000,436000,2,1,790,6600,790,0
795002190,20140715T000000,205000,2,1,1060,8000,1060,0
226059065,20140903T000000,514000,3,2.25,2260,54014,1450,810
8682280270,20140903T000000,530000,2,2.5,1900,2983,1900,0
7695370160,20140811T000000,511000,5,2.5,3361,6983,3361,0
3025300226,20140515T000000,2.10E+06,4,1.75,3550,19865,3550,0
241900160,20150310T000000,370000,5,2.5,2740,5460,2740,0
2461900550,20141216T000000,500000,4,1.75,2040,6000,1020,1020
9206700060,20141105T000000,710000,4,2.5,4070,129808,4070,0
1997200060,20140908T000000,270000,1,1,720,5196,720,0
5468700105,20140805T000000,415000,3,1.75,2000,8400,2000,0
5078400160,20140605T000000,1.80E+06,5,4.5,4400,15580,3390,1010
6603000030,20141217T000000,236000,3,1.75,1300,8976,1300,0
8598200070,20141208T000000,278000,2,2.5,1420,2229,1420,0
5101402435,20140603T000000,312000,3,2.25,1540,5338,770,770
5101402435,20150304T000000,539000,3,2.25,1540,5338,770,770
8820902400,20140910T000000,498000,3,3,2360,2750,1780,580
1246700251,20140527T000000,857000,4,3,3720,29043,3720,0
5315101716,20150225T000000,780000,3,1.75,1690,13500,1690,0
5035300570,20140923T000000,650000,3,2,2300,5000,1150,1150
4123400310,20150409T000000,559500,4,1.75,1650,7088,1650,0
4058802255,20140724T000000,219950,2,1,990,6448,990,0
2141330560,20140725T000000,671500,4,2.25,2130,8410,2130,0
2725069121,20140903T000000,813000,4,2.5,3320,52707,3320,0
7682200340,20140728T000000,182000,3,2.25,1960,8875,1290,670
9518100059,20140822T000000,203700,2,1,770,2500,770,0
1861400060,20140505T000000,740000,4,1.75,2010,3600,2010,0
2223059053,20150311T000000,230000,2,1,800,17965,800,0
421049114,20141009T000000,128000,3,1,910,11117,910,0
6703100140,20140822T000000,345000,3,1,1200,6628,1200,0
6127010890,20150427T000000,663000,4,2.5,3570,6246,3570,0
8898700960,20140620T000000,329950,3,2.5,1820,8085,1820,0
486000597,20140811T000000,1.05E+06,3,2.25,2930,7005,2670,260
7175300045,20141112T000000,402300,3,1.75,1480,4050,870,610
3073500045,20140507T000000,492000,4,2.5,3305,16164,2245,1060
2407900550,20150507T000000,448000,4,2.5,2230,5000,1650,580
5379802650,20150225T000000,273000,3,1,1560,7800,1560,0
4364700990,20141003T000000,335000,3,1,1030,7200,880,150
2158900140,20140905T000000,695000,3,3.75,2380,3600,1690,690
3235100075,20150503T000000,279000,3,1,1010,7903,1010,0
2887701940,20141205T000000,485000,2,1.75,2060,2700,1030,1030
7399200510,20140812T000000,383000,4,2.5,2370,10580,2370,0
3578600045,20141216T000000,490000,4,2.5,2242,37451,2242,0
9406500310,20141119T000000,240000,2,1.5,1078,1263,1078,0
1560100135,20150224T000000,285000,2,1,890,7250,890,0
1326069094,20150225T000000,524950,3,1.5,2700,24539,2120,580
3396830310,20150407T000000,729000,4,2.5,2450,27081,2450,0
4040400340,20140905T000000,460000,3,1.75,1420,8250,1420,0
7234601221,20141014T000000,687500,3,1.5,1280,2114,1280,0
6065301040,20140814T000000,1.17E+06,5,2.75,2910,15118,1780,1130
2600010390,20141015T000000,825000,4,2.25,2430,10050,2430,0
6679000560,20140729T000000,314950,2,2.5,1860,6359,1860,0
6743700335,20140604T000000,470000,3,2,1800,12669,1800,0
2207000060,20140818T000000,500000,3,1.5,1960,8815,1020,940
1900000060,20141117T000000,313000,3,1.5,1550,7260,1550,0
1232001480,20140710T000000,445000,2,1,840,3840,840,0
9835800320,20140828T000000,300000,4,1.75,2080,8750,1330,750
9285800055,20141014T000000,619500,4,2.5,2210,5077,1480,730
3438500677,20140613T000000,305000,3,1.5,1210,5240,610,600
3879901290,20150401T000000,874000,3,2.5,1350,941,1350,0
3905040060,20150313T000000,477500,3,2,1860,5146,1860,0
9530101290,20141110T000000,700000,3,2,1940,4500,1090,850
5104532030,20150306T000000,515000,4,3.5,3400,5222,3400,0
6411600045,20141016T000000,590000,4,2.5,2240,9385,2240,0
1796360990,20140701T000000,205000,3,1.75,1170,8239,1170,0
9264911550,20141022T000000,310000,3,3.25,3130,9302,2190,940
7715800310,20140821T000000,442500,2,2.25,1510,7280,1510,0
3407700012,20141106T000000,1.08E+06,4,3.5,3740,41458,3740,0
2322069116,20140825T000000,530000,4,2.5,2690,46609,2690,0
4058800875,20140624T000000,343500,4,1.75,1760,6204,1180,580
8113101070,20150423T000000,334900,4,1.75,2180,4066,1270,910
9512501370,20141105T000000,544300,4,1.75,1560,9000,1560,0
3670500465,20140526T000000,370000,3,2.5,1780,4050,1780,0
8856950310,20140524T000000,245000,3,1.75,1260,6908,1260,0
4315700505,20150210T000000,535000,4,1.75,1570,3250,1570,0
3046200125,20150406T000000,202000,2,1,740,6550,740,0
2922701420,20141118T000000,490000,4,2.25,2020,4960,1710,310
6430500238,20141216T000000,651500,4,1.5,1500,3075,1420,80
6031400071,20150114T000000,270000,4,2.5,1670,8056,1170,500
1854750030,20150407T000000,1.16E+06,3,3.5,3620,8072,2920,700
7950302121,20140716T000000,289000,2,1.5,1010,1309,860,150
1421069117,20150417T000000,240000,3,1.5,1460,13503,1460,0
1370803510,20140515T000000,790000,3,1.75,1790,6117,1350,440
1559900140,20141222T000000,350000,3,2.25,1760,9621,1760,0
2734100738,20141029T000000,246950,3,3.5,1790,1682,1480,310
7007700030,20150105T000000,400000,3,1,1050,6000,1050,0
7702020030,20150225T000000,533000,4,2.5,2590,6394,2590,0
1795500060,20141021T000000,198400,3,1,1040,8645,1040,0
3303860030,20141029T000000,495000,4,2.5,4060,8547,2790,1270
7701960990,20140616T000000,862000,4,2.5,3190,14565,3190,0
7701960990,20140819T000000,870000,4,2.5,3190,14565,3190,0
5453700060,20150224T000000,875000,4,1.75,2180,9726,2180,0
2143700935,20140903T000000,317000,6,3.5,2120,5840,2120,0
9485300560,20140725T000000,325000,4,2.75,2110,6838,2110,0
3693900135,20140920T000000,615000,2,1.5,1210,5000,1210,0
7212650990,20140721T000000,334950,4,2.5,2410,7846,2410,0
1245001659,20140821T000000,775000,3,2.5,1980,7807,1980,0
6071300550,20140822T000000,600000,4,2.5,2370,9135,1600,770
4083306620,20140728T000000,565000,3,1.75,1720,2218,1270,450
8122100392,20141028T000000,292500,2,1,750,5026,750,0
5418500800,20150429T000000,825000,3,2.25,2510,10418,1810,700
2421059036,20150415T000000,495000,3,2.5,2577,156816,2577,0
952000310,20140520T000000,525000,3,1.5,1540,4773,1540,0
5694501195,20150511T000000,438600,1,1,720,2500,720,0
2872900390,20140814T000000,507000,3,2.25,1810,8158,1450,360
1502400140,20150429T000000,275900,3,1.75,1380,8400,1380,0
3860900003,20140617T000000,1.17E+06,4,2.5,2570,6251,2570,0
1180003435,20141209T000000,275000,4,1.75,1690,6000,1690,0
6430000070,20141027T000000,355000,3,0.75,1420,3060,860,560
5530000030,20150126T000000,233000,4,2,2130,9579,1250,880
5700000465,20140904T000000,666000,3,2.5,3000,5000,2110,890
3211100570,20140811T000000,317500,4,2.5,2150,9000,1360,790
9536601331,20140722T000000,420000,4,2,2280,10319,1270,1010
985000955,20150312T000000,290000,4,2,1560,8800,1560,0
323059208,20140603T000000,320000,3,2,1880,10758,940,940
4221270350,20150323T000000,650000,3,2.5,2320,5284,2320,0
3768000030,20140714T000000,325000,3,1.75,1010,7171,1010,0
7211401610,20140820T000000,165000,3,1,1120,5000,1120,0
9542000340,20140807T000000,500000,3,1.75,1560,16194,1560,0
2426049078,20140716T000000,443000,4,1.5,1860,12197,1860,0
5438000160,20140609T000000,213400,3,1.5,1150,8686,1150,0
259600890,20141002T000000,480000,4,1.75,1920,9380,1920,0
8732190200,20150115T000000,275000,4,2.25,2490,7233,1460,1030
3395040200,20140709T000000,299880,3,2.5,1460,3044,1460,0
6362900171,20140527T000000,499950,3,3.5,1820,1501,1430,390
2154500060,20141203T000000,1.71E+06,5,3,4290,17100,2480,1810
5706200370,20140806T000000,550000,4,2.75,2230,9460,1480,750
1402950240,20140602T000000,300000,4,2.5,2070,7476,2070,0
4141800030,20141014T000000,920000,3,1.75,2480,4000,1240,1240
3426049284,20140819T000000,2.30E+06,4,3.25,4110,15929,2720,1390
3658700510,20140724T000000,620000,4,2.75,2290,3060,1550,740
2220069196,20140811T000000,253500,3,1,1220,20400,1220,0
5700004485,20140520T000000,978000,4,2.75,2620,13777,1720,900
1328320350,20141202T000000,387500,4,2.5,3190,9856,3190,0
3432500310,20140624T000000,325000,3,1,850,6906,850,0
9274200318,20150410T000000,568000,3,2.5,1740,1308,1740,0
3034200550,20140922T000000,525000,4,2.5,2140,7754,2140,0
2078500350,20140604T000000,560000,3,2.5,2070,12708,2070,0
7203101290,20141020T000000,394000,3,2.5,1680,4075,1680,0
9287801455,20141028T000000,484950,2,1,1000,4956,1000,0
9472200060,20141105T000000,1.30E+06,3,2.75,3340,12690,2550,790
869700060,20140729T000000,315000,3,2.5,1260,2767,1260,0
4298100060,20140509T000000,590000,4,2.25,2430,32496,2430,0
7211402105,20141126T000000,106000,1,1,560,5700,560,0
7135520260,20141118T000000,751000,3,2.5,3380,9528,3380,0
9222400565,20141017T000000,474000,2,1,1100,3500,1100,0
7116500125,20140528T000000,189000,2,2,1700,3171,850,850
7202290320,20141024T000000,440500,3,2.5,1600,3172,1600,0
9808630260,20150318T000000,1.02E+06,3,2.5,2605,2216,2090,515
8682310310,20150511T000000,589000,2,2,1850,4667,1850,0
4137000700,20140829T000000,273000,3,2.25,1830,7651,1830,0
5119400075,20140620T000000,950000,3,3.25,3050,18892,1650,1400
8857100060,20141110T000000,277700,2,1.5,1240,1055,1200,40
3329510200,20141124T000000,299900,3,2.25,2100,8163,2100,0
7789200070,20140603T000000,235000,3,1,1250,15603,1250,0
6140600049,20150506T000000,464000,2,2,1230,4800,1230,0
9324320030,20150317T000000,281000,3,1.75,1690,9826,1690,0
2555900030,20141107T000000,320000,3,1,1520,8870,1520,0
8662500350,20140620T000000,282000,4,2,1890,6302,1890,0
7856601040,20150220T000000,745000,4,1.75,1990,8900,1990,0
109200390,20140820T000000,245000,3,1.75,1480,3900,1480,0
109200390,20141020T000000,250000,3,1.75,1480,3900,1480,0
6870300060,20140922T000000,470000,3,2.5,2120,2374,1770,350
2734100732,20141015T000000,216650,3,3.5,1480,1077,1300,180
7201900370,20150505T000000,440000,3,1,1250,8412,1250,0
3904960700,20140613T000000,590000,4,2.5,2010,7972,2010,0
2225059240,20141028T000000,935000,5,2.5,3150,35283,1800,1350
4397650160,20140922T000000,848000,3,3.5,3010,5717,3010,0
3629860060,20150312T000000,827500,5,4.25,3920,5823,3000,920
4083305085,20140520T000000,1.13E+06,6,3,2880,3192,2180,700
518500700,20140507T000000,630000,2,2.25,2550,5663,1720,830
3580900260,20140505T000000,340000,5,1,1120,9022,1120,0
1974300060,20140923T000000,570000,4,2.75,3140,10918,1900,1240
624069035,20141209T000000,2.75E+06,4,4,4130,5575,2860,1270
5152980070,20150102T000000,514500,4,2.5,2990,9614,1740,1250
2624039114,20150413T000000,360000,2,1,1120,12625,1120,0
4337000200,20141217T000000,228900,4,1.5,1570,8775,1570,0
7203100550,20140625T000000,660000,3,2.75,2210,4000,2210,0
2782100260,20150303T000000,647000,4,2.5,2390,5800,2390,0
1737320060,20140610T000000,366000,3,1.75,1520,8625,1520,0
7972604001,20140718T000000,354000,5,1.75,1830,7986,1060,770
2719100240,20140519T000000,850000,4,3.5,2640,5900,2640,0
3904990570,20140524T000000,496700,3,2.5,1740,5782,1740,0
7399000350,20141104T000000,300000,3,2,1550,8300,1550,0
6400700189,20141017T000000,390000,3,1,1040,8075,1040,0
4305200070,20140519T000000,350000,3,2.25,1640,7200,1640,0
4305200070,20140922T000000,561000,3,2.25,1640,7200,1640,0
2201500240,20140730T000000,475000,3,1.75,1260,10065,1260,0
3277800729,20141016T000000,275000,3,1.5,1170,1174,840,330
2525310320,20141028T000000,290000,3,1.75,1590,13500,1090,500
2215901840,20150211T000000,199000,3,2.5,1750,6725,1330,420
1796700160,20150324T000000,279900,4,2.5,1770,4338,1770,0
4218400671,20150505T000000,1.66E+06,4,2.25,3530,5500,2860,670
6415100350,20150413T000000,405000,3,2.5,2160,10200,1360,800
7504020400,20150127T000000,615000,4,2.25,2360,15860,2360,0
8732190070,20141002T000000,268000,3,1.75,1980,12543,1180,800
2826049200,20140825T000000,451000,4,1.5,1620,5444,1620,0
8682292190,20141215T000000,850000,2,2.75,2700,9854,2700,0
2524049250,20140921T000000,1.18E+06,5,2.25,3270,16553,2470,800
7972603385,20140516T000000,245000,2,1,870,6150,870,0
4454800060,20140626T000000,450000,2,1.75,840,3340,700,140
8910500226,20150409T000000,370350,3,3.5,1340,1168,1080,260
1972202505,20140729T000000,543000,3,2.5,1540,1256,1540,0
6303400520,20150127T000000,265000,2,2,1650,8975,1650,0
7852020340,20150325T000000,497000,3,2.5,2630,4611,2630,0
3824100041,20150412T000000,419000,4,2.25,1880,9727,1100,780
3904990260,20140724T000000,545800,4,2.5,1980,4500,1980,0
204000140,20150403T000000,403000,3,1,1500,10730,1000,500
6083000071,20141110T000000,195000,3,2,1230,8235,1230,0
6819100111,20141211T000000,1.13E+06,4,2.5,2520,2600,1670,850
7806210400,20140929T000000,255000,5,1.75,1970,8925,1170,800
4375700055,20140627T000000,500000,2,1.5,1520,8040,1520,0
207500012,20140505T000000,855000,4,2.75,2600,5390,1300,1300
2731600045,20150107T000000,390000,4,2,2290,9200,2290,0
1953400570,20150324T000000,339000,3,2,1979,8470,1329,650
2883200139,20150306T000000,1.33E+06,4,3.5,2170,3672,2170,0
3345100251,20150217T000000,429900,4,1.5,1820,17918,1190,630
1387301740,20140925T000000,370900,3,1.5,1200,8560,1200,0
3214200070,20150429T000000,457500,3,1,1210,7636,1210,0
1937300193,20150227T000000,499000,4,2.5,1970,2601,1440,530
2821049082,20150212T000000,225000,2,1,1040,11500,1040,0
2207500200,20140915T000000,615000,3,1.75,1920,4000,1070,850
9528104286,20150113T000000,455000,2,1.5,1020,1146,1020,0
8901001170,20140514T000000,458000,3,1,1660,7500,1060,600
3260200200,20141030T000000,580000,3,2.25,1670,7416,1220,450
1853080640,20140514T000000,966000,5,4.5,3810,8019,3810,0
986000045,20141007T000000,240000,4,1.75,2020,10332,1010,1010
4322200105,20150331T000000,229050,1,1,420,3298,420,0
1453600681,20150223T000000,328500,3,2.25,1390,1407,1390,0
3365900041,20150121T000000,319000,3,1.5,2010,10100,1110,900
9294300070,20140502T000000,650000,4,2,1820,5000,1640,180
5096300140,20150217T000000,398500,3,2.5,1630,1971,1630,0
985001275,20140620T000000,250000,1,1,800,16306,680,120
6669200370,20140626T000000,815000,3,2,2270,11989,2270,0
3885806840,20150316T000000,1.07E+06,3,2.75,2290,5002,1950,340
2025079037,20141001T000000,510000,3,2.25,2750,219542,1870,880
3812400202,20141114T000000,156000,2,1.75,590,6138,590,0
4136880140,20140522T000000,254500,4,2.75,2570,7264,1720,850
258500059,20140721T000000,760000,3,2.5,2050,15020,1600,450
8016250140,20150506T000000,210000,3,2.5,1610,6732,1610,0
5153100030,20140825T000000,349950,3,2.5,2140,7715,2140,0
1377800135,20150402T000000,676000,3,2,1730,6784,1730,0
7549800045,20150102T000000,475000,4,3.5,2440,3052,1940,500
3179101070,20140630T000000,880000,4,2.75,3220,4392,2320,900
629800520,20140903T000000,1.21E+06,4,3.25,4330,26162,4330,0
7129302800,20141212T000000,420000,3,1.5,1780,5000,1030,750
2450000320,20140523T000000,607000,3,1,1230,8114,1230,0
6804600990,20141124T000000,475000,4,1.75,2160,19283,2160,0
3389900800,20141022T000000,395000,2,1.75,1400,2500,710,690
524059208,20150220T000000,650000,4,1.75,1900,10454,1180,720
1523069128,20150331T000000,625000,5,2.75,2910,85377,1510,1400
5701700640,20140729T000000,849000,3,3,2960,42159,2960,0
4077800247,20140610T000000,429950,3,1.5,2010,9480,1570,440
3629860160,20141028T000000,825000,3,2.5,3760,5260,3230,530
2877102180,20140829T000000,505000,2,1,1020,5000,1020,0
7203101610,20140512T000000,265000,2,1,1290,2828,1290,0
3342100685,20140625T000000,283000,3,1,890,8400,890,0
3575301550,20150407T000000,560000,3,2.75,1620,7500,1140,480
1829300260,20141113T000000,765000,4,2.5,3360,13636,3360,0
6071000030,20140722T000000,610000,5,2.75,2930,31411,1520,1410
4099100260,20140903T000000,589000,3,2.5,2940,4799,1710,1230
3365900520,20140618T000000,192500,3,1,1080,8580,1080,0
8964800890,20150109T000000,3.20E+06,3,3.25,4560,13363,2760,1800
7977200055,20150213T000000,550000,3,1,1010,6120,860,150
7589700106,20141014T000000,460000,2,1.5,1790,3760,1280,510
9324300030,20140703T000000,264500,4,2.25,2060,11385,1200,860
5347200070,20150427T000000,339000,3,1,1150,2496,1010,140
2771600550,20141112T000000,950000,4,3.5,4030,4200,4030,0
5456000135,20140822T000000,677500,3,1.75,2020,9718,2020,0
629811360,20141205T000000,690000,4,2.5,2740,8120,2740,0
1354600160,20140509T000000,312000,4,2.25,1930,7452,1430,500
8566100160,20141022T000000,840000,5,1.75,2500,11617,1560,940
5104520550,20140701T000000,357500,3,3.5,2080,5100,2080,0
2819100140,20150427T000000,675000,3,1.5,1460,6480,980,480
7298020140,20141021T000000,515000,3,2.75,3290,11441,3290,0
8929000140,20140623T000000,491234,4,2.5,1540,1860,1540,0
9407600070,20150319T000000,290000,3,2,1310,6265,1310,0
2896000510,20140821T000000,490000,4,2.5,2120,7820,1280,840
1938000140,20150428T000000,810000,4,2,2920,10424,1520,1400
4331000400,20150220T000000,252000,3,1.5,1150,13200,1150,0
4031700030,20150410T000000,299999,3,2.5,2380,9719,2380,0
1722800860,20150309T000000,400000,3,2.75,2220,5000,2220,0
2491200955,20141229T000000,530000,5,2,3020,6000,1860,1160
2013802030,20140911T000000,357000,3,2,2460,53882,2460,0
1923300135,20150310T000000,365000,3,1.75,1820,5555,1030,790
2391600335,20150203T000000,804000,4,2.5,2620,5060,2620,0
2425039017,20140904T000000,808250,3,2,1750,2640,1010,740
6752600320,20150514T000000,360000,4,2.5,2020,7289,2020,0
193300140,20141023T000000,240000,3,1.75,1240,10956,1240,0
5651010320,20140722T000000,335000,2,2,1380,5840,1380,0
243000045,20140829T000000,380000,3,1.75,1920,8775,1920,0
1558100398,20140515T000000,350000,3,1.75,1680,250470,1070,610
4204400339,20140925T000000,194000,3,1,1400,7955,1400,0
9567800140,20150325T000000,310000,3,1,1240,7194,1090,150
4046500140,20150209T000000,315000,3,1.75,1410,15134,1410,0
2115510160,20141208T000000,258950,3,1.75,1440,8050,1440,0
9828702518,20140617T000000,479000,2,2.25,1230,932,1020,210
3888100117,20141110T000000,510000,5,1.5,1550,9750,1550,0
1775900140,20140709T000000,400000,3,2,1760,6875,1760,0
6645950070,20150401T000000,1.45E+06,4,3.5,5000,38012,3610,1390
6840701160,20141029T000000,680000,5,2,2140,5000,2020,120
1336800240,20140508T000000,1.75E+06,6,3,3510,5760,3510,0
3830200140,20140804T000000,335000,3,1.75,2010,9417,1500,510
2473510260,20140623T000000,460000,5,2.5,3390,9760,1750,1640
5056500260,20140502T000000,440000,4,2.25,2160,8119,1080,1080
8682280260,20150326T000000,412250,2,2,1300,2983,1300,0
7338000800,20141120T000000,185000,3,1.5,1280,4031,1280,0
3260701160,20150407T000000,286500,3,2,1840,8140,1040,800
3793500510,20150502T000000,422000,4,2.5,3200,6691,3200,0
9485950340,20150319T000000,408000,3,2.25,2800,35362,2800,0
2011400662,20141027T000000,306500,2,1,1390,19988,1390,0
6699940320,20150413T000000,359900,4,2.5,2600,5188,2600,0
6134500070,20140709T000000,560000,3,2.5,1960,6058,1960,0
8807810890,20140827T000000,259875,3,1,1250,21303,1250,0
8807810890,20141105T000000,385000,3,1,1250,21303,1250,0
6453300055,20141007T000000,188000,1,1,550,16345,550,0
1118001820,20140615T000000,1.14E+06,4,3.25,2500,5801,1960,540
8570900023,20141010T000000,255000,3,1,1250,10094,1250,0
629000510,20140730T000000,1.19E+06,4,2.75,3020,8622,3020,0
2028701000,20140529T000000,635200,4,1.75,1640,4240,920,720
7147400045,20150428T000000,355000,3,1.75,1870,8250,1870,0
3180100023,20150130T000000,544000,3,2.5,1760,1755,1760,0
1032000079,20150422T000000,402000,3,1.5,1320,3145,1320,0
7010700860,20141226T000000,575000,4,1.5,1430,4163,1430,0
5547500070,20140724T000000,216000,3,1.75,1580,9705,1580,0
7237501040,20140617T000000,1.20E+06,4,3.5,4170,9748,4170,0
7284900030,20140522T000000,850000,4,3.25,3090,6744,3090,0
3277801646,20140516T000000,238000,3,2,1020,1204,720,300
8722101370,20150413T000000,625000,4,1.75,2180,4431,2020,160
2436200200,20140701T000000,1.11E+06,5,3.25,3350,4000,2510,840
2716600273,20140528T000000,820000,3,2.5,2510,5503,2510,0
1795700030,20141201T000000,355000,3,2.5,1880,5290,1250,630
9421500160,20150303T000000,495000,4,1.5,1810,7998,1210,600
4139910030,20150302T000000,1.30E+06,5,2.5,4170,33310,4170,0
3080000030,20140505T000000,398750,3,2.5,2230,4000,2230,0
2568200070,20140716T000000,835000,4,2.5,3650,7784,3650,0
1546600565,20141002T000000,705000,6,2.75,2830,10579,1430,1400
9187200045,20150504T000000,625000,4,1.5,2120,5000,2120,0
8078450340,20150211T000000,550000,4,2.5,2090,6926,2090,0
9297301535,20140529T000000,540000,3,1.5,2600,5085,1400,1200
6431000196,20140604T000000,519000,2,1,830,2820,830,0
9406520260,20150128T000000,311000,4,2.5,1975,8734,1975,0
9510900140,20150406T000000,305000,4,2.5,1900,7000,1420,480
7932600140,20140703T000000,395000,4,2.75,2640,35070,2640,0
7864500140,20141107T000000,275000,4,1.5,1610,6923,1010,600
3629960550,20140807T000000,450000,3,3.25,1770,1863,1430,340
2239000016,20140911T000000,324000,2,1,1070,6000,1070,0
1069000070,20150415T000000,2.80E+06,5,3.25,4590,12793,3590,1000
1972201550,20140716T000000,565000,4,1,1540,2452,1540,0
5469000140,20140707T000000,373000,4,1.75,1590,7920,1590,0
7871500685,20140708T000000,613000,2,2,1170,1890,1170,0
7214820200,20141107T000000,614000,4,2.25,2880,9996,1920,960
6072300800,20150505T000000,595000,4,1.75,2510,8989,1680,830
6817801040,20140821T000000,440000,2,1,1280,12086,850,430
6117500160,20150317T000000,425000,3,1.5,1570,12412,1570,0
5100401516,20140925T000000,407000,2,1,740,6380,740,0
6751100125,20140825T000000,472000,3,1.5,1740,9038,1740,0
2771602420,20140617T000000,472000,3,2.5,1180,1262,1180,0
3585900045,20141022T000000,1.25E+06,5,2.75,2960,28300,2160,800
2492200055,20140708T000000,412000,3,1.75,1880,5752,940,940
461004730,20150406T000000,717000,3,1,1150,5000,1150,0
4038000055,20140812T000000,425000,3,1,1320,7076,1320,0
4338800685,20140819T000000,299999,4,2,1640,7200,820,820
2215901230,20150507T000000,254000,3,2,1470,7694,1470,0
2730000270,20150212T000000,178500,3,1,900,10511,900,0
2397100560,20141121T000000,800000,3,1.75,1510,3600,1230,280
5100403754,20140911T000000,420000,3,1,1440,5623,720,720
5634500891,20150312T000000,319900,2,1,1380,9251,1380,0
3834000004,20150302T000000,350000,2,1.5,1150,7552,1150,0
5569700075,20140528T000000,968000,6,2.75,3610,17580,2070,1540
476000338,20150225T000000,491000,3,2,1250,1306,1250,0
3299610260,20150421T000000,948000,3,2.5,3510,9824,3510,0
4441300075,20140924T000000,900000,3,2.5,2260,9577,1700,560
1796200140,20150309T000000,270000,3,1.75,2840,9800,1420,1420
5029451230,20140617T000000,198000,3,1.5,1430,7347,820,610
2523039282,20141121T000000,250000,2,1,1420,21158,1420,0
3629971290,20140730T000000,615000,4,2.5,2120,3720,2120,0
8078350520,20140916T000000,550000,3,2.5,2080,7749,2080,0
3395380200,20141017T000000,190000,2,2.5,1370,3438,1370,0
1687910200,20141007T000000,629000,4,2.25,1900,11171,1280,620
3818700016,20141007T000000,434000,3,1.75,1660,8301,1660,0
9842300036,20141008T000000,415885,3,1,1310,4163,1310,0
4206901550,20140602T000000,550000,3,2.5,1840,3035,920,920
3878900681,20150121T000000,272000,1,0.75,1040,6034,580,460
2195700270,20140627T000000,665000,3,2.5,2610,35000,2610,0
2824059128,20141009T000000,510000,3,2,1990,7405,1990,0
7635801370,20140904T000000,530000,3,2,3080,17700,1740,1340
1775910270,20141020T000000,355000,3,1,1200,16000,1200,0
5245400030,20150223T000000,255000,4,1,1250,9102,1250,0
2600400030,20140724T000000,790000,4,2.75,2640,9000,2640,0
3860900111,20141202T000000,695000,5,1.75,1790,9335,1790,0
9558800030,20141107T000000,255000,2,2,1140,8400,1140,0
255000270,20140723T000000,410000,3,2.25,1790,5794,1380,410
3526039074,20140625T000000,650000,4,2.75,1910,16532,1420,490
4083304355,20150318T000000,675000,4,1.75,1530,3615,1530,0
6840701610,20140701T000000,332888,2,2.5,1050,1029,950,100
2212200270,20150220T000000,300000,3,1.75,1730,6900,1130,600
2203500140,20140801T000000,320000,4,1.5,1100,11824,1100,0
9353301070,20150508T000000,342500,5,2.25,2100,10726,1050,1050
1326059185,20150320T000000,752875,4,2.5,2800,72309,2800,0
46100350,20140630T000000,1.73E+06,5,3.5,5000,26540,3410,1590
7987400316,20140814T000000,255000,1,0.5,880,1642,500,380
3971702325,20141103T000000,244000,3,2.5,1470,9337,1470,0
7419500200,20150401T000000,1.42E+06,5,3.25,3950,11438,3430,520
923049468,20141110T000000,218000,3,1,980,12812,980,0
5589300435,20141203T000000,359000,4,1,2180,10617,2180,0
3303990030,20141027T000000,840000,4,2.75,3040,13559,3040,0
2926069083,20140507T000000,900000,5,3.75,4130,226076,3170,960
3622059157,20141009T000000,205000,4,1.75,1850,65340,1850,0
5466350160,20150121T000000,205000,3,2.5,1600,7295,1600,0
4174600262,20150408T000000,500000,2,1.5,2070,5432,1370,700
9477940390,20150109T000000,510000,4,2.5,3180,5405,3180,0
1126069045,20140620T000000,1.14E+06,6,4.25,6900,244716,4820,2080
6096500105,20150430T000000,1.55E+06,4,2.25,2640,3000,2080,560
2923069037,20140721T000000,210000,3,1.5,1920,61014,1920,0
5649300160,20141209T000000,597500,3,1.75,2030,32565,1600,430
3121059036,20141029T000000,400000,2,1,1140,101529,1140,0
6136900045,20140821T000000,412000,3,1,1660,6992,1260,400
2426039247,20150325T000000,299950,2,1.5,1390,1756,1390,0
8818400340,20150423T000000,1.08E+06,4,3,2490,4325,1690,800
7429000240,20141118T000000,422500,4,2.5,2550,8824,2550,0
3888100030,20140714T000000,410000,3,2,1270,10227,1270,0
5699000070,20140528T000000,1.40E+06,4,3.25,2980,7000,2140,840
8731982470,20140715T000000,245000,3,2,1470,8000,1470,0
6899990200,20140702T000000,720000,4,3,3550,12327,2180,1370
4154300505,20141024T000000,315000,2,1,780,7200,780,0
9268710140,20150224T000000,191950,2,2.5,1390,1302,1390,0
9290860140,20140923T000000,455000,4,2.5,2440,5001,2440,0
5708500270,20140516T000000,523000,3,1.5,1260,3135,1260,0
16000200,20141024T000000,250000,3,2.25,1640,4420,1640,0
1352300520,20150113T000000,294000,3,3,1670,4120,1140,530
5207200160,20141010T000000,490000,3,2.25,2380,6000,2040,340
9284800844,20140916T000000,310000,4,1,1030,5750,1030,0
5602000105,20140721T000000,265000,3,1.5,1560,10489,1560,0
3585220340,20140811T000000,402000,4,1.75,1640,10500,1010,630
220069083,20140509T000000,705000,2,2.5,2200,188200,2200,0
5104531290,20141124T000000,589450,4,2.5,3190,7941,3190,0
8125200273,20141223T000000,219950,3,1.5,1200,8404,1200,0
3176600105,20140813T000000,750000,3,2.25,2250,5301,1510,740
6821101275,20140821T000000,478000,2,1.75,1960,6000,980,980
5379802090,20140714T000000,170000,3,1,1250,7015,1250,0
3211240320,20140612T000000,489950,4,2.25,2640,31941,2640,0
486000520,20140606T000000,1.37E+06,2,2.25,2460,16940,1930,530
705710640,20150302T000000,319950,3,2.5,1700,7000,1700,0
2185000685,20141124T000000,208417,2,1,840,4200,840,0
7518502030,20141117T000000,410000,4,2,1900,5100,950,950
4078300024,20140725T000000,590000,4,2.75,2160,4205,1080,1080
6071400710,20150429T000000,648000,3,1.75,1610,10229,1610,0
4136950200,20140627T000000,255000,3,2.5,1720,6194,1720,0
9527300200,20140825T000000,465000,4,2.75,2190,3267,2190,0
6071000310,20150128T000000,622000,4,1.75,3020,10714,1510,1510
9183702220,20140915T000000,306000,3,1.75,1980,9800,1980,0
369000045,20141010T000000,617000,3,2.5,1880,5500,1880,0
2826049117,20140528T000000,438750,3,1.75,1610,6480,1610,0
811000055,20140925T000000,1.28E+06,4,3,3260,4500,2300,960
7154200070,20141124T000000,995000,5,3.25,3970,8029,2970,1000
2303900045,20140623T000000,1.58E+06,4,2.5,4570,74487,4570,0
1254200045,20150422T000000,635000,5,2.75,2620,5500,1710,910
8731730710,20140728T000000,215000,3,1,1180,9000,1180,0
9528104109,20141027T000000,530000,3,2.5,1365,1090,1315,50
3298700012,20150320T000000,295000,2,1,720,4125,720,0
7967700570,20150302T000000,245000,3,2.25,1350,6775,930,420
1402200140,20150105T000000,400000,6,2.5,3060,17112,1530,1530
3797300140,20140721T000000,303000,3,2.75,1850,8820,1850,0
2481200140,20141015T000000,330000,3,1.75,1320,9675,1320,0
3582900310,20150304T000000,700000,3,1.75,1990,13000,1990,0
1352300990,20140826T000000,126000,1,1,610,4400,610,0
1525059074,20140723T000000,850000,4,1,2500,35802,2500,0
3876000710,20141218T000000,405000,3,2,1440,7425,1440,0
1994200260,20140819T000000,869900,6,4.5,2750,4400,1770,980
1121000058,20150331T000000,485000,3,1.75,1790,6775,1790,0
1407300012,20150128T000000,400000,2,2,1050,1173,720,330
1565930070,20140911T000000,299950,3,2.5,1780,4650,1780,0
3574900030,20150327T000000,585000,4,2.5,2200,9099,2200,0
5100401441,20150506T000000,495000,4,2,1720,5413,1470,250
3629940160,20150311T000000,2.20E+06,5,4.5,5840,17168,4570,1270
7715800390,20141110T000000,447000,3,2.25,1520,14080,1520,0
1682000160,20150417T000000,206000,3,1,1320,9239,1320,0
952007055,20141021T000000,500000,3,1,1070,4600,950,120
3790700070,20141121T000000,302500,4,2.5,1990,5511,1990,0
3134100023,20141125T000000,1.25E+06,4,4.25,4980,13000,3080,1900
1862400292,20140723T000000,391000,2,1,890,5423,890,0
4123800270,20140710T000000,250000,3,2,1440,5457,1440,0
3448700070,20140723T000000,435000,4,2.5,2440,5350,2440,0
9133600135,20150211T000000,160000,4,2.25,1800,14722,1440,360
6163901913,20140722T000000,451000,5,3,2260,6508,1330,930
1446403305,20140505T000000,206000,2,1,810,7158,810,0
59000445,20140923T000000,590000,4,2.75,2240,5400,1540,700
7510700030,20140515T000000,695000,3,2.5,4560,17622,3800,760
1722059222,20141120T000000,350000,3,1.5,1550,40752,1550,0
8127700132,20150326T000000,1.24E+06,5,3.5,3180,4628,2420,760
1774000030,20150330T000000,395000,6,2.25,2950,11200,1700,1250
4058800135,20150405T000000,419000,5,3,2190,9652,2190,0
8682281600,20140708T000000,592350,2,2,1570,4665,1570,0
8562740520,20140806T000000,855000,5,3.25,3420,5669,2620,800
3982700125,20141230T000000,771000,4,2.5,2420,7200,2420,0
1120069036,20141218T000000,325000,3,2.25,1570,43350,1570,0
3592500800,20141018T000000,1.85E+06,5,3.25,3680,6060,2630,1050
7905200310,20140729T000000,545000,4,1.75,1910,6731,1210,700
7577700136,20150226T000000,615000,3,1.75,1780,5175,990,790
2629600016,20150410T000000,625500,2,1,2160,7439,1300,860
9262800002,20140708T000000,232000,3,1.5,1460,15000,1460,0
2892700041,20140714T000000,168000,3,1.5,1370,7439,1370,0
2892700041,20150128T000000,238000,3,1.5,1370,7439,1370,0
4136950070,20150414T000000,260000,3,2.5,1500,7401,1500,0
2354300550,20150302T000000,460000,3,1.75,1210,7500,1210,0
7740100260,20140825T000000,900000,3,2.5,2850,11535,1680,1170
6163901352,20141021T000000,289950,3,1,1090,8280,1090,0
2025700200,20150220T000000,265000,3,1.75,1450,5858,1450,0
1775801090,20140530T000000,465000,4,2.25,1820,20349,1340,480
1138000070,20141113T000000,370000,3,1.5,1320,7201,1320,0
1823049046,20140806T000000,240000,2,1.5,1670,9880,1670,0
7227801580,20140917T000000,232000,4,2,1440,5911,1440,0
4364700875,20140729T000000,237502,3,1,980,7560,980,0
8127700390,20141215T000000,1.28E+06,4,3.5,4340,5500,2850,1490
9560500105,20150424T000000,957000,4,2.25,2860,11545,1430,1430
8651411420,20150305T000000,218000,3,1.5,1140,4875,1140,0
1274500240,20140820T000000,205000,3,1.5,1120,8366,1120,0
3278602190,20140611T000000,350000,3,3.25,1460,1592,1130,330
873900240,20140702T000000,256000,4,2.5,2050,5787,2050,0
3834000520,20140730T000000,275000,3,1,1250,7654,1000,250
4224100030,20150403T000000,372000,4,2.5,2520,9604,2520,0
5710500060,20150319T000000,688888,3,3.25,2580,9825,1760,820
203101370,20140630T000000,170000,2,1,1200,24792,1200,0
4039300140,20140625T000000,530000,5,2.25,2140,7910,1070,1070
3629920990,20140623T000000,905000,4,3.25,3440,7661,3440,0
6882510060,20140825T000000,365000,4,2.5,1800,5070,1080,720
2597150270,20150406T000000,312000,4,2.5,1790,10584,1290,500
4365200445,20140822T000000,400000,2,1.75,1250,7680,1250,0
6145601819,20140912T000000,278750,2,2,800,5765,800,0
3447000030,20150401T000000,510000,3,2,1410,11995,1410,0
4442800162,20150414T000000,527700,2,2.25,1330,806,1330,0
1698900075,20150415T000000,740000,4,2.75,2890,4000,2190,700
9432750070,20140808T000000,512000,4,2.5,2550,17209,2550,0
3204850140,20141112T000000,362000,5,2.5,2880,8216,2880,0
1446401550,20150206T000000,225000,3,1,660,6600,660,0
3904901840,20140630T000000,491500,3,2.25,1470,4322,1470,0
3299200075,20150204T000000,429950,4,1.75,1700,10230,1320,380
2206500550,20141117T000000,375000,3,1,1040,9800,1040,0
2112700370,20140813T000000,199400,2,1,880,4000,880,0
4397010350,20150126T000000,364900,4,2.5,2490,9346,2490,0
4364700885,20140912T000000,324950,3,1.5,1210,7560,1210,0
1498301672,20150330T000000,467000,5,2,2080,4000,1040,1040
3992700326,20140822T000000,380000,3,1,1380,5400,1380,0
5438000060,20141103T000000,250000,3,2.25,1620,10850,1620,0
9550200370,20140520T000000,700000,4,1,1680,4021,1680,0
3977630270,20141113T000000,206990,3,1,1330,9620,1330,0
475001000,20150406T000000,670000,3,1.75,1730,3400,970,760
3426059050,20140520T000000,315000,2,1,790,6969,790,0
4137000070,20150410T000000,319950,3,2.5,2240,7500,2240,0
2759500105,20140730T000000,419000,3,1.5,1500,8272,1500,0
4137010310,20140822T000000,205000,3,2,1800,11419,1800,0
5616000030,20141023T000000,335000,4,2.5,1980,4745,1980,0
9266700295,20141024T000000,397000,3,1.75,1340,5100,1340,0
9828200187,20150429T000000,370000,2,1,750,2020,750,0
6061400160,20140918T000000,330000,4,2.25,1790,9920,1170,620
4139420640,20141030T000000,1.79E+06,4,3.5,5490,14300,2910,2580
4022900197,20140808T000000,399000,3,2,1940,16300,1140,800
3221069035,20140620T000000,400000,4,1.75,2670,189486,2670,0
2591730200,20140717T000000,249900,3,2,1220,6404,1220,0
9165100260,20140513T000000,717000,3,1.5,1310,3880,1090,220
5201810060,20140807T000000,319000,4,2.5,1930,8336,1930,0
5499200060,20150403T000000,635000,4,3,2100,3800,2100,0
1568100060,20140910T000000,355000,3,1,1180,7573,1180,0
4139910160,20150401T000000,1.60E+06,5,3.25,4320,32840,4320,0
6743700060,20140714T000000,585000,4,1.75,3140,12519,2320,820
7258200060,20141229T000000,320000,3,2,2320,7800,1160,1160
5127000810,20140514T000000,305495,3,1.75,2110,10200,2110,0
2011400520,20140619T000000,240000,4,2,1790,14690,1670,120
1953400510,20140623T000000,199950,5,2.5,1740,8750,1740,0
2450500060,20140826T000000,1.62E+06,4,3.25,3820,8114,3820,0
2623039082,20150218T000000,770000,3,3.5,2050,21744,1750,300
3204400030,20140702T000000,255000,4,2.25,1680,3179,1680,0
2473370890,20140915T000000,289000,4,2.25,1930,8925,1930,0
3343901401,20140718T000000,494500,4,3,3760,8804,2470,1290
4376700030,20140604T000000,746000,3,2.25,2370,9619,1650,720
1072000400,20141023T000000,385000,4,3,2120,13000,2120,0
2193330030,20141118T000000,688100,4,2.5,2370,10513,2370,0
4083300070,20140512T000000,870300,4,2.5,2350,3150,1690,660
2241700075,20141022T000000,310000,3,1,1180,8474,1180,0
9250900111,20150312T000000,500000,3,2.5,2270,5654,2270,0
9412700160,20140814T000000,255000,3,2.25,1830,7770,1400,430
1118001360,20150218T000000,1.48E+06,3,2.75,3910,7080,1970,1940
4383500030,20140924T000000,154500,3,1,890,9465,890,0
2558630060,20140530T000000,425000,3,2.25,1820,8058,1260,560
1150000400,20140721T000000,700000,4,2.5,2440,7491,2440,0
5244801275,20141121T000000,410500,2,1,1110,3943,740,370
1839920160,20140714T000000,432000,3,2,1870,7080,1210,660
9834200030,20150414T000000,530000,3,1.5,1240,4080,1240,0
3288200710,20140527T000000,465000,3,2,1560,8640,1560,0
3904980320,20140923T000000,498688,3,2.5,1910,5600,1910,0
2927600435,20150402T000000,573500,3,1,2200,21450,1600,600
1321740260,20141015T000000,349900,4,2.75,2530,13474,2530,0
7809200055,20140618T000000,220000,3,1,1130,12519,1130,0
3298700671,20140731T000000,260000,2,1,820,6771,820,0
1231000640,20140911T000000,290000,2,1,960,4000,960,0
1498303905,20150402T000000,615000,4,1.5,1980,3240,1780,200
7491010060,20141022T000000,730000,4,3.5,3370,5638,2250,1120
8835800350,20150112T000000,1.95E+06,4,3.25,7420,167869,7420,0
8856960260,20140521T000000,332500,3,2.25,1800,10500,1800,0
1088810160,20141224T000000,650000,5,3.5,3990,10120,2820,1170
3931900510,20140829T000000,1.40E+06,4,2.5,4070,7800,3390,680
9567800435,20150513T000000,465000,4,1.75,1640,7194,1480,160
2806000560,20140722T000000,690000,4,3.25,3730,11820,2460,1270
2473101360,20140711T000000,289900,3,1.75,1220,7004,1220,0
2288900140,20141218T000000,1.62E+06,3,3.5,3490,4000,2570,920
9320990140,20150422T000000,339950,3,2.5,1730,4286,1730,0
8731982050,20150423T000000,367999,4,2.75,3430,8000,3430,0
705700240,20150218T000000,380000,4,2.5,2320,10079,2320,0
4335000030,20140625T000000,440000,3,1.75,2030,17100,2030,0
2806300070,20140521T000000,975000,5,4,4850,36450,4850,0
5631501323,20140805T000000,309500,3,1.5,1340,13560,1340,0
3738900105,20140723T000000,350000,3,1,1130,8201,1130,0
2781270400,20150316T000000,215000,2,2,1180,2521,1180,0
3336001360,20140826T000000,254000,2,1,910,6000,910,0
2464400435,20150420T000000,567000,3,1.75,1630,4275,1630,0
2025049114,20140529T000000,402000,2,1,710,1173,710,0
1523089012,20141120T000000,365000,4,1,1520,80150,1520,0
7305300695,20140502T000000,625000,4,2.5,2820,8408,2820,0
9269200340,20150423T000000,432000,4,1.75,1970,5160,1970,0
1402100070,20140801T000000,335500,5,3,2240,19090,1700,540
2998300060,20140806T000000,672500,2,1.75,1860,5940,1020,840
8113101000,20140722T000000,336000,4,1,1780,4310,1780,0
1388600070,20141124T000000,294400,4,2.5,1788,10183,1788,0
8944600060,20150420T000000,541900,3,2.5,1880,3054,1880,0
8860310240,20141217T000000,505000,3,1.75,2300,11400,1520,780
8016250060,20140605T000000,255000,3,2.5,1610,6176,1610,0
2061800045,20150122T000000,435000,6,2.5,2270,11970,1470,800
2652500070,20140508T000000,636000,2,1.75,1230,3600,1230,0
3622069114,20140909T000000,655000,4,3.5,3420,33106,3420,0
4438000075,20150318T000000,280500,3,1.5,1670,6988,1370,300
2776600002,20150422T000000,520000,2,1,1120,6141,900,220
241900060,20140626T000000,354000,4,2.5,2580,5476,2580,0
5151800045,20140822T000000,810000,5,2.75,3847,17654,2299,1548
3221059036,20140502T000000,400000,4,2.5,3630,42884,2300,1330
7504020960,20150107T000000,879900,4,2.75,3580,12000,1840,1740
1924059319,20150320T000000,1.29E+06,5,4,4050,11358,2780,1270
4067600160,20150402T000000,902500,3,3.5,3240,23522,2130,1110
9828700685,20150513T000000,900000,3,1.75,1540,8400,1540,0
4307330070,20140717T000000,419500,4,2.5,2550,7200,2550,0
6822100310,20141103T000000,685000,4,2,2340,6000,1270,1070
3295900520,20141107T000000,429950,4,2.5,2320,4524,2320,0
1773100310,20150423T000000,464950,4,2.5,1640,6000,1640,0
9407000990,20141010T000000,239900,2,1,910,9000,910,0
1472800160,20150218T000000,406250,4,3.25,2550,11524,2550,0
7787110370,20141027T000000,447000,4,2.5,2660,8027,2660,0
3041700570,20140605T000000,466800,3,2.5,1480,14250,1480,0
3999200310,20140917T000000,674000,4,2.5,2810,11560,1740,1070
1931300955,20141126T000000,525000,1,1,830,3200,830,0
2591720160,20150501T000000,674950,3,2.75,3510,92347,3510,0
8691510310,20150429T000000,374900,3,2.5,2480,4950,2480,0
9831200520,20141006T000000,1.44E+06,4,3,3720,5000,2720,1000
8123710070,20141205T000000,559500,3,2.25,2150,9250,2150,0
7852170370,20140516T000000,522500,3,2.5,2370,7875,2370,0
3528000310,20150427T000000,1.13E+06,5,2.5,4310,28008,4310,0
6403500570,20140612T000000,498500,5,2.75,2990,7420,2990,0
6021501420,20140825T000000,571000,4,1,1350,4000,1350,0
723069128,20140514T000000,543000,2,2,2370,217800,1600,770
3329530030,20150304T000000,271920,3,2,1410,10248,1410,0
723049326,20141208T000000,104950,2,1,1170,8254,1170,0
7215721070,20140929T000000,485500,4,2.5,1800,4500,1800,0
3179101580,20140528T000000,1.21E+06,4,2.75,3650,6982,2530,1120
2025700270,20150122T000000,260250,3,1.75,1490,8357,1490,0
8691300260,20150413T000000,875909,4,2.5,3610,13292,3610,0
5112800060,20140606T000000,455000,4,1.75,2050,94525,1250,800
2112700240,20140520T000000,309000,3,1,1092,7500,1092,0
8732190990,20140709T000000,229000,4,2.25,2010,7688,1170,840
537000416,20150429T000000,250000,3,2,1680,7900,1680,0
3761700251,20140528T000000,600000,4,2,2510,38141,2510,0
625100181,20140508T000000,535000,4,2.5,2280,65836,2280,0
7202261260,20141117T000000,571000,3,2.5,2510,5186,2510,0
7856410030,20140505T000000,1.03E+06,5,2.75,3190,16920,1690,1500
8128600060,20140624T000000,600000,4,3.25,4690,14930,3680,1010
1775800860,20150428T000000,469500,3,2.25,1850,12000,1300,550
3303980140,20150402T000000,1.15E+06,4,3,4160,13170,3040,1120
4206901200,20140825T000000,785000,4,1.5,2220,4000,1970,250
11500240,20150428T000000,872750,3,2.5,2870,13695,2870,0
6383500295,20140815T000000,900000,4,2.75,3950,10214,2050,1900
7849202220,20140717T000000,350000,2,1.75,1740,6620,1740,0
2260300060,20150410T000000,2.58E+06,5,3,4780,20440,3660,1120
7701950060,20140729T000000,940000,4,2.5,3160,39960,3160,0
5153200486,20140715T000000,185000,5,1.75,1990,27810,1990,0
205000310,20140624T000000,850000,4,3.5,3920,37122,3920,0
920069053,20140917T000000,201000,3,1,960,15273,960,0
6141100445,20150107T000000,499000,2,1.5,1540,6549,1540,0
8809200070,20150408T000000,315000,4,2.5,1970,5190,1970,0
3905080310,20140806T000000,509950,3,2.5,1880,4668,1880,0
393000311,20150225T000000,286300,3,2.75,2000,6405,1260,740
3127200036,20140728T000000,590000,3,2.5,1990,8325,1310,680
123039128,20140904T000000,325000,4,1,1400,9384,1400,0
2896310160,20140822T000000,625000,4,2.5,3190,27806,3190,0
5272200045,20141113T000000,378000,3,1.5,1000,6914,1000,0
9211500520,20140618T000000,239950,3,1.75,1670,6900,1170,500
3589500260,20141111T000000,550000,4,2,2100,4500,1060,1040
3330500335,20150422T000000,325000,2,1,1010,6180,1010,0
9445300045,20140609T000000,831000,4,2.5,2030,3905,1630,400
114100354,20141212T000000,249000,3,1,1090,10296,1090,0
1775920340,20150126T000000,484000,4,1.75,2440,16730,1390,1050
8946700140,20141121T000000,395000,4,3,2500,6278,2500,0
8651610240,20141119T000000,839900,4,2.5,3420,7462,3420,0
1237500105,20141113T000000,760000,4,2.5,2850,11000,2850,0
9151600106,20150512T000000,750000,4,1.5,2030,3300,1530,500
1118000340,20150408T000000,3.00E+06,5,3.75,4590,11265,3450,1140
7853230570,20140915T000000,440000,3,2.5,2230,5800,2230,0
4353700200,20141203T000000,501000,2,1.75,1810,7523,1170,640
7228501805,20140924T000000,739000,6,4.5,4000,7500,4000,0
9541800075,20140908T000000,685650,3,1.75,1490,16200,1490,0
3425069083,20140625T000000,1.01E+06,4,4.5,4225,284011,4225,0
7613700270,20140916T000000,980000,4,1.75,2120,4000,1920,200
6882200140,20140930T000000,275000,3,1.5,1030,7184,1030,0
2473380400,20140519T000000,319950,4,1.75,2310,8045,1650,660
3579000370,20150320T000000,448500,3,2.25,1830,7943,1830,0
2623029078,20140603T000000,437000,5,2,2120,137565,2120,0
3124049196,20141107T000000,330000,4,1.5,2500,9448,1250,1250
3374500240,20141217T000000,365000,3,2.5,2470,7700,2470,0
8911000445,20141112T000000,329000,2,1,940,7700,940,0
1066100260,20140620T000000,681500,5,2.75,3260,11700,1630,1630
7205850030,20140509T000000,566000,3,2.25,1660,10140,1370,290
1330910370,20141020T000000,897500,4,3,4370,217882,4370,0
11520370,20141229T000000,738000,3,2.5,2620,9112,2620,0
3327000070,20150420T000000,185000,3,1.75,1500,7800,1500,0
2594200350,20150304T000000,445000,2,1,910,7200,830,80
2724049185,20150325T000000,175000,3,1.75,1430,4920,1430,0
3123800125,20141121T000000,315000,2,1,900,8556,760,140
3298200320,20140624T000000,445000,4,1.75,1250,7400,1250,0
2068000270,20140805T000000,1.40E+06,5,3,3850,14990,2290,1560
7732500700,20141126T000000,832500,4,2.5,3450,35100,3450,0
7851990240,20140717T000000,771150,4,3.5,3950,12320,3950,0
3423049269,20140513T000000,225000,4,1.5,1950,12559,1950,0
7852150200,20140923T000000,389950,3,2.5,1700,6396,1700,0
7853230270,20140804T000000,435000,3,2.5,2370,6082,2370,0
1965200075,20150316T000000,845000,3,1.75,1600,2538,1600,0
1959700445,20140725T000000,1.30E+06,4,1.75,4060,5500,2660,1400
1250200765,20140714T000000,350000,3,2.25,1322,1796,1087,235
3275300270,20140708T000000,250000,3,1.75,1140,10400,1140,0
7548300751,20150430T000000,370000,2,1.5,1280,2096,1080,200
9526600260,20140729T000000,750000,4,2.5,3080,4553,3080,0
2880100240,20140825T000000,439950,2,1.75,1210,3000,910,300
5253300320,20141103T000000,395000,4,1.75,1950,10219,1950,0
2291400566,20140807T000000,375000,4,1,1450,6820,1450,0
103400160,20140515T000000,263000,3,2.25,1590,7748,1590,0
1951600240,20141208T000000,185000,3,1,1240,9198,1240,0
224069129,20150225T000000,500000,3,1,1440,54315,790,650
5608000860,20140926T000000,920000,4,2.5,3470,10045,3470,0
424069271,20141024T000000,936000,7,3.75,5100,21802,3640,1460
8964800390,20140508T000000,1.50E+06,3,1.75,2430,12757,1340,1090
7533800885,20141027T000000,1.10E+06,3,2.25,2420,7200,1420,1000
2312400200,20150102T000000,247000,3,2.5,1510,10875,1150,360
3226049267,20150425T000000,289500,3,1,1200,5525,1200,0
7852130640,20140602T000000,432500,3,2.5,2240,6396,2240,0
9530101535,20150327T000000,680000,3,1.75,1870,4320,970,900
6822100030,20140528T000000,589000,3,1,1110,6000,1110,0
1090000036,20141223T000000,756450,4,2,3210,8400,2040,1170
6619910260,20150407T000000,536650,3,1.75,2090,8910,1230,860
342000036,20140702T000000,540000,3,2.25,1320,1800,1320,0
3448002267,20150428T000000,385000,3,1.75,1340,3850,1340,0
7974200765,20140902T000000,485000,3,1,1020,6120,1020,0
7230400400,20140926T000000,240000,3,2,1220,17652,1220,0
7230400400,20150326T000000,415500,3,2,1220,17652,1220,0
2028700575,20141113T000000,550000,3,2,1390,2688,1390,0
4232400400,20140929T000000,1.26E+06,4,2,2970,5400,2970,0
792500260,20140715T000000,430000,2,2,1440,213008,1440,0
2493200370,20141112T000000,415000,2,1.75,1550,4257,830,720
844001052,20150128T000000,365000,4,2.5,1904,8200,1904,0
7696610240,20141210T000000,257000,4,1.5,1400,8500,1400,0
3630110370,20140624T000000,420000,3,2.5,2140,3821,2140,0
1217000270,20140916T000000,338995,3,1.75,1320,9450,1320,0
9441300030,20150410T000000,615000,3,1.75,2620,8280,1330,1290
2991000160,20141212T000000,312500,4,0.5,2300,5570,2300,0
6641020160,20140506T000000,513000,4,2.5,2000,5684,2000,0
2998300075,20150127T000000,857500,4,2.75,2960,5040,2210,750
5456000570,20141230T000000,1.06E+06,3,2.75,2700,22343,2700,0
7784400070,20140722T000000,585000,3,1.75,1740,9500,1150,590
2781250400,20141008T000000,350500,2,2.5,1770,4950,1770,0
3821400200,20141006T000000,215000,3,2,1290,9312,1290,0
3580900200,20140617T000000,440000,4,2,1450,8400,1450,0
5466750140,20150427T000000,270000,3,2.25,1420,7800,1130,290
8122100160,20141023T000000,385000,3,0.75,1330,7020,1330,0
9523102447,20141117T000000,688500,3,1.75,1760,4125,1760,0
7234601525,20140519T000000,700000,3,1.75,2010,4905,1230,780
6071300160,20140822T000000,585000,5,2,2560,14467,1280,1280
8044200200,20150226T000000,401000,2,1.5,1260,2625,1260,0
8563050350,20150306T000000,655000,4,2.25,2420,7725,1890,530
1282300105,20140604T000000,317000,3,1,1010,5400,1010,0
3374300030,20150505T000000,500000,4,2.5,1770,8155,1770,0
9232900075,20141021T000000,314963,2,1,890,6350,890,0
952000640,20141027T000000,715000,3,1.5,1670,5060,1670,0
7334600030,20141014T000000,280000,3,2.25,1360,9600,1360,0
200500700,20140612T000000,531000,3,2.5,2120,9736,2120,0
11200400,20140923T000000,617000,3,2.5,1910,4488,1910,0
1139000135,20141009T000000,440000,4,1,1480,7560,1480,0
7468900270,20140729T000000,140000,3,1,1090,10114,1090,0
1036400200,20150213T000000,661000,4,1.75,1670,13125,1670,0
1036400200,20150429T000000,697000,4,1.75,1670,13125,1670,0
3622900200,20140627T000000,1.20E+06,5,2.75,3650,13297,2750,900
6884800262,20140920T000000,535000,4,2,1970,3515,1030,940
7950302255,20150324T000000,404500,2,2,1320,3060,1320,0
3524039196,20141112T000000,396500,3,1,1710,5110,1100,610
2064800830,20150320T000000,450000,3,2.25,1740,9488,1180,560
1861400116,20150116T000000,605000,3,3.25,2200,2400,1740,460
7129302685,20140911T000000,699000,3,2,2010,4320,2010,0
4046600070,20140619T000000,805000,3,3,3910,19023,3910,0
8655900162,20150219T000000,156000,1,0.75,470,15000,470,0
2193310320,20150306T000000,595000,4,2.5,2330,7064,1780,550
5417600200,20140728T000000,285000,3,1.75,1930,7200,1930,0
4178900070,20150325T000000,725000,4,2.5,3270,6055,3270,0
2115720070,20141125T000000,216300,3,2.5,1650,5000,1650,0
3211100990,20141020T000000,410000,4,2.75,2220,8450,1260,960
5288200260,20140903T000000,597000,2,1.75,2470,4600,1140,1330
1771110070,20150218T000000,325000,3,1,1300,9300,1300,0
274000070,20150401T000000,355000,5,2.75,2530,9375,1530,1000
2816900030,20141218T000000,338000,3,1.5,2400,8215,1200,1200
304100070,20141118T000000,210000,4,2.25,1500,5393,1500,0
3876200350,20140814T000000,423000,4,1.75,1700,9000,1700,0
7806210070,20150211T000000,249500,4,1.5,2120,8554,1170,950
5437600140,20150110T000000,325000,4,2.5,2240,5105,2240,0
1796360370,20150325T000000,257000,3,1.75,1540,8223,1070,470
1428001160,20150420T000000,550000,3,1.75,1890,100623,1890,0
1233100260,20141114T000000,490000,3,1,1260,9638,1260,0
8835220200,20150202T000000,299000,2,1.5,1160,3838,1160,0
2023039045,20141103T000000,295000,2,1,1300,39639,1300,0
7504400400,20141029T000000,630000,4,2.5,3220,14463,3220,0
1432900310,20150424T000000,320000,4,1.5,2020,8474,1010,1010
9541600295,20150424T000000,1.11E+06,4,2.5,2990,8640,2100,890
2914700310,20140922T000000,398000,4,1,1420,6458,1420,0
7972604355,20140521T000000,218000,3,1,1020,7874,1020,0
2423069084,20150303T000000,590000,4,2.75,2400,104108,2400,0
8655000070,20140601T000000,1.60E+06,5,3,3640,8239,2540,1100
8165501620,20141218T000000,348500,2,2.25,1550,1824,1550,0
8682281480,20140725T000000,592500,2,2,1870,4751,1870,0
1137610140,20140610T000000,505000,3,2.5,2340,5957,2340,0
4232900310,20141029T000000,1.43E+06,5,4.25,3350,3600,2260,1090
324000370,20140721T000000,502000,3,1,1710,5000,1140,570
3822200036,20140624T000000,257500,2,2,1180,9265,1180,0
3876100310,20140711T000000,405000,3,1.5,1600,7500,1600,0
8024201525,20150317T000000,427000,3,1.75,1300,5111,1300,0
4024101670,20141204T000000,290000,3,1.5,1040,9997,1040,0
3124049171,20150324T000000,222000,3,1,1220,7695,1220,0
2310100240,20141218T000000,315000,3,2.5,2240,6097,2240,0
8021700030,20140604T000000,371000,3,1.5,1420,4500,1420,0
3861500340,20140626T000000,279900,3,1.75,1580,6620,1580,0
1823069046,20150420T000000,250000,3,1.5,2390,23522,1890,500
6070500055,20140506T000000,599000,4,2.25,2260,29930,1400,860
520069032,20140716T000000,267300,3,1.75,1890,93218,1890,0
4154303655,20141211T000000,585000,2,1.75,1830,7200,1070,760
3876800710,20150414T000000,350000,3,1.75,1000,8268,1000,0
259000240,20140617T000000,506000,3,1.75,2180,7700,1480,700
1822069041,20141113T000000,400000,6,2,2320,210830,2320,0
7520000695,20141104T000000,151100,3,1,840,4495,840,0
7520000695,20150421T000000,251000,3,1,840,4495,840,0
2141330700,20140522T000000,555000,4,2.25,2350,8140,1430,920
3123039082,20141006T000000,467500,3,1.75,2040,273556,2040,0
7215420370,20150407T000000,479000,4,2.5,2370,30378,2370,0
1311000270,20150416T000000,247000,5,2,1590,9350,1060,530
7334500800,20150123T000000,299500,3,1,1380,10875,1380,0
2832100270,20150507T000000,306888,4,1.5,1940,8970,1270,670
3022079094,20141006T000000,675000,4,2.5,3320,244807,3320,0
2436200320,20150421T000000,577000,2,1,1090,5265,1090,0
1042500013,20140520T000000,219950,3,1.5,1650,9936,1090,560
3897100060,20140723T000000,375000,3,1.5,1110,5500,1110,0
3188100105,20141107T000000,650000,4,2.5,2110,6820,1530,580
2767604170,20150406T000000,975000,3,3,1850,5000,1850,0
1773100765,20150429T000000,229000,1,1,600,3720,600,0
1211000070,20140921T000000,575000,5,2.5,2760,4000,1730,1030
8920100041,20150428T000000,815000,4,1.75,2970,14880,1560,1410
126059225,20140806T000000,525000,3,1.75,2300,43560,1350,950
9286100320,20140606T000000,471000,3,2.5,2030,2805,1720,310
4449800681,20140623T000000,450000,4,1.75,2160,4333,1260,900
5505700030,20140528T000000,590000,3,2,1650,6150,1650,0
3260590070,20140801T000000,744000,4,2.5,3140,7260,2200,940
3211240370,20141201T000000,460000,4,2.25,2690,36114,2690,0
8142000060,20150313T000000,299000,5,2.5,1940,9389,1290,650
5595900316,20150129T000000,231000,4,1,1220,5120,1220,0
4312700200,20140820T000000,195000,3,1,1300,9600,1300,0
9407001600,20150423T000000,305000,3,1.75,1660,11500,1130,530
5700001895,20150302T000000,895000,4,1.5,3390,6200,2530,860
1424200070,20140507T000000,1.11E+06,4,1.5,2310,13300,1890,420
1708400370,20140626T000000,339000,2,1,950,7954,950,0
5457801925,20150411T000000,885000,4,3.75,2400,3520,1370,1030
2895600350,20141103T000000,375000,3,1,1780,5236,1050,730
4036801070,20140804T000000,367400,4,1.5,1280,7400,1280,0
976000879,20150424T000000,700000,4,2,1930,5398,1430,500
7923100400,20150130T000000,667000,5,2.25,2560,10360,1870,690
7129304200,20141222T000000,200000,2,1,920,5250,920,0
2225069062,20150415T000000,552775,3,2.5,1900,18414,1900,0
3343903240,20140722T000000,452000,3,2,2270,148975,1270,1000
5095401360,20141121T000000,418000,3,2.5,2080,16050,1360,720
2547200160,20150212T000000,601500,3,1.75,1460,10128,1460,0
124069032,20140505T000000,600000,3,1.75,1670,39639,1670,0
7300400320,20150424T000000,340000,4,2.5,2810,6481,2810,0
7212660560,20140826T000000,310000,3,2.5,2370,6752,2370,0
3343902650,20141217T000000,290000,2,1.75,1700,18000,1700,0
3034200036,20150424T000000,438000,2,1,1630,9255,1630,0
1498303855,20150224T000000,718000,4,2.75,2930,4408,1660,1270
1446404015,20140620T000000,200000,2,1,860,6600,860,0
5467910140,20140528T000000,479900,3,2,1980,12150,1980,0
2472920800,20150423T000000,400000,3,2.5,2080,7877,2080,0
7147600070,20150323T000000,219950,3,1,1060,10042,1060,0
3820350140,20140827T000000,300000,3,2.5,1590,3381,1590,0
520700125,20140805T000000,437000,3,2.25,1980,8775,1290,690
3211200140,20140710T000000,350000,4,2,1720,7210,860,860
250000320,20140929T000000,626000,4,1.75,1350,9293,1350,0
6139800640,20150224T000000,490000,3,2.5,2080,12032,2080,0
6699000710,20140520T000000,289000,3,2.5,2090,4700,2090,0
7010700550,20141114T000000,595000,3,2.5,2030,5100,2030,0
5506500070,20141211T000000,676000,3,2.25,2680,41804,2680,0
3293700521,20150414T000000,389000,3,1.75,1820,8028,1220,600
6929604005,20140915T000000,240000,3,2,1300,5000,1300,0
3216900070,20140617T000000,382500,4,2.5,2210,7079,2210,0
7922800160,20140509T000000,511555,3,2,1400,7293,1400,0
6610000320,20140910T000000,710500,3,1.75,2040,4125,1540,500
5561400140,20140521T000000,429000,3,2.5,2420,49928,1860,560
7686202065,20140723T000000,170000,4,1.75,1920,7500,1920,0
4107100204,20140821T000000,2.14E+06,4,3.25,3860,17820,2630,1230
7214810510,20150408T000000,480000,5,2.75,2760,7200,1430,1330
5350201180,20140720T000000,1.67E+06,4,3.75,3450,8395,2640,810
8148600055,20140513T000000,225000,3,1,1040,6535,1040,0
226039270,20141201T000000,615000,3,1.75,2220,7224,2040,180
1220069035,20141120T000000,438950,4,2.5,2470,385506,2470,0
7466900320,20150304T000000,242000,3,1.75,1300,9856,1300,0
8078430030,20140716T000000,560000,3,2.5,1960,9686,1460,500
9523100550,20141003T000000,857500,3,1.5,2040,3960,2040,0
8961970510,20140506T000000,685000,4,2.5,3030,7864,3030,0
3574800810,20150403T000000,486000,4,3,2260,7336,2260,0
7732410390,20140605T000000,749000,3,2.5,2670,10338,2670,0
7697870700,20141114T000000,260000,3,2.5,1520,6298,1520,0
9275702405,20150114T000000,1.02E+06,3,1.75,3610,8502,2610,1000
1370804461,20150310T000000,565000,3,1.75,1130,5111,930,200
4310702440,20141014T000000,355000,3,2,1480,2502,1480,0
3935900030,20140730T000000,775000,5,2,3540,9970,3540,0
6385800030,20150422T000000,335000,4,2.25,2100,7305,1050,1050
1193000390,20140620T000000,1.30E+06,5,4,3366,7800,2966,400
8605900060,20140603T000000,545000,3,1.75,1810,3000,1810,0
3964400160,20141118T000000,540000,3,1.75,1680,4240,1680,0
1455600045,20140915T000000,687500,3,1.75,2450,9377,1540,910
4031000520,20140708T000000,115000,1,2,1150,9812,1150,0
4031000520,20141125T000000,227000,1,2,1150,9812,1150,0
3299610240,20150429T000000,870000,4,2.5,3240,7621,3240,0
1727850350,20141112T000000,1.19E+06,4,2.5,3480,12164,3480,0
5416510990,20140910T000000,375000,4,2.5,2800,5000,2800,0
4154303215,20140828T000000,902000,3,2.75,3240,7200,1620,1620
421000465,20140617T000000,269500,2,1.5,1480,7276,940,540
9164100105,20150310T000000,570000,3,1,1700,4750,1200,500
6300000320,20140821T000000,359950,2,1,1240,7590,1040,200
824059324,20150325T000000,1.45E+06,4,3.5,3720,8301,2880,840
259900320,20140717T000000,615000,3,2.5,1910,3427,1910,0
7888200140,20140604T000000,250000,4,2,2120,8701,2120,0
7852130550,20140916T000000,530000,4,2.5,3020,6788,3020,0
2824089053,20150127T000000,474950,3,2,2250,222156,2250,0
3935900350,20150222T000000,490000,4,2,1650,6480,1650,0
5347200162,20140528T000000,210000,2,1.5,880,1157,880,0
1953400520,20141114T000000,265500,3,1,1860,9225,1860,0
1251200045,20140620T000000,1.46E+06,5,3.25,3840,4800,2750,1090
1858600012,20140605T000000,310000,4,2.25,2192,12128,2192,0
4307310400,20150409T000000,324500,3,2.5,1590,4108,1590,0
6708200320,20140929T000000,599000,4,4.75,3700,11000,1840,1860
1473060030,20140709T000000,525000,4,2.5,3670,9958,3670,0
6163901382,20140515T000000,400000,3,1,1630,10304,1630,0
617000030,20141223T000000,887500,3,3,4230,54977,3780,450
2887700875,20140723T000000,344000,2,1,1060,3325,770,290
9465910030,20140515T000000,525000,3,2.5,2700,7434,2700,0
6918710340,20140822T000000,385000,3,2.25,2110,8000,2110,0
629810560,20141217T000000,820000,4,2.5,3720,8633,3720,0
1025039320,20150427T000000,1.31E+06,4,3.5,3440,5000,2560,880
3575200030,20140729T000000,549000,4,2.25,2420,59800,1350,1070
3298701070,20150225T000000,180000,3,1,1090,6771,1090,0
7852011040,20140521T000000,589000,4,2.5,2910,5776,2910,0
1705400350,20150127T000000,350000,3,1,1050,5518,1050,0
7682200320,20150409T000000,197400,3,2,1610,7575,1110,500
3814701090,20140806T000000,267000,3,2.5,1760,6477,1760,0
8099800340,20141224T000000,480000,3,1.5,1540,20281,1540,0
5418200340,20141013T000000,650000,4,2.5,2580,9450,1660,920
2767601805,20150213T000000,600000,2,1,1370,5000,1370,0
8682280340,20150430T000000,490000,2,1.75,1440,6265,1440,0
1432900030,20141121T000000,225000,3,1,1410,7700,980,430
1546600125,20140703T000000,640000,3,2.25,1980,10115,1980,0
7560000070,20140610T000000,710000,3,3.5,2440,3427,1990,450
2130200160,20140609T000000,325000,3,2,1350,11805,1350,0
9238430140,20140725T000000,595000,3,3.25,3130,28001,2210,920
7116000350,20140718T000000,128750,3,1,880,7004,880,0
4039500390,20141017T000000,465000,3,2.25,1920,7300,1240,680
8031700186,20140726T000000,710000,4,1.75,2700,7625,1450,1250
7625702505,20150306T000000,605000,4,2.75,1670,6000,840,830
7511000140,20140808T000000,994000,4,2.5,3470,20445,3470,0
3191000030,20140619T000000,489950,3,2.25,1820,7326,1820,0
6150700394,20140506T000000,365000,3,1.5,1310,8160,1310,0
1786640030,20150202T000000,359950,3,2,1790,7212,1790,0
7708200400,20140929T000000,495000,4,2.5,2460,4774,2460,0
4406000390,20140521T000000,255000,3,1.5,1060,9039,1060,0
1926059094,20140812T000000,330000,3,1.75,1340,10276,1340,0
9413500350,20140707T000000,450000,3,1.75,1480,8394,1480,0
7853240310,20150318T000000,655000,4,2.5,3500,11306,3500,0
5152800030,20150421T000000,485000,4,2.75,2910,16362,2120,790
1775950030,20140812T000000,375000,4,1.75,1940,15909,970,970
4221250320,20141017T000000,570000,4,2.5,2280,4534,2280,0
6749700117,20150423T000000,350000,3,2.25,1190,1022,1190,0
290000075,20150225T000000,550000,3,1,1260,6000,1260,0
1842100160,20140731T000000,513000,5,2,2270,8652,1150,1120
4365200055,20141205T000000,450000,4,2.25,1990,7320,1030,960
3644100030,20150209T000000,432500,4,1.75,1500,1856,750,750
3220079017,20150213T000000,432000,5,2.75,2060,329903,2060,0
8121200710,20150123T000000,480000,3,2.25,1950,8892,1950,0
3574801740,20140728T000000,402200,3,1.75,1790,6980,1330,460
644000102,20150413T000000,650000,3,1,1520,10227,1520,0
5315100784,20150424T000000,1.20E+06,4,2.5,3240,13044,3240,0
9578200030,20140728T000000,312000,3,2,2440,13250,1440,1000
2313900810,20150402T000000,610000,4,2,2220,5821,1380,840
1623300055,20150323T000000,823000,5,1.75,2640,7722,1650,990
9191200435,20141113T000000,471000,4,1.75,1450,3750,950,500
2591020560,20140702T000000,481015,3,2.25,1550,5511,1550,0
1923000260,20141015T000000,1.96E+06,5,4.5,6200,23373,5050,1150
2193300390,20140923T000000,624000,4,3.25,2810,11250,1680,1130
7016200030,20150320T000000,480000,4,2.5,2080,7966,1200,880
727500030,20140715T000000,815000,3,1.5,1370,8671,1370,0
1651800030,20140829T000000,1.65E+06,4,2.25,2920,20400,2920,0
623049094,20140516T000000,180000,3,1,1000,18513,1000,0
2538800030,20150217T000000,156601,2,1.75,1210,9750,1210,0
7714000310,20140719T000000,374950,4,2.5,2790,4650,2790,0
254000075,20140519T000000,368000,2,1.5,1660,4680,830,830
1257201375,20141202T000000,550000,3,2,1650,3952,1650,0
8856004582,20140717T000000,198000,3,1.75,1300,6318,1300,0
3205400240,20140513T000000,345000,3,1.75,1090,7200,1090,0
3738000070,20150309T000000,1.71E+06,5,2.5,2660,6572,1960,700
8856001090,20150130T000000,185900,3,1,940,10890,940,0
3224500240,20140617T000000,950000,3,2.75,2750,18029,1810,940
4139460390,20140620T000000,995000,4,4.5,3850,13551,3000,850
3531900060,20140802T000000,345000,2,1,860,8250,860,0
4457300135,20141105T000000,741000,4,2.75,2070,10125,1390,680
8682292090,20140709T000000,737000,2,2.25,2290,9772,2290,0
7278700069,20140521T000000,668750,4,2.5,2340,6420,1590,750
5710610800,20140702T000000,575000,3,1.75,2680,8625,1590,1090
8651443420,20141017T000000,280000,4,2,1710,5440,1030,680
7751800070,20140804T000000,583000,3,1.5,1800,10050,1800,0
2570600140,20150128T000000,196000,3,2.25,1510,9600,1090,420
1565950260,20140515T000000,349950,3,2.5,1700,7496,1700,0
7550801170,20141211T000000,429000,4,1,1350,3333,1350,0
6648701740,20150220T000000,270000,5,2.5,2140,10320,1330,810
7529500030,20140909T000000,385000,6,4,2700,7416,1350,1350
9523102420,20140922T000000,535000,1,1,920,5000,920,0
7283900521,20150420T000000,352500,3,1.75,1500,10269,1030,470
7519001275,20150301T000000,624000,3,1.75,1510,5200,860,650
1432900350,20141217T000000,215000,5,1.5,1980,7958,1980,0
1924059248,20140602T000000,870000,4,3,4500,21780,3040,1460
6649500060,20140729T000000,440000,4,2.5,3220,8256,2610,610
2254501342,20150505T000000,518000,2,1.5,1140,1149,940,200
2025700260,20150325T000000,259500,3,2.25,1490,7589,1490,0
2386000070,20141029T000000,795127,4,3.25,4360,91158,3360,1000
2206500105,20140818T000000,290000,3,1,960,9000,960,0
1953400045,20150423T000000,385000,4,3,2253,7700,2253,0
3996900575,20141007T000000,259950,2,1,770,6542,770,0
869700350,20150429T000000,330000,2,2.5,1310,2915,1310,0
7387500335,20141219T000000,280000,3,1,980,7480,830,150
6795100563,20140701T000000,595000,4,2.5,1820,20011,1820,0
8001470560,20141117T000000,925900,4,3.75,3980,7828,3980,0
4140100200,20140808T000000,499000,3,2.25,3010,9600,2410,600
7212650510,20150403T000000,325000,4,2.5,1830,7762,1830,0
686800070,20140610T000000,895000,5,2.5,2550,20875,1610,940
5126900200,20150429T000000,162248,2,1,800,8960,800,0
6329000070,20141015T000000,1.07E+06,3,2.25,2890,21480,1790,1100
5430300171,20140703T000000,430000,3,1.5,1810,5080,1030,780
5430300171,20150129T000000,615500,3,1.5,1810,5080,1030,780
2742100016,20150416T000000,260000,3,1,940,5650,940,0
1324079082,20141117T000000,295000,4,2,1810,42981,1810,0
1422200496,20140924T000000,1.19E+06,3,1.75,2550,6117,1650,900
3754500566,20141120T000000,749950,4,2.5,2370,2971,2080,290
5132000140,20140618T000000,175000,6,1,1370,5080,1120,250
5132000140,20150120T000000,415000,6,1,1370,5080,1120,250
6131600240,20141119T000000,190000,3,1,1200,8316,1200,0
2768000295,20150417T000000,625000,3,1.75,2100,3264,1350,750
4046600320,20140826T000000,420000,3,2.25,2020,21010,2020,0
1598600320,20150416T000000,339900,4,1.5,1570,9210,1400,170
4140900270,20150427T000000,160000,2,1,1140,23030,1140,0
5104510060,20141215T000000,353000,4,2.5,1830,5331,1830,0
3578400710,20150206T000000,390000,3,2,1010,14183,1010,0
4036400030,20150305T000000,675000,4,2.5,1770,9858,1770,0
6084200060,20150313T000000,400000,3,2.5,2120,3757,2120,0
1251200055,20140626T000000,1.34E+06,4,3.5,3190,5040,2160,1030
8964800860,20150209T000000,1.65E+06,4,2.5,2780,11904,1730,1050
9551200270,20140825T000000,1.00E+06,5,3,3350,9450,2180,1170
3226059128,20140618T000000,850000,5,3.5,3450,28324,2350,1100
3438500798,20140715T000000,275000,3,1.5,1060,6954,1060,0
9286100200,20140813T000000,450000,3,2.5,1670,2589,1670,0
5151600390,20141113T000000,305000,4,1.75,2251,12731,1390,861
4172100240,20140902T000000,643002,3,2.5,1770,3744,1270,500
5422560830,20150413T000000,468000,2,1.75,1510,4500,1510,0
5104520640,20150220T000000,324950,4,2.5,1770,5000,1770,0
8078550320,20150326T000000,290000,3,2,1260,7346,1260,0
8099600160,20150429T000000,488500,3,2,1710,10959,1030,680
7287700059,20140813T000000,367950,3,1.75,2290,8234,1250,1040
8862000075,20150220T000000,285000,2,1,790,6555,790,0
8887001625,20150410T000000,417000,3,2.75,1820,52889,1820,0
9464700340,20140708T000000,1.12E+06,4,2.5,3180,31931,2390,790
5451300117,20150422T000000,1.55E+06,4,4,5280,17677,3220,2060
587550340,20140502T000000,604000,3,2.5,3240,33151,3240,0
2591820070,20150428T000000,380000,3,2.5,2390,8102,2390,0
6679000960,20141116T000000,336500,4,2.5,2500,5264,2500,0
9138100350,20150218T000000,685000,4,2,2290,6000,2290,0
6065300370,20150506T000000,4.21E+06,5,6,7440,21540,5550,1890
5315100393,20141211T000000,670000,3,1,1600,16868,990,610
5244800695,20140616T000000,524000,2,1,1120,2000,1120,0
3584000400,20141211T000000,172000,3,1,1340,10260,1340,0
6746701090,20140619T000000,680000,6,2,1670,3000,900,770
2421059017,20140523T000000,549900,4,3,2830,213879,2830,0
4053200926,20141205T000000,357000,4,2.75,2700,49428,2700,0
7899800045,20140828T000000,107000,3,1.5,910,5120,910,0
7899800045,20141202T000000,232900,3,1.5,910,5120,910,0
9482700075,20150112T000000,800000,4,3.5,2370,3302,1610,760
6300000368,20150327T000000,248500,2,1.5,880,1498,880,0
5135000160,20140612T000000,670000,3,2.5,2050,6420,1730,320
1022069050,20150227T000000,207000,3,1.75,1180,21275,1180,0
2599000370,20141103T000000,164000,3,1,1070,8250,1070,0
2652500126,20150217T000000,570500,2,1,1380,1800,1080,300
2923500550,20140625T000000,599990,3,2.25,2680,9162,1570,1110
3760100200,20141006T000000,395000,5,1.75,2100,9599,1060,1040
1226069045,20140827T000000,979500,4,3.75,4133,361548,4133,0
3935900232,20140929T000000,207000,3,1,920,5546,920,0
3935900232,20150112T000000,237000,3,1,920,5546,920,0
224069105,20150410T000000,650100,2,1,1750,60872,1180,570
8087800400,20141201T000000,385000,4,2.5,1950,7350,1150,800
723049301,20140813T000000,335000,2,1.75,1660,11437,1660,0
4136920030,20140524T000000,347000,4,1.5,2670,10026,2670,0
7686203385,20150326T000000,204000,3,1,980,8000,980,0
7922710520,20150507T000000,615000,4,2.25,1780,10260,1780,0
824059293,20141028T000000,943500,3,2.25,2370,10890,2370,0
3959400335,20150423T000000,560000,3,2,1640,7333,1020,620
6072760390,20150407T000000,547500,4,2.5,2610,7254,1610,1000
2787700030,20141010T000000,359500,4,1.75,2030,7210,1450,580
6446200060,20150401T000000,660000,3,2.5,2590,35640,2590,0
1545800710,20140523T000000,258000,3,1.75,1620,7540,1310,310
3522059196,20140627T000000,355000,3,1.75,2040,22693,2040,0
4365200186,20140606T000000,253500,2,1,810,4800,810,0
2064800890,20150415T000000,422500,3,1,1270,8920,1270,0
9268710390,20141113T000000,239000,2,2,1470,2052,1470,0
2273600260,20150403T000000,628000,3,2.25,1720,8521,1140,580
9206950200,20150310T000000,352000,2,2.5,1320,1957,660,660
2291400341,20150203T000000,311600,3,2.25,1358,1196,1358,0
1311400350,20141009T000000,235000,4,1.5,2070,7245,1060,1010
191100810,20140811T000000,870000,5,2.25,2910,9525,2910,0
7895500550,20150319T000000,190848,4,1.5,1370,7904,900,470
9221400335,20141001T000000,570000,4,1.75,2340,5080,1170,1170
6087100070,20140523T000000,661254,4,4,2290,6250,1690,600
3052700695,20140507T000000,575000,4,2,1650,5000,1650,0
6150200435,20140513T000000,230000,2,0.75,650,5360,650,0
5423040140,20150402T000000,680000,3,2.25,2300,9914,2300,0
123039336,20140611T000000,148000,1,1,620,8261,620,0
123039336,20141208T000000,244900,1,1,620,8261,620,0
1446401290,20141030T000000,214950,3,1,1400,6600,1280,120
8010100135,20141030T000000,580000,3,1.5,1800,6250,1420,380
8899000140,20140828T000000,263000,3,1.5,1300,7885,1300,0
2172000570,20140624T000000,317000,5,2.5,2360,11375,1180,1180
1471701200,20141022T000000,302000,4,3,3320,13500,1750,1570
9808700370,20140623T000000,899000,3,1,1480,6978,1480,0
904000045,20140623T000000,1.29E+06,3,2.5,2190,11394,1550,640
7680400140,20140626T000000,710000,3,3.25,3740,136915,3100,640
3291800140,20141107T000000,230000,3,1,1360,9310,1020,340
3624039074,20150504T000000,430000,3,1,1210,5200,1210,0
98001070,20140818T000000,1.17E+06,5,4.25,4610,13252,4610,0
5100402767,20141014T000000,397000,3,1,860,6380,860,0
2826049070,20150225T000000,595000,3,2.5,2250,8300,2250,0
9414610240,20150310T000000,485000,3,1.75,2030,10089,1330,700
4019301160,20140627T000000,755000,5,2.5,3260,24300,2310,950
1217000340,20140606T000000,185000,3,1,1840,8100,920,920
1217000340,20150219T000000,340000,3,1,1840,8100,920,920
8081650400,20140624T000000,236000,4,2.75,2000,5827,2000,0
9465910310,20140919T000000,550000,4,2.5,2810,7549,2810,0
9468200163,20140709T000000,680000,3,2,1780,5720,980,800
305000310,20150421T000000,630000,4,2.5,2540,8706,2540,0
2624049035,20140617T000000,560000,3,2,2340,3477,1170,1170
8098400135,20140513T000000,385000,3,2,1480,6600,740,740
2291400342,20141022T000000,280000,3,2.25,1358,1141,1358,0
4051110240,20140825T000000,225000,3,2.5,1750,7490,1180,570
3024059078,20140605T000000,610000,4,1.75,1830,29110,1230,600
3182100105,20141209T000000,592500,3,2,1170,6750,800,370
6705850140,20141009T000000,750000,4,2.75,3170,7634,3170,0
8651442440,20141023T000000,164000,4,1,1530,4875,1530,0
3432500765,20140612T000000,320000,2,1,1100,8281,1100,0
3905100310,20140625T000000,544000,4,2.5,2030,3974,2030,0
1328330510,20140909T000000,344950,3,1.75,1870,7500,1320,550
4017050260,20140606T000000,539500,3,2.5,3080,12476,3080,0
2323069053,20150417T000000,420000,4,1.75,2480,60548,1600,880
4022900951,20150402T000000,305000,2,1,910,22725,910,0
6450304630,20141201T000000,229000,2,1,810,5100,810,0
3303960060,20140619T000000,1.07E+06,5,3.5,3990,9938,3990,0
993001342,20140808T000000,397500,3,2.25,1430,1383,1430,0
6743700030,20150401T000000,540000,4,2,2190,8402,2190,0
6696800030,20140923T000000,650000,4,2.5,2290,10186,2290,0
4114601580,20140724T000000,1.90E+06,6,4,3020,13237,2840,180
2025079045,20140623T000000,649000,2,1.75,2260,280962,1890,370
182000350,20150325T000000,287500,5,2,2020,67953,1620,400
8082400136,20140626T000000,815000,4,2.75,2620,4743,1310,1310
6352600350,20141209T000000,795000,2,2.5,2830,8630,2830,0
9414610070,20150130T000000,502775,3,1.75,1700,9840,1200,500
7812801125,20150112T000000,222900,2,1,1110,6411,1110,0
1121039105,20141203T000000,399950,4,3,2150,64694,1450,700
3591000030,20140823T000000,728000,4,2.5,2650,13684,2650,0
2386000240,20140929T000000,850000,5,3.5,3870,65556,3870,0
4254000060,20141002T000000,525000,4,2.75,2530,17856,2530,0
6623400193,20140903T000000,257000,3,1,1450,7850,1450,0
8944550140,20140519T000000,433500,3,2.5,2200,3360,2200,0
2730500140,20150423T000000,314950,4,1.75,1890,9623,1290,600
5490210510,20140922T000000,500000,3,1.75,1530,14633,1100,430
8718500560,20140627T000000,300000,3,1.5,1590,8911,1590,0
8651520160,20140707T000000,645000,4,2.5,2690,18653,2690,0
2868900160,20141002T000000,222500,3,1,990,10125,990,0
8062900030,20140715T000000,275000,3,1.75,1300,8099,1080,220
3336000626,20150416T000000,498000,3,1.5,1720,6570,1720,0
3226059083,20140626T000000,800000,3,1.75,2080,75794,2080,0
7212660960,20140814T000000,297000,3,2.5,1840,8234,1840,0
1180007375,20150512T000000,625000,5,3.5,4010,6000,2560,1450
1150900060,20141030T000000,770000,4,2.5,3560,6187,3560,0
9528102110,20140917T000000,517000,3,2.25,1640,4635,1540,100
1172000150,20140829T000000,238000,1,1,530,6350,530,0
1523049115,20141021T000000,234550,3,1,1990,15375,1140,850
4222310410,20140929T000000,230500,3,2.25,1690,7245,1160,530
2568300210,20140628T000000,585000,5,2.5,2670,16777,1620,1050
3131201320,20140822T000000,733000,4,1.75,1930,3876,1450,480
1982201255,20141114T000000,357950,2,1,810,3880,810,0
125039025,20140611T000000,530000,3,1.75,1550,3680,1050,500
5379805121,20141229T000000,377500,4,2.5,2640,10720,2640,0
7853302520,20150206T000000,475000,4,2.5,2320,10046,2320,0
1921069101,20150508T000000,399000,3,1.75,2170,73616,2170,0
9276202160,20141126T000000,660000,3,2,2080,5750,1040,1040
4037500230,20141007T000000,400000,5,2.25,2070,10488,1080,990
1982201345,20140502T000000,440000,2,1,800,4850,800,0
5469500180,20150206T000000,366400,4,2.25,2040,14383,1270,770
1088810040,20150320T000000,627250,4,2.5,2830,10677,2830,0
2117700085,20140730T000000,375950,3,1.75,1480,7560,1100,380
9211500730,20150218T000000,162000,3,2.25,1810,6750,1280,530
4083801395,20140724T000000,780000,3,2.75,1970,2600,1970,0
9274201006,20140507T000000,705000,4,2.5,2650,4316,1520,1130
7205800040,20141223T000000,450000,4,2.5,2820,15233,1820,1000
3276180210,20141117T000000,311000,3,2.75,1400,7880,1000,400
3904900530,20140613T000000,485000,3,2.5,1580,6065,1580,0
9560800040,20140716T000000,485000,3,2.5,1800,11034,1800,0
5249801411,20141010T000000,725000,5,3.75,3360,6000,2640,720
3750603492,20140715T000000,185000,3,1,1510,17040,1510,0
249000180,20141201T000000,1.89E+06,4,4.25,4285,9345,4285,0
1796370180,20150508T000000,260000,3,2.25,1610,7423,1610,0
6699940120,20150430T000000,356000,4,2.5,2470,5074,2470,0
3830210230,20150319T000000,225205,3,1,1200,7220,1200,0
9144100158,20141229T000000,445000,3,1,1260,8910,1260,0
3332500636,20140605T000000,356000,2,1,920,4095,920,0
5315100476,20141010T000000,760250,5,2.75,2540,8250,1440,1100
8682260610,20150430T000000,572000,2,2,1870,5143,1870,0
5700004525,20140624T000000,970000,3,2.25,3060,9950,1810,1250
3303950220,20140831T000000,348450,4,2.5,1950,8628,1950,0
7399800150,20140606T000000,535500,3,1.5,1730,40250,1730,0
1454600256,20141013T000000,710000,5,2.5,2570,9600,1620,950
629000730,20140528T000000,745000,3,1.75,1490,9800,1140,350
7520400040,20140620T000000,355000,4,2.5,2040,8265,2040,0
2799800180,20150323T000000,333000,4,2.5,2690,5505,2690,0
2025701530,20140826T000000,282000,3,2.5,1610,6000,1610,0
1794501415,20140528T000000,840500,3,2,2520,5400,1410,1110
4038500330,20150407T000000,432000,3,1.75,1550,8134,1550,0
9297301065,20141029T000000,625000,3,1,1800,4800,900,900
985000833,20140910T000000,209977,3,1,1170,6134,1170,0
3353400120,20140701T000000,174000,2,1,900,13531,900,0
8860310120,20150422T000000,740000,4,2,2800,8540,1730,1070
9547200790,20140917T000000,518000,3,1.75,1830,4500,1830,0
9136103026,20150305T000000,539000,3,1.75,1380,3225,940,440
5710600620,20150429T000000,575000,3,2.75,1990,9600,1530,460
6003001999,20150209T000000,530000,2,1.75,1170,976,780,390
922059020,20140716T000000,242025,4,1.75,1400,54014,1400,0
644200065,20150306T000000,1.03E+06,4,2.5,2620,11200,1770,850
6929602390,20140826T000000,230000,3,1,880,7500,880,0
7399000230,20150107T000000,350000,4,2.5,2260,7500,1460,800
3885805300,20150429T000000,595000,3,1,1300,11520,1300,0
200800330,20140711T000000,440000,3,1.75,1450,6829,1450,0
6819100330,20150220T000000,550000,3,1,1110,6000,1110,0
1338600175,20140507T000000,940000,4,2.25,1890,5940,1470,420
8728100781,20140516T000000,375000,3,1.5,1100,1751,940,160
871000515,20141205T000000,567500,2,1.5,1350,4592,1070,280
6446200175,20140916T000000,735000,3,2.5,3020,50800,1510,1510
7889600230,20141017T000000,114000,2,1,730,5200,730,0
2652500210,20140825T000000,608000,2,1,1390,3600,1010,380
7302000210,20141107T000000,442500,3,1.5,2710,47419,2170,540
6450301530,20141016T000000,381800,4,2,1530,5250,1110,420
7905200230,20140724T000000,330000,3,2,2170,3978,1340,830
1049010620,20140513T000000,90000,2,1,790,2640,790,0
9284802825,20140724T000000,312000,2,1.75,1160,8625,1160,0
3782100145,20140512T000000,339000,3,1,1080,8100,1080,0
8731951490,20140507T000000,313000,3,1.75,2190,8000,2190,0
9202650210,20140507T000000,618080,3,2.5,2030,6500,2030,0
2473450870,20141006T000000,325000,3,2.25,2480,8755,2480,0
2899200040,20140715T000000,242000,4,1,2240,7620,1120,1120
2644900149,20141218T000000,364000,2,1.5,1650,7311,860,790
952005000,20140815T000000,545000,3,1.75,1700,5750,1450,250
7298030210,20141223T000000,445000,3,2.5,2790,16173,2790,0
3760500730,20140728T000000,1.09E+06,4,2.75,3010,10830,3010,0
1562000120,20140512T000000,660000,4,2.5,2550,10000,1290,1260
9290850760,20141028T000000,845000,4,2.5,2880,35610,2880,0
272000220,20140923T000000,417000,4,2,2090,4000,1060,1030
418000145,20150428T000000,213800,2,1,740,5200,740,0
3560800040,20141028T000000,400000,2,1.75,960,6200,960,0
1139000035,20150305T000000,759950,4,3.5,2100,7560,2100,0
6681500150,20150423T000000,990000,4,2.5,2540,5930,2540,0
2330000035,20140820T000000,710000,3,1.75,1650,10250,1650,0
3095000040,20141016T000000,315000,1,0.75,770,4600,770,0
3343300065,20140902T000000,515000,4,2.5,2280,14810,1500,780
375000230,20140626T000000,638000,3,2,1660,3729,970,690
7663700772,20150218T000000,370000,4,2,2020,8100,1160,860
302000065,20150129T000000,184000,3,1,970,14850,970,0
6134500220,20140728T000000,583800,3,2.5,2480,6600,2480,0
2787700580,20141028T000000,309500,3,1,1250,7320,1250,0
2806300065,20150422T000000,1.96E+06,4,4,4430,31353,4430,0
7866500035,20140805T000000,299000,1,1,740,5000,740,0
7689600360,20140613T000000,215000,2,1,710,7200,710,0
3541600210,20140618T000000,410000,4,2,1970,10500,1820,150
6821600065,20141030T000000,478000,2,1,820,6000,820,0
7625703405,20140910T000000,431000,2,1,1000,6500,1000,0
6979900360,20140709T000000,635000,4,2.5,3080,35430,3080,0
6072100790,20150408T000000,648000,5,2.25,2410,12000,2410,0
4113800410,20140603T000000,640000,3,2.5,2370,11172,2370,0
4139450760,20141215T000000,932808,5,4.5,4690,6705,3450,1240
8682220150,20140606T000000,835000,2,2,2280,6815,2280,0
2325039057,20140728T000000,469775,2,1.75,1530,7020,1030,500
2459900040,20140717T000000,587000,5,3.5,3610,52595,3610,0
6819100150,20140721T000000,677915,3,2,1740,3600,990,750
7922900040,20140522T000000,1.08E+06,4,3,3600,9200,2100,1500
430000035,20140705T000000,671000,4,3,3130,5700,1750,1380
7853301520,20140903T000000,695000,5,3.25,3940,9780,3940,0
1623049133,20140729T000000,205000,4,2,2200,13320,1100,1100
4024101451,20150430T000000,350000,4,1,1510,7200,1510,0
3211100730,20140804T000000,360000,3,1.75,1560,7930,1560,0
9542840410,20141108T000000,313999,4,2.25,1870,4198,1870,0
6648500580,20150421T000000,300000,3,2.25,2070,7225,1690,380
8665900206,20150423T000000,452000,2,1.75,1660,11747,830,830
3025079003,20150325T000000,495500,3,2.5,2010,57934,2010,0
2377000040,20141218T000000,288000,3,1,1410,40500,1410,0
9315100210,20150217T000000,227490,3,1.75,1820,7194,1820,0
4046500720,20141107T000000,470950,3,2.5,2560,16420,2560,0
8956000120,20140614T000000,735000,4,2.75,2450,4187,2450,0
2862100366,20141015T000000,730000,7,2.75,3110,4400,2010,1100
1402660150,20141203T000000,412000,3,2.5,2210,7000,2210,0
7853310450,20140606T000000,589500,4,2.5,2630,6326,2630,0
3812400455,20141104T000000,291000,7,1,2350,8636,1550,800
269000970,20150402T000000,1.30E+06,5,3.75,4450,7680,3460,990
1788800910,20141020T000000,190000,3,1,1200,10458,1200,0
8820902700,20150422T000000,456200,2,1.75,1210,7733,1210,0
8945300040,20140919T000000,225000,3,1,1290,8470,970,320
3225069241,20150422T000000,2.00E+06,3,2.5,3490,21064,2290,1200
7202430150,20140709T000000,740000,4,2.5,3360,15091,3360,0
2070100040,20141201T000000,467000,3,1.75,2660,5511,1330,1330
1139000620,20141008T000000,385000,2,1,770,7554,770,0
976000790,20141020T000000,670000,3,2.5,1800,4763,1240,560
6617500085,20150422T000000,500000,4,2.5,2900,5760,1660,1240
6163900971,20140619T000000,352450,3,2,1430,6000,1430,0
7135521530,20141028T000000,669888,4,2.75,2550,7591,2550,0
4036800925,20140624T000000,405000,3,2.75,1310,7300,1310,0
6751300065,20140506T000000,518000,3,1.5,1430,8000,1430,0
7192200040,20141001T000000,280000,4,1,1880,6288,1120,760
3629970610,20140718T000000,435000,3,2.5,1600,2375,1600,0
3797310230,20150507T000000,314950,3,2,1760,9732,1760,0
2781270210,20150224T000000,209900,2,2,1180,3003,1180,0
1330900230,20150416T000000,630000,4,2.5,2330,31705,2330,0
8917100206,20140718T000000,442000,4,1.5,1960,12688,1960,0
1219000120,20150402T000000,340000,4,1,1140,13440,1140,0
522059158,20140616T000000,230000,3,1.75,1400,6956,1400,0
526059122,20141205T000000,495200,5,2.25,2710,22120,1410,1300
293620180,20150331T000000,900000,4,2.5,3510,6745,3510,0
945000410,20150313T000000,265000,2,1,910,4600,910,0
226059106,20150102T000000,489500,3,1.75,2090,65558,1330,760
4166600610,20150514T000000,335000,3,2,1410,44866,1410,0
8854100220,20141205T000000,585000,3,3.25,3050,12700,2240,810
5249804655,20141017T000000,800000,4,2.25,2010,7200,1010,1000
2220069203,20140908T000000,379500,4,2.25,2120,53578,2120,0
3298200790,20140812T000000,475000,3,1,1270,8000,1270,0
4038400040,20141124T000000,520000,3,2,1670,8800,1150,520
7215730730,20150128T000000,515000,4,2.5,1800,4338,1800,0
3126049107,20150503T000000,577500,2,1,1640,5515,940,700
3110800040,20140716T000000,269900,3,2.25,1740,9672,1110,630
2608300035,20140527T000000,329000,3,1,1600,5952,1150,450
7217400650,20150424T000000,458500,3,1.5,1280,1920,1280,0
924069106,20150313T000000,890000,4,2,1480,11171,1480,0
2310050040,20150401T000000,361500,4,2.5,1980,7334,1980,0
7490000040,20140718T000000,2.54E+06,5,3.25,3730,10626,3730,0
6675500133,20140822T000000,325000,2,1,900,8374,900,0
809001520,20141105T000000,1.85E+06,4,3.25,3480,6000,3480,0
1424200035,20140523T000000,945000,4,2,2840,13367,1420,1420
5641300220,20140828T000000,370000,3,2.5,2490,4244,2490,0
7849202299,20150218T000000,320000,0,2.5,1490,7111,1490,0
8682292020,20140915T000000,450000,2,2,1510,4908,1510,0
1604590230,20150424T000000,800000,4,2.5,2900,18303,2900,0
2856101540,20141211T000000,676000,3,2.5,2240,3825,2240,0
1336300610,20150402T000000,1.27E+06,4,1.75,2040,5000,2040,0
3819500065,20141028T000000,290000,3,1.75,1460,7980,1460,0
2329600040,20141118T000000,158000,3,1.5,990,8925,990,0
4440900040,20140505T000000,379950,4,1.75,1970,9389,1140,830
7202260330,20140509T000000,583000,4,2.5,2660,4000,2660,0
425000230,20141230T000000,150000,2,1,870,5700,870,0
5466400530,20140721T000000,261500,3,2.5,1740,6992,1740,0
6600490220,20141014T000000,278000,4,2.5,2290,3777,2290,0
2156500220,20140923T000000,555000,4,2.75,2170,7140,1290,880
9438300035,20140827T000000,355000,3,1.75,2040,8173,1470,570
4036800770,20140917T000000,375000,4,1.5,1770,6650,1770,0
4006000281,20140729T000000,227000,3,1.75,2380,12681,1380,1000
619079061,20140619T000000,335000,4,2,2030,103672,2030,0
3586501135,20140606T000000,680000,3,2.25,2270,23900,1820,450
8819900220,20150205T000000,686500,2,1.75,1390,5025,1390,0
1775801020,20141124T000000,410000,3,1.75,1530,26642,1180,350
3758900150,20140826T000000,425000,2,1,1430,13300,1230,200
1954420230,20150310T000000,562500,3,2.5,2030,7549,2030,0
4307320230,20141014T000000,345000,4,2.5,2390,6976,2390,0
7856620910,20150414T000000,627500,4,2.5,2540,11500,1640,900
1624079021,20150313T000000,355000,3,1,1890,36300,1890,0
4123800330,20150501T000000,335000,3,2.25,1870,5876,1870,0
7186800120,20150311T000000,350000,4,3,1780,4228,1780,0
925069123,20150318T000000,590000,3,1,1610,58370,1610,0
5422420120,20140717T000000,252000,3,2,1420,6788,1420,0
5460500040,20150421T000000,1.30E+06,5,4,4440,9270,2220,2220
5113400264,20141119T000000,705000,4,2,1820,5001,1820,0
1828000230,20140714T000000,498000,3,2,1620,8400,1180,440
6415100331,20140921T000000,312500,2,1,870,7227,870,0
7686205370,20141124T000000,260000,4,1.75,1830,5375,1060,770
8092501400,20150318T000000,209950,3,1.5,2290,9600,2290,0
643300210,20150210T000000,610000,3,1.75,1110,10402,1110,0
7550801225,20140627T000000,500000,4,1,1440,7100,1440,0
4078300040,20150224T000000,850000,3,3.5,3070,7050,1570,1500
4036100175,20150219T000000,689000,4,2.5,2440,11700,1480,960
1036700220,20141110T000000,470000,4,2,2410,4680,2410,0
1644500450,20140507T000000,640000,3,3,2270,5175,2130,140
6326000205,20140812T000000,290000,4,1.75,2340,7200,1590,750
3375300150,20141218T000000,258500,3,2.5,1800,9000,1800,0
2344300220,20140714T000000,1.10E+06,4,3.5,2210,7597,1550,660
203101065,20140528T000000,420000,3,1.75,1820,22320,1250,570
5083100065,20140916T000000,230000,3,1,1190,9083,1190,0
1545804240,20150402T000000,252000,3,1.5,1400,6865,1400,0
2329720040,20140630T000000,515000,3,2.5,2600,4506,2600,0
7551300065,20140609T000000,425000,2,1,910,4635,910,0
4321200580,20150125T000000,575000,3,2.5,1760,2320,1760,0
9164100040,20141026T000000,390000,2,1,860,5160,860,0
7922750150,20140917T000000,561500,4,2.25,2310,9800,1780,530
2804600155,20150507T000000,1.35E+06,4,1.75,2000,3728,1820,180
5101402296,20140925T000000,835000,5,2.75,2460,7830,1490,970
8019200845,20150218T000000,245000,2,1,1020,15000,1020,0
9286100150,20140811T000000,475200,3,2.5,1670,3980,1670,0
3727800065,20141113T000000,425000,2,1,790,5024,790,0
7657000085,20150202T000000,218000,2,1.5,2010,7755,2010,0
7954300120,20140822T000000,600000,4,2.5,2600,6536,2600,0
686400040,20150410T000000,545000,4,2.25,1890,7210,1890,0
853200040,20150428T000000,2.41E+06,5,2.5,4600,23250,3600,1000
7857003046,20150506T000000,460000,5,3,2008,5050,1216,792
5014000085,20140623T000000,425000,2,1,880,6413,880,0
2205500355,20141021T000000,455000,3,1.75,1700,8360,850,850
2595650220,20150421T000000,313100,3,2,1730,12821,1730,0
7880010150,20140623T000000,780000,4,3.5,3910,59863,2490,1420
6386550040,20141223T000000,345500,4,2.5,2160,9682,2160,0
1355000220,20150119T000000,243000,3,1.75,1200,8034,1200,0
6619900120,20141208T000000,670000,5,3.5,3860,9600,2660,1200
2132200230,20150211T000000,325000,3,1.5,1320,7560,840,480
2988800065,20141202T000000,281000,2,1,1280,12500,1060,220
13001215,20150305T000000,130000,3,1,1100,5100,1100,0
705700530,20140730T000000,340000,3,2.5,2170,9798,2170,0
7230100120,20150209T000000,485000,4,2.75,2720,51396,2720,0
9520900230,20141217T000000,642860,4,2.75,2520,6398,2520,0
9828701085,20141003T000000,747000,3,1.75,2560,4800,1280,1280
1926049385,20140729T000000,559950,4,2.5,2650,7200,2250,400
5680000455,20141117T000000,577288,4,2.75,2870,7200,2870,0
125039021,20140924T000000,575000,2,1,1230,2726,880,350
3241600150,20140505T000000,287000,3,1,1450,6000,1450,0
1245003006,20141110T000000,1.15E+06,4,3.75,3180,9889,2500,680
2789000120,20150424T000000,335000,2,1,1800,8900,900,900
6073300040,20150106T000000,375000,4,2.25,2020,12500,2020,0
7663700531,20150106T000000,325000,2,1,620,14823,620,0
123059042,20150423T000000,530000,3,2.25,2190,220414,1330,860
7149400450,20150112T000000,287000,4,2.25,1980,7081,1470,510
9264911210,20150226T000000,320000,5,3,2970,7000,1810,1160
7853300650,20140822T000000,425000,4,2.5,2270,4400,2270,0
6383000150,20140806T000000,550000,3,1,1630,6009,1630,0
5560000650,20141202T000000,135000,3,1,1520,8450,1120,400
5700002020,20140717T000000,695000,3,1.75,2080,5687,2080,0
2141310540,20150506T000000,975000,5,2.5,3020,9648,1980,1040
7247000035,20140520T000000,210000,4,1.75,2180,28710,1180,1000
4077800438,20141231T000000,518000,4,1.75,1780,8768,1050,730
8821900155,20140709T000000,335500,3,1,1370,6780,1370,0
1324039110,20141126T000000,750000,4,3.5,3050,7020,2050,1000
5566100205,20141223T000000,515000,3,1.75,1490,12000,1490,0
7222000209,20140521T000000,344500,4,2.75,1800,5453,1050,750
7867500021,20140616T000000,470000,3,1.5,1760,6723,1160,600
8563010540,20140904T000000,606150,4,1.75,1770,9848,1370,400
7349650120,20141120T000000,292000,4,2.75,2910,7712,1600,1310
620069061,20150507T000000,450000,3,2.5,2880,426452,2880,0
9269200540,20140819T000000,429000,3,1.75,2520,5043,1260,1260
1939000040,20140820T000000,765000,4,2.5,3190,38119,3190,0
2767603026,20150415T000000,425000,2,1,540,2500,540,0
9477920120,20150212T000000,505000,4,2.5,3170,5340,3170,0
4037200530,20150317T000000,544950,3,1.75,1830,7371,1830,0
8150600065,20140924T000000,382000,3,2,1360,4840,1360,0
4046600120,20140828T000000,475000,3,1.75,1870,25157,1870,0
8835220210,20150417T000000,355000,3,1.5,1370,4790,1370,0
7696300180,20140703T000000,410000,4,2.5,1700,9000,1700,0
6362900145,20150203T000000,450000,4,2,1960,5008,980,980
7663700968,20140528T000000,565000,7,4.5,4140,9066,2070,2070
6844700975,20150414T000000,529100,2,1,1290,6528,1290,0
7853300720,20150212T000000,452500,4,2.5,2460,6454,2460,0
4222200210,20140522T000000,245000,4,2,1580,8000,1040,540
7518505040,20150330T000000,415000,1,1,700,2550,700,0
6646200770,20140724T000000,610000,4,2.5,2410,15899,2410,0
1262700040,20141016T000000,363500,4,1.75,2180,9702,1090,1090
6811000220,20150204T000000,510000,3,2.75,1950,12630,1230,720
6979900330,20150325T000000,650000,4,2.5,2630,28298,2630,0
984200540,20150114T000000,290000,4,2.5,2050,9015,2050,0
7812800155,20150318T000000,170000,3,1,790,6750,790,0
7228500610,20150330T000000,510000,2,1,1070,5280,1070,0
1225069038,20140505T000000,2.28E+06,7,8,13540,307752,9410,4130
5162100650,20140922T000000,316000,4,2.5,2320,7379,2320,0
3904902510,20140512T000000,690000,4,2.5,2670,13463,2670,0
418000330,20140808T000000,199950,2,1,700,5200,700,0
7689600330,20140813T000000,207000,3,1,860,7740,860,0
2473370870,20150416T000000,449950,4,2.25,3490,8400,3490,0
2023069054,20150318T000000,361550,3,1.75,1160,257875,1160,0
293800410,20140924T000000,824000,4,3.5,3650,57538,3650,0
7752000065,20150106T000000,537000,3,1.75,1550,10050,1550,0
191100870,20140805T000000,838400,4,2.5,2620,9525,2620,0
5347200220,20140911T000000,225000,2,1,720,4758,720,0
7604400150,20150423T000000,329900,3,2,1380,5198,1380,0
3024089057,20150106T000000,282500,4,1,1170,34925,1170,0
2212901010,20150406T000000,229950,3,1.75,1170,11960,1170,0
6414100482,20150331T000000,500000,2,1,1630,12059,1270,360
9455200329,20141104T000000,495000,3,1.75,1890,6557,1890,0
9536601996,20140610T000000,149500,3,1,1010,9450,1010,0
1546600230,20140818T000000,726000,3,2.5,2040,10033,1420,620
8691330330,20150409T000000,899000,4,2.5,4080,10295,4080,0
7788400065,20150315T000000,317000,3,1,1270,8925,1270,0
2771101251,20150326T000000,395000,1,1,790,3000,790,0
4475000120,20150202T000000,360000,4,3,2580,6740,2580,0
3905120540,20140618T000000,570000,4,2.5,2290,6738,2290,0
8562890910,20140619T000000,320000,4,2.5,3490,5000,3490,0
7701700040,20140925T000000,320000,3,1.75,1510,30185,1510,0
7237300330,20150312T000000,268000,5,2.5,2400,4564,2400,0
7883608693,20140627T000000,191000,2,1,900,3400,900,0
4363700304,20140804T000000,400000,2,1,1270,7440,910,360
2768100040,20140701T000000,515000,2,1,1050,5000,1050,0
7853220120,20150416T000000,610000,4,2.5,2950,9010,2950,0
9547204675,20141024T000000,538000,2,1.75,1850,3060,1060,790
7852150220,20140603T000000,432000,3,2.5,1970,4036,1970,0
5089700720,20150127T000000,335000,4,2.25,2400,8592,2400,0
3705900124,20150220T000000,302000,5,1.75,2360,8642,2060,300
5425700150,20140804T000000,787500,4,1.75,1580,9382,1080,500
6141100065,20141218T000000,420000,3,1,1790,7055,1520,270
2726079098,20140918T000000,560000,3,2.5,2840,216493,2840,0
3904960150,20150423T000000,535000,3,2.5,1970,6634,1970,0
3298700156,20140610T000000,310000,3,2.5,1780,6771,1230,550
5700000180,20141208T000000,760000,5,2,3920,5250,2560,1360
646910620,20140922T000000,242500,3,1.75,1550,1905,1550,0
2397100975,20150220T000000,1.31E+06,6,3,2980,7200,2980,0
5365200040,20141016T000000,235000,3,1,1270,7153,1270,0
4157600180,20150223T000000,598780,4,2.25,3040,12160,1520,1520
723099044,20140807T000000,433200,3,2.5,2075,16200,2075,0
3343300644,20150511T000000,343000,2,1,1110,9920,700,410
2870000040,20141110T000000,145000,2,1,800,8125,800,0
739000035,20150116T000000,291970,1,1,680,21727,680,0
8118600155,20150318T000000,599950,3,1,1680,7910,1680,0
3025059072,20140725T000000,1.75E+06,4,2.5,3910,22710,3910,0
524059241,20150319T000000,870000,4,1.75,2780,11000,1560,1220
2215900410,20150508T000000,323000,4,2.75,2000,9083,2000,0
7215730410,20140825T000000,727000,4,3,3150,9703,3150,0
3751600146,20141023T000000,166000,1,1,1120,17332,1120,0
3461000120,20150430T000000,450000,4,1.75,1740,12204,1270,470
9238500040,20140624T000000,400000,3,2.5,2970,23100,1510,1460
9238500040,20150210T000000,599000,3,2.5,2970,23100,1510,1460
3751604895,20140605T000000,165000,3,1,1150,19200,1150,0
8961800035,20140605T000000,229000,2,1,1190,7408,830,360
1154100205,20141013T000000,305000,1,1,900,7500,900,0
9274203036,20140915T000000,930000,3,3.25,2950,4446,2450,500
3296000040,20140923T000000,542000,3,2.5,1990,15985,1540,450
1421069123,20140909T000000,214000,3,1,1020,9147,1020,0
1245500276,20140909T000000,718000,3,2.5,2070,7200,2070,0
263000325,20140611T000000,349000,3,2.5,1430,1002,1430,0
8802400644,20150505T000000,305000,3,2.5,2030,8000,2030,0
9826701345,20140715T000000,498000,3,2.5,1620,2640,1620,0
3221059044,20140523T000000,799950,4,3.5,4220,196817,4220,0
9430110120,20150505T000000,737000,3,2.5,2300,7800,2300,0
424069275,20141226T000000,860000,4,3.25,3830,10005,3830,0
9485940330,20140702T000000,339950,3,2.5,2390,34041,1840,550
2787460120,20140516T000000,249000,3,2.25,1440,7673,940,500
293000180,20150507T000000,370000,2,1,910,5525,910,0
7785000220,20141013T000000,725000,3,2,1550,12262,1550,0
1523059183,20141205T000000,529000,5,2.5,2380,91476,1580,800
9536601852,20150317T000000,310000,4,2.75,2060,8100,1310,750
2591800530,20141027T000000,315000,4,2.25,1880,9163,1880,0
1732800865,20141002T000000,1.30E+06,4,2.5,3470,4160,2480,990
2525000760,20141105T000000,435000,3,2,2360,12744,2360,0
428100580,20140716T000000,350000,3,1.75,1970,10800,1300,670
2143700676,20140908T000000,240000,3,1,1040,7800,1040,0
2313900610,20150428T000000,410000,3,2.25,1420,3750,1420,0
8946410040,20140923T000000,430000,4,2.75,2290,5249,2290,0
3275730120,20140818T000000,446000,4,2.5,1530,8375,1020,510
7334500120,20140611T000000,240000,3,1.5,1360,9760,1360,0
5561401210,20150108T000000,595000,4,3,3680,35736,2320,1360
8651410330,20150306T000000,215150,3,1,920,4770,920,0
4058801325,20140522T000000,319950,2,1,1070,5824,1070,0
2817100910,20140616T000000,385000,3,2,1590,9912,1590,0
8647800040,20150325T000000,280000,3,2.5,1600,6700,1600,0
1138010180,20150511T000000,399950,3,2.5,1510,7300,1040,470
4014400237,20140523T000000,132500,3,1,1080,10500,1080,0
9358000650,20150423T000000,399950,2,0.75,1330,2856,930,400
6150200180,20140721T000000,290000,2,1,850,6800,850,0
8146300180,20150512T000000,860000,5,2.25,1960,8592,1290,670
2424049029,20140529T000000,3.10E+06,6,4.25,6980,15682,5330,1650
3352400905,20140516T000000,245000,4,1,1530,7200,1400,130
393000385,20141215T000000,255000,3,1.5,1320,7980,1320,0
7417100133,20141113T000000,310000,4,3,2320,7200,2320,0
3782100035,20140813T000000,299000,3,1,960,8100,960,0
3905120330,20141110T000000,575000,4,2.5,2040,5508,2040,0
9310300211,20141114T000000,284000,3,1,1080,8214,1080,0
1868900035,20150407T000000,840000,3,1.75,2020,4800,1090,930
3574801510,20140813T000000,442573,3,1.75,1780,7567,1290,490
5102400035,20141008T000000,560000,3,1,1140,7028,1140,0
2810100040,20140507T000000,485000,3,2,1610,4160,1010,600
785000040,20150318T000000,472500,4,1.75,1440,8536,1440,0
3861470120,20141126T000000,1.61E+06,4,2.75,4270,25807,4270,0
8813400155,20141219T000000,808000,8,3.75,3460,4600,2860,600
526059199,20141022T000000,398000,3,1.75,1890,16001,1890,0
5126300770,20150217T000000,340000,3,2.5,2240,6000,2240,0
2734100395,20150513T000000,380000,2,1,760,4000,760,0
795000865,20140912T000000,235000,3,1,1020,6173,780,240
3763300040,20141027T000000,400000,3,1.5,1330,9900,1330,0
1777600880,20140711T000000,582000,5,2.5,2780,12335,1590,1190
3361401210,20141231T000000,209000,2,1,1070,6120,1070,0
1431600180,20150403T000000,335000,5,3,2660,7700,1670,990
7454001120,20141212T000000,285950,2,1,710,7120,710,0
5561100180,20141107T000000,645000,5,2.25,3340,52476,3340,0
8658303080,20141223T000000,312000,2,1,1160,7500,1160,0
6795100589,20141010T000000,663000,3,2.25,2840,59677,1580,1260
3345100184,20141020T000000,443950,3,1.75,2000,36000,2000,0
9284801165,20140530T000000,315000,3,2,1060,5750,1060,0
7229100180,20150323T000000,302200,4,1.5,1730,10396,1730,0
9808630120,20150108T000000,770000,3,2.5,2190,2658,2190,0
2473411210,20150122T000000,374950,4,1.75,1660,8160,1660,0
8029500180,20140611T000000,330000,3,2.5,2210,7557,2210,0
3438503014,20141020T000000,230000,2,1,870,7020,570,300
5100403882,20150427T000000,967000,4,2.5,3100,7250,3100,0
6909200401,20140908T000000,536500,4,2.5,1720,3515,1470,250
2113700360,20140627T000000,315000,6,4,3120,4240,2090,1030
2028701075,20140716T000000,626000,3,1,1040,4240,860,180
3755200220,20140718T000000,334009,4,2,1650,9305,1650,0
2767800065,20150129T000000,429000,2,1,1010,5000,1010,0
1136100087,20150205T000000,818000,4,2.5,4020,44431,4020,0
3422059257,20140828T000000,326000,5,2.75,2166,6342,2166,0
3438502083,20140612T000000,310000,5,3,1880,5000,1100,780
930000234,20150421T000000,525000,4,2,2260,7680,1130,1130
2475200330,20150403T000000,350000,3,2.25,2010,4400,2010,0
6352600650,20150402T000000,936000,4,2.5,3330,8897,3330,0
4415600040,20141129T000000,226000,3,1,1520,7200,1030,490
7974700150,20150501T000000,1.25E+06,5,3.5,3510,4798,2700,810
820079043,20140819T000000,428000,3,1.75,1580,507038,1580,0
8910500150,20140529T000000,329932,3,1.5,1460,5040,1100,360
8910500150,20150120T000000,539000,3,1.5,1460,5040,1100,360
1938400410,20150310T000000,275000,3,1.75,1650,7700,1650,0
7338200180,20140910T000000,590000,4,2.5,2660,35010,2660,0
3636800180,20150123T000000,782000,4,2.5,3510,24604,3510,0
9545240180,20140616T000000,575000,4,2.5,2120,9603,2120,0
3293700482,20150114T000000,509000,3,2.25,1780,9315,1780,0
7968000120,20140509T000000,290000,4,2.5,2000,13300,1200,800
7655900062,20140728T000000,305240,3,1,1300,9000,1300,0
4321200970,20140610T000000,555000,3,2,2180,4976,1680,500
8645540040,20140725T000000,317000,3,2,1790,8228,1390,400
7504200120,20140613T000000,430000,3,2,1910,5040,1910,0
3867400175,20150224T000000,850000,2,1.5,1800,4144,900,900
4022906222,20141126T000000,469000,3,2.25,2620,10659,1660,960
7346600092,20140730T000000,327200,2,2,1440,8425,1440,0
3222049044,20140612T000000,835000,3,3,2790,12523,1600,1190
1843100580,20140903T000000,360000,4,2.5,2340,13445,2340,0
393000142,20141211T000000,372000,4,2.5,2070,8658,2070,0
3288200360,20150326T000000,453000,3,1,2160,11484,2160,0
5379800040,20140813T000000,275000,2,1.75,2090,11317,1090,1000
6843600040,20140702T000000,475000,4,2.5,2040,7260,2040,0
1091500120,20150213T000000,310000,4,2.75,1950,9720,1400,550
7148200040,20150210T000000,173000,4,2,1200,8460,1200,0
1623089025,20150403T000000,313500,5,3,2240,94960,2240,0
3278600760,20140729T000000,345000,3,2.5,1360,1489,1360,0
1226039054,20150316T000000,436000,3,1.5,1500,10200,1300,200
798000145,20140924T000000,244500,2,1.75,1300,14500,650,650
7905400040,20140711T000000,206000,3,1.75,1140,9800,1140,0
3825310720,20150421T000000,890000,4,2.5,2930,9158,2930,0
4137000540,20150122T000000,329950,4,2.25,2140,8874,2140,0
120059044,20150217T000000,250000,3,1.75,1628,286355,1628,0
420069021,20141027T000000,246000,3,2,1990,203861,1990,0
622100092,20140716T000000,440000,3,1.75,1950,19747,1150,800
3876312620,20140924T000000,395000,4,1.75,1910,8117,1460,450
3331001165,20140926T000000,305000,3,1,820,5150,820,0
2019200220,20140923T000000,160000,3,2.25,1470,8682,1160,310
2019200220,20150226T000000,269000,3,2.25,1470,8682,1160,310
7956200220,20140811T000000,169500,3,1,1060,10023,1060,0
6632900452,20141205T000000,690500,4,2.75,3130,8920,3130,0
8165100035,20141203T000000,245560,2,1.5,1260,9693,1260,0
9264930970,20150311T000000,345000,4,2.75,2200,13498,2200,0
3344500085,20141015T000000,383000,4,1.75,2580,19607,1290,1290
3320000222,20140827T000000,388500,3,2.25,1350,944,1050,300
3375300210,20140918T000000,250000,3,1.75,1350,8548,1350,0
5469500580,20150203T000000,455500,3,1.75,2290,19000,1650,640
8146100610,20141201T000000,672000,3,1,1220,8573,1220,0
3223059123,20140630T000000,550000,4,1.5,2750,128502,1500,1250
2325059101,20150506T000000,487000,3,1.75,1430,12632,1430,0
9475710040,20140820T000000,291375,4,2.5,2220,6233,2220,0
9310300175,20150304T000000,225000,3,1,1490,15850,1490,0
8099900040,20141111T000000,519950,5,3.5,2440,10200,2440,0
3224800120,20140826T000000,250000,3,2.5,2070,8400,2070,0
4232903265,20140918T000000,614950,3,1,1500,2400,1500,0
8861500065,20150114T000000,599500,4,2.25,2020,10260,2020,0
3585300365,20140924T000000,625000,4,1.5,2190,13660,2190,0
8019200360,20150506T000000,248500,2,1,780,10064,780,0
2862100205,20140930T000000,469950,5,2,1220,4200,1090,130
7420100040,20150422T000000,525000,3,1.5,1840,10956,1840,0
223039229,20140902T000000,787500,2,2.5,2390,6928,1810,580
7967950040,20150416T000000,485000,4,2.5,3710,15935,2130,1580
1443500120,20150407T000000,310000,2,1,750,5379,750,0
3920000040,20141010T000000,280000,5,2,2110,7919,1110,1000
126059021,20150402T000000,200000,4,1,1020,42966,1020,0
8106300970,20141010T000000,490000,3,2.5,3080,7363,3080,0
9320900610,20141231T000000,146000,3,1,900,4770,900,0
5647900650,20141120T000000,500000,5,3,3720,25474,2090,1630
1432701430,20140910T000000,242500,3,1,940,7380,940,0
6632300477,20141006T000000,324950,3,1,1040,7288,1040,0
9476200150,20150416T000000,231500,2,1,1000,7615,1000,0
8029500450,20140529T000000,300000,3,2.5,2080,9827,2080,0
9510320150,20141202T000000,545000,4,2.5,2500,50595,2500,0
415100085,20150217T000000,350000,3,1,1050,8583,1050,0
8562850150,20140523T000000,467100,3,1.75,1620,8645,1190,430
1951600150,20150408T000000,180000,3,1,1610,8500,1610,0
6745700150,20140710T000000,749000,4,1.5,2130,5000,2130,0
9211520410,20141009T000000,245000,3,2.5,1460,11593,1460,0
3388000040,20140819T000000,260000,5,1,1600,7350,1600,0
3566800040,20140607T000000,490000,3,3,1730,2940,1730,0
4221250120,20140827T000000,565000,4,2.5,2280,4602,2280,0
1402600040,20140825T000000,330000,4,2.25,2430,7490,2430,0
2720000120,20141104T000000,295000,3,1,1380,7575,1380,0
3359500665,20141009T000000,725000,3,1.5,1790,6000,1790,0
7732650040,20140903T000000,1.14E+06,4,2.5,3370,10602,3370,0
2874600040,20140804T000000,680000,3,2.25,2920,6300,1710,1210
6154900065,20141030T000000,490000,2,1,2180,9300,1090,1090
3491300180,20150427T000000,635000,3,1.75,1480,6985,1200,280
619079096,20150406T000000,750000,3,2.5,2350,715690,2350,0
9264920620,20141209T000000,330000,4,2.25,2440,8098,2440,0
7899800730,20150324T000000,270000,3,2.5,1350,1189,1080,270
8944750730,20140514T000000,340000,3,2.25,1970,3716,1970,0
2922703150,20150304T000000,413252,3,0.75,1110,3960,1110,0
293610040,20150210T000000,600000,4,2.75,2950,5803,2950,0
7215720410,20150415T000000,726888,5,3,2970,7261,2970,0
5550300175,20141206T000000,285000,2,1,720,6400,720,0
1588600040,20150206T000000,365000,2,1,770,5680,770,0
7819000040,20150309T000000,295000,4,2,1650,7200,1650,0
1839920180,20150318T000000,460000,3,2.25,1620,7350,1170,450
2560803085,20140925T000000,230000,3,1.5,1510,10588,1510,0
6414100133,20140522T000000,337000,3,1,1070,6109,1070,0
164000174,20140908T000000,300000,3,1,1010,6300,1010,0
1118001201,20150130T000000,2.30E+06,4,2.5,3370,8402,2240,1130
5104510720,20141210T000000,360000,4,2.5,2000,5500,2000,0
3904910650,20150316T000000,585000,3,2.5,2060,10839,2060,0
9211500620,20141008T000000,182700,3,2.25,1740,6650,1240,500
9211500620,20150428T000000,305000,3,2.25,1740,6650,1240,500
6402710120,20140505T000000,309950,3,2.5,1880,7838,1880,0
1245001739,20150316T000000,550000,3,1,960,12527,960,0
6817850040,20141111T000000,825000,3,2.5,3280,26413,2670,610
9839301165,20141001T000000,998500,2,1,1570,4400,1570,0
1854900410,20141101T000000,644500,4,2.5,2990,5342,2990,0
2787700180,20150112T000000,320000,3,2,1250,8636,1250,0
1843130210,20141015T000000,266950,3,2.5,1920,4803,1920,0
205000450,20140514T000000,633100,4,2.5,2470,33305,2470,0
3626039279,20140805T000000,395000,2,1,960,6700,960,0
3126049261,20150316T000000,259250,3,1,940,5904,940,0
8658303265,20141106T000000,300000,3,1,1260,5000,1260,0
2421059009,20150220T000000,413000,3,1.75,2280,139392,2280,0
3111300040,20140801T000000,435000,3,2.25,1740,8491,1240,500
1770000330,20141003T000000,500000,4,2.75,2630,15000,1690,940
4174600264,20140801T000000,402000,4,1.75,2430,5481,1430,1000
822039025,20150501T000000,777700,3,2.5,2260,251460,2260,0
9521101065,20150323T000000,580000,2,1.5,1220,5000,1220,0
3244500158,20140908T000000,570000,3,1.75,2580,40392,1390,1190
3603000410,20141208T000000,174950,2,1,730,6000,730,0
7548300441,20140507T000000,300000,2,1,760,3001,760,0
3034200142,20140923T000000,435000,3,1.5,1740,6988,1600,140
8651611590,20140528T000000,840000,4,2.5,3420,8405,3420,0
2978800120,20140618T000000,469000,5,2.5,2240,7543,1140,1100
7011200515,20141112T000000,870000,4,1.75,1920,3600,1920,0
7199340620,20140604T000000,532000,4,1.75,2020,7029,1430,590
7291700065,20150326T000000,455000,4,1.5,1880,11400,1280,600
2129700142,20140731T000000,201000,3,1,1010,25277,1010,0
318300040,20140923T000000,649000,5,3.25,3990,13087,2400,1590
5101400871,20150524T000000,445500,2,1.75,1390,6670,720,670
2561360120,20140527T000000,475000,3,2,1230,11502,1230,0
293800120,20150430T000000,590000,4,2.5,2940,29013,2940,0
2595300155,20150224T000000,565000,4,1.5,2190,8296,2190,0
2853600155,20140915T000000,110000,1,1,640,10280,640,0
4365200555,20141219T000000,375000,3,2.5,1670,7740,1130,540
2473100790,20140718T000000,255000,3,1.5,1240,8528,1240,0
8019200925,20150429T000000,315000,5,1.75,1850,14800,1760,90
6071600450,20141120T000000,496600,4,2.25,2020,8400,1350,670
5249803036,20140714T000000,380000,3,1,1020,4800,1020,0
3222069151,20141110T000000,338950,3,1.75,1610,22496,1610,0
5561400610,20141019T000000,542500,5,3.5,2730,42500,1530,1200
5700000905,20140816T000000,739000,5,2.5,2840,5000,1620,1220
3362401935,20140619T000000,549000,4,1.75,1290,3060,1290,0
2893000610,20140624T000000,252000,3,2.25,1670,7881,1190,480
7856410411,20140922T000000,1.70E+06,4,4.5,3860,15246,2940,920
8156600155,20140611T000000,735000,4,1.75,2460,5100,1450,1010
2560803248,20140709T000000,270000,4,2.5,1660,8063,1660,0
1118001215,20150204T000000,2.25E+06,3,2.5,3420,8700,2890,530
1437500035,20141010T000000,155000,2,1,1010,43056,1010,0
2124049229,20150302T000000,469000,4,2.5,2240,5624,1520,720
7129304225,20150108T000000,305000,4,2.25,2340,5250,2340,0
7986400180,20140710T000000,675000,3,1.75,1920,4500,960,960
809001970,20141231T000000,931000,3,2.5,2460,6600,1560,900
7979900145,20150205T000000,385000,3,1,1470,11398,1470,0
3299600040,20150214T000000,815000,3,2.5,3400,12442,3400,0
8651730580,20150330T000000,531000,3,2.25,1910,8390,1910,0
1250201175,20150323T000000,386500,4,1,1400,3600,700,700
8651510610,20140626T000000,475580,3,1.75,1520,11085,1520,0
7017200120,20140820T000000,358000,2,1,930,5077,930,0
9272201385,20141022T000000,677500,5,1,2340,4730,1810,530
518500210,20140508T000000,868500,3,2.5,2920,3942,2920,0
3260000120,20150209T000000,599380,3,1.75,1270,7350,1270,0
7504030220,20141008T000000,712000,4,2.25,2450,11960,2450,0
7972601885,20150430T000000,350000,5,1.75,1380,7620,1180,200
2331300395,20140510T000000,875000,4,2,2520,6000,1400,1120
2597710450,20150304T000000,365000,3,2.25,2290,7350,2290,0
8122600145,20140521T000000,452000,4,2,1660,6150,850,810
629000410,20150217T000000,915000,3,2.75,2800,9750,1400,1400
7202380120,20150105T000000,482500,3,2.5,1690,3068,1690,0
2926049437,20141014T000000,425000,3,1,1180,7200,1180,0
9550202700,20141211T000000,460000,2,1.75,1390,4160,790,600
1231000458,20140720T000000,666570,4,2,2320,7400,1620,700
9485930120,20141014T000000,390000,3,2.25,2270,32112,1740,530
7923100410,20141009T000000,650000,4,1.75,2640,8215,1500,1140
2571910210,20141001T000000,305000,3,2,1680,8487,1680,0
3395800155,20140805T000000,250000,3,1,990,8100,990,0
9558040230,20150406T000000,438800,4,2.5,2770,4432,2770,0
7129302185,20141215T000000,290000,2,1,950,5650,950,0
7841300230,20150501T000000,324950,4,2,2160,4800,1290,870
2768300650,20141201T000000,453000,3,2.5,1650,1838,1270,380
546000865,20140919T000000,556000,3,1,1800,4005,1160,640
7708300150,20141118T000000,315000,3,2,1660,11135,1660,0
3709500180,20140527T000000,445830,3,2.5,1870,5449,1870,0
9273200145,20141010T000000,1.26E+06,3,3.5,3220,3960,2760,460
2025700730,20140502T000000,287200,3,3,1850,19966,1090,760
2215500220,20140923T000000,525000,4,1.5,1580,6360,1290,290
3758900220,20141226T000000,1.14E+06,4,4.25,4590,17621,3160,1430
7229900925,20141010T000000,381000,3,1.75,2700,18246,1510,1190
6632900084,20140606T000000,360000,3,1.75,1020,7020,1020,0
7137300040,20150504T000000,619000,5,3.5,2950,2932,2950,0
222069029,20150219T000000,535000,2,1.75,1780,224769,1780,0
7518503685,20141009T000000,402000,2,1,710,5100,710,0
7701930180,20141110T000000,600000,4,3.5,4300,70407,2710,1590
5072420040,20140910T000000,549950,3,2.5,2080,8690,1430,650
4058802300,20140820T000000,300000,4,2,2360,7440,1180,1180
5127100210,20150325T000000,360000,6,2,2210,9870,2210,0
6453300306,20140910T000000,419000,7,3.25,4340,8521,2550,1790
4442800166,20150407T000000,510000,3,3,1320,1012,1320,0
8078490330,20140916T000000,319950,3,2.5,1980,9907,1980,0
2322069010,20141007T000000,1.18E+06,5,5,3960,94089,3960,0
9558021010,20141003T000000,381000,4,2.5,2130,6003,2130,0
6700390230,20150505T000000,256900,3,2.5,1720,3951,1720,0
1841400150,20150219T000000,346000,5,1,1790,30456,1350,440
6873000150,20141208T000000,465000,2,2.25,1390,1222,1340,50
5710500230,20150506T000000,545000,3,2,1900,9975,1500,400
9528102060,20140730T000000,516000,2,1.75,1640,3090,910,730
2490200450,20140609T000000,550000,4,2.5,2700,5100,1440,1260
4178500580,20150505T000000,339950,4,2.25,2200,7150,2200,0
4325700085,20150325T000000,417000,3,1,1310,8514,1310,0
5606000120,20150225T000000,906000,4,2.5,2480,5000,1480,1000
5451220150,20141112T000000,980000,4,2.25,3010,9800,3010,0
7954300620,20150413T000000,555000,4,2.5,2450,5079,2450,0
2591010040,20141110T000000,468000,2,1.75,1250,7029,1250,0
3321079060,20141020T000000,378000,3,1.75,2610,117176,1390,1220
7229900145,20141216T000000,430000,4,2.5,2010,16020,2010,0
5710610790,20140516T000000,730100,4,2.5,3120,14300,3120,0
937000220,20140904T000000,219000,4,1.5,1370,7944,1370,0
7504001320,20141121T000000,570000,3,2.5,2420,11953,2420,0
3832710450,20141119T000000,262500,4,2.75,1500,7036,1060,440
8567450180,20140529T000000,525000,5,2.5,2630,9216,2630,0
4443801590,20150402T000000,520000,2,1,950,3880,950,0
7399200770,20141209T000000,417400,3,3,2680,12285,2680,0
8562740530,20140512T000000,788000,4,3.25,3680,5759,2840,840
5592900230,20141224T000000,320000,3,1,1270,7400,1270,0
3693900155,20140905T000000,950000,6,1,2330,5000,2330,0
3782100155,20140527T000000,255000,3,1,960,8100,960,0
104550580,20140520T000000,260000,4,2.5,1990,6671,1990,0
4365200620,20150312T000000,394000,3,1,1450,7930,1150,300
226059161,20141231T000000,575000,4,2.5,2280,27441,2280,0
5316100220,20150319T000000,1.25E+06,4,2.25,1830,7200,1750,80
1387300760,20140804T000000,385000,3,2.25,1650,7800,1260,390
2521059042,20141107T000000,456000,5,2.75,2720,193406,1700,1020
7974200902,20150506T000000,637000,4,2.5,1710,5000,1110,600
259600910,20141110T000000,485000,5,1.5,1420,9900,1050,370
4375700065,20140512T000000,315275,3,1.75,1440,8040,960,480
2473100330,20140923T000000,252500,2,1.5,1280,8710,1280,0
1523069095,20150323T000000,240000,2,1,1320,24319,1320,0
5101402428,20141112T000000,790000,4,2.5,2560,12760,1760,800
1072100085,20140514T000000,310000,3,1,1480,7830,1480,0
9322800230,20141212T000000,1.25E+06,4,2.5,2960,20240,2960,0
2695600455,20150128T000000,425000,2,1,1160,5038,740,420
8946400210,20140603T000000,548000,3,2.5,2110,4099,2110,0
1523069197,20140503T000000,379880,3,2.5,1650,14054,1130,520
8078420230,20140530T000000,530000,3,2.5,1950,9906,1950,0
2723069052,20150420T000000,695000,3,2.25,2600,220300,2120,480
9297300395,20140527T000000,435000,3,1,1270,4000,1270,0
1428000970,20140521T000000,540000,3,1.75,1300,62290,1300,0
1774000720,20140620T000000,425000,3,2.25,1790,10209,1290,500
2826049106,20140715T000000,490000,3,2.5,1930,7266,1930,0
2113700205,20140703T000000,220000,4,1,1200,6000,1200,0
1036450360,20150107T000000,540000,4,2.5,2050,3784,2050,0
714000155,20141222T000000,670000,3,1,1710,6195,1410,300
686800065,20141119T000000,667500,3,1.75,2130,20423,2130,0
5323100120,20140916T000000,585000,3,3.5,1700,2197,1260,440
8658300455,20141118T000000,225000,3,1.5,1390,12500,1390,0
2202500150,20140819T000000,375000,3,1,1230,9877,1230,0
258100040,20141124T000000,335000,3,2,1490,8847,1490,0
4027700021,20150311T000000,680000,5,3.25,2440,15815,1990,450
9828701747,20150123T000000,600000,3,1,970,4800,970,0
1523049207,20140805T000000,161000,4,2,1700,8043,850,850
1523049207,20150114T000000,220000,4,2,1700,8043,850,850
2131701075,20141204T000000,420000,3,1.75,1720,5000,1720,0
1794500870,20150327T000000,710000,3,1,1400,2250,1400,0
6383000790,20150122T000000,626000,4,2.5,2570,7221,1570,1000
723049448,20140722T000000,279500,3,1.5,1200,8040,1200,0
5093300325,20140523T000000,1.61E+06,4,3.5,4390,11600,3060,1330
7547300120,20140801T000000,325000,2,1,1080,5000,1080,0
2473000720,20140717T000000,380000,4,2.25,1860,7980,1860,0
7697800040,20140826T000000,470000,4,2.75,2150,9820,1220,930
1442860120,20141205T000000,363000,4,3,2250,12142,2250,0
9542800610,20150219T000000,245000,4,2.25,2050,7700,2050,0
6003501400,20150226T000000,525000,3,1,1010,3520,1010,0
5493100366,20140625T000000,1.70E+06,5,3.5,5850,22885,4670,1180
6681500205,20150504T000000,658500,4,2.25,1900,5000,1400,500
2594200230,20150424T000000,680000,2,1,1020,8442,920,100
624110450,20150225T000000,835000,4,2,3390,16025,3390,0
2768100180,20140606T000000,595000,4,2.5,1990,2175,1680,310
9406700180,20150416T000000,419000,4,2.5,3190,4980,3190,0
2122059077,20140915T000000,198900,2,1,1210,18700,1210,0
624110610,20140515T000000,1.09E+06,4,3.25,3740,12080,2000,1740
3575302245,20150423T000000,500000,3,3.5,2150,4368,1610,540
2287600040,20140711T000000,575000,4,1.75,2440,8100,1620,820
2026049183,20150402T000000,324950,2,1.5,1230,1516,1230,0
216500040,20150226T000000,259000,3,2.5,2740,7980,2740,0
6705800040,20140516T000000,551000,2,2,2260,9604,2260,0
9266701115,20140808T000000,488000,2,1.5,1000,5125,1000,0
3811000180,20150305T000000,635000,4,2.25,2350,46173,2350,0
1561900180,20150311T000000,395000,3,2.5,2300,8938,2300,0
3432500760,20140818T000000,370000,3,1,1440,8287,1440,0
7465900205,20141024T000000,675000,4,3,2780,5000,1710,1070
6629300120,20150402T000000,402000,3,1,1200,6825,1200,0
3026059011,20140813T000000,825000,3,2.75,3040,24192,3040,0
822069029,20150217T000000,579000,3,2.75,2660,223027,1330,1330
9826701490,20150225T000000,455000,5,2,1510,3000,1510,0
4137020360,20140722T000000,265000,3,2.5,1780,6527,1780,0
1115700040,20141201T000000,713500,5,2.75,2920,9163,1520,1400
1061400180,20150106T000000,240000,3,1,1550,12670,1550,0
820079081,20140911T000000,570000,4,3,2710,217800,2710,0
2524069072,20140626T000000,243800,3,1,1140,27760,1140,0
9521101520,20141212T000000,543000,2,1,940,3864,940,0
5016002240,20141008T000000,1.01E+06,3,2.25,2160,7500,2160,0
424069010,20140721T000000,625000,4,2.25,2470,17008,2470,0
5104540610,20140925T000000,459950,4,2.5,2800,6567,2800,0
8567300150,20141031T000000,370000,4,2.75,2420,39704,2420,0
2976800749,20141031T000000,150000,4,2,1460,7254,1460,0
7015200790,20140624T000000,683500,3,1.5,1820,5756,1640,180
2770604104,20140604T000000,499950,3,2.5,1520,2208,1040,480
1624049092,20140630T000000,255000,2,1,1320,9967,940,380
8078570410,20150326T000000,279000,3,2.5,1920,7779,1920,0
7974200456,20141201T000000,910000,5,3,2640,5096,2640,0
752000035,20140520T000000,699000,4,2.5,2650,7945,2650,0
3262300322,20150408T000000,1.65E+06,4,3.25,3640,13530,2570,1070
5412300410,20150325T000000,248000,3,1,1420,8800,1090,330
4013200145,20141107T000000,429000,3,1,1540,37950,1090,450
2623039018,20141027T000000,685000,4,1,1550,15239,1370,180
8122100650,20140731T000000,316000,2,1,730,5040,730,0
1005000220,20150310T000000,410000,2,1,2020,7540,1010,1010
1023089096,20140808T000000,299000,3,1,1200,15843,1200,0
1392800035,20140618T000000,559000,2,1,1240,6400,1060,180
1523069072,20140723T000000,575000,3,2.25,2680,100188,1580,1100
519000043,20140714T000000,602000,3,2.5,1640,3804,1640,0
475000975,20140522T000000,492000,4,2,1640,5000,1640,0
4142450040,20150327T000000,293500,3,2.5,1610,5024,1610,0
2824059043,20140722T000000,481000,3,2.75,2290,14810,1400,890
8558600085,20140509T000000,311100,4,2.25,2130,8078,1380,750
8649400410,20150417T000000,375000,3,1.75,2140,13598,1620,520
2523089025,20150210T000000,1.08E+06,3,3,4020,435600,4020,0
9512500720,20150428T000000,500000,5,2.5,2030,8400,1330,700
2461900760,20150401T000000,553000,3,1,1380,6250,1380,0
2877104196,20141206T000000,760000,3,2,1780,1750,1400,380
2493200325,20150509T000000,589500,4,1.5,1440,3200,960,480
5210200410,20141114T000000,840000,5,2.75,2790,20824,1680,1110
1954700410,20140801T000000,2.55E+06,4,3,4190,8805,3490,700
9253900210,20140707T000000,1.28E+06,3,2.5,3870,46609,3870,0
984000450,20141201T000000,260000,3,2.5,1850,7875,1250,600
993002247,20140716T000000,430000,3,2.25,1550,1469,1550,0
7517500610,20150304T000000,781000,3,2.5,1920,1896,1920,0
3438500981,20150328T000000,280000,2,1,790,13170,790,0
2011400021,20140701T000000,392000,5,2.25,3740,32481,2240,1500
4038100360,20150210T000000,466200,3,1.5,1340,8856,1340,0
2028700360,20140523T000000,641000,3,1.75,1620,3975,940,680
9144100035,20150324T000000,350000,3,1,1680,8010,840,840
8665050530,20150204T000000,450000,3,2,1610,4364,1610,0
5425700205,20140520T000000,1.80E+06,4,3.5,4460,16953,2550,1910
7399100040,20150309T000000,185000,3,1.5,1200,1848,1200,0
7809200035,20150123T000000,290000,2,1,1250,12507,1250,0
1825069072,20150430T000000,964000,3,2.5,3630,9475,3630,0
2524049318,20140528T000000,2.00E+06,4,3,4260,18000,4260,0
7527200360,20140611T000000,545000,3,2.5,2180,15693,1850,330
3041700035,20150312T000000,609950,3,2.25,1760,10350,1330,430
625049318,20140804T000000,605000,4,2,1820,7626,990,830
6071400360,20140908T000000,550000,4,2.5,2120,9163,1450,670
8127700720,20150120T000000,905000,4,2.75,2730,4268,2730,0
1402650360,20141023T000000,384200,3,2.5,2430,7613,2430,0
3277800845,20140711T000000,370000,3,1,1170,1105,1170,0
2771603050,20141204T000000,717500,3,1,2090,4000,1890,200
1068000150,20150501T000000,2.00E+06,4,3.25,3910,7500,2550,1360
126039213,20141203T000000,365500,2,1,1140,15624,1140,0
7537300210,20150128T000000,580000,2,1.5,1460,5700,1460,0
764000155,20141107T000000,415000,4,1.5,2700,14760,2700,0
7454000555,20150113T000000,272000,2,1,670,6300,670,0
2215500205,20140505T000000,600000,3,1.75,1880,6360,1040,840
3013300085,20140515T000000,744000,4,3,1980,5352,1980,0
3760500222,20140603T000000,830000,3,3,2080,10521,2080,0
6145601312,20141029T000000,322000,3,3.25,1380,1225,1380,0
3750605674,20140917T000000,270000,3,2.5,1808,19200,1808,0
1001200035,20150306T000000,272450,3,1,1350,7973,1350,0
2768300736,20150408T000000,605000,3,3,1760,2114,1400,360
5255300150,20150511T000000,510000,3,1.75,1950,8325,1950,0
5015001215,20150423T000000,1.13E+06,4,3.5,3170,4000,2340,830
4219400580,20140612T000000,1.69E+06,4,2.5,3000,7500,3000,0
6151800612,20150107T000000,162000,4,1,1460,16638,1460,0
7893207510,20150506T000000,337500,3,1.75,1350,5850,1050,300
8899200720,20150331T000000,312000,3,2.25,1470,7857,1180,290
7167000040,20140813T000000,740000,4,3,3350,199253,3350,0
7167000040,20150305T000000,700000,4,3,3350,199253,3350,0
7771300035,20140925T000000,328000,4,1,1360,8136,1360,0
7967700530,20150213T000000,241000,3,1,1020,7538,1020,0
6669150790,20140731T000000,265000,3,2.25,1840,6750,1270,570
1921059213,20150327T000000,246000,5,1.75,2030,10200,2030,0
723049533,20140930T000000,271000,4,1.75,1490,9112,970,520
797000276,20140625T000000,270000,2,1,2060,8398,1260,800
6381500720,20141117T000000,395000,4,2,2240,7085,2240,0
3812400789,20140731T000000,340000,3,2,1460,5715,1460,0
3451000206,20141016T000000,340000,3,1.75,2140,13260,1240,900
8165501540,20150306T000000,335000,2,2.25,1420,1246,1420,0
3131201563,20140625T000000,435000,2,1,1060,3036,1060,0
6813600365,20141009T000000,527950,4,1.75,1760,3600,880,880
1822039138,20150227T000000,600000,2,2.25,2320,18919,2320,0
4443800555,20140716T000000,667000,3,1.75,1770,3880,1300,470
627300145,20140814T000000,1.15E+06,10,5.25,4590,10920,2500,2090
9133600120,20150408T000000,417000,3,2.5,2040,11211,2040,0
2354300910,20150310T000000,451000,4,1.75,1260,7250,1260,0
6917700665,20150218T000000,580000,2,1,1650,9780,950,700
7214710210,20141217T000000,570000,4,2.25,2380,36446,2380,0
2649500155,20140610T000000,750000,5,3.25,2750,7500,2150,600
3343301385,20140527T000000,685000,3,2.5,2810,7700,2810,0
1237500720,20141226T000000,275000,3,2,1340,9764,1340,0
1724069043,20140618T000000,739888,3,2.5,2420,43177,1690,730
8682210650,20140527T000000,715000,2,2.5,2160,5581,2160,0
2025049025,20150325T000000,800000,4,2,2450,4400,1450,1000
7883605695,20141124T000000,350000,3,1.5,1870,9000,1120,750
2120069003,20141124T000000,220000,3,1,1000,223462,1000,0
7852130720,20141009T000000,452500,3,2.5,2240,7791,2240,0
3832060120,20150316T000000,280000,4,2.5,2200,5893,2200,0
4356200120,20141023T000000,248000,1,1,790,12000,790,0
4073200124,20150417T000000,305000,2,1,890,7200,740,150
2113700790,20150312T000000,435010,3,1,1270,4000,1120,150
9274202620,20140718T000000,678100,3,1.75,1850,2860,1210,640
2026049124,20140509T000000,325000,3,2.25,1352,1694,1352,0
1828000760,20140714T000000,529950,3,2,1540,8400,1180,360
6187700175,20141223T000000,440000,3,1.75,1640,8529,1640,0
6371500040,20150316T000000,585000,3,1,1350,4800,1350,0
8929000040,20140820T000000,462608,3,2.5,2010,2778,1390,620
2970800145,20150407T000000,350500,3,1.75,2080,5200,1040,1040
8588000610,20141110T000000,210000,3,1,1040,8125,1040,0
3905080870,20150206T000000,510000,3,2.5,1890,5929,1890,0
2457200040,20150506T000000,280000,3,2.25,1810,7630,1810,0
3971700580,20150303T000000,385000,3,1.75,1930,14389,1130,800
7304300760,20140625T000000,349000,3,1,1010,8184,1010,0
5561720180,20140826T000000,252000,3,2.25,1740,10836,910,830
1370801565,20141030T000000,1.10E+06,4,2.5,2910,8881,1940,970
1822350180,20141211T000000,375000,3,2.25,1330,8004,1330,0
1310900610,20140714T000000,336000,4,2.25,2210,11700,2210,0
9285800330,20140702T000000,732000,3,3.75,2670,6517,2020,650
6620400205,20140806T000000,200000,2,1,1000,6227,1000,0
1644510040,20140528T000000,681716,4,2.5,3150,7277,3150,0
6151800606,20150225T000000,235000,3,1.75,1520,12246,1520,0
5245600120,20141009T000000,257500,3,1,1690,13825,1210,480
8951900065,20140929T000000,315000,3,1,1070,9497,1070,0
226039186,20140520T000000,299950,3,1,910,8000,740,170
3558900450,20140711T000000,530000,4,2.25,2130,8640,1430,700
3179100790,20140915T000000,766500,2,1.75,2230,6930,1530,700
9808590210,20140513T000000,860000,4,2.5,3560,11119,2290,1270
1781500220,20150131T000000,690000,3,2.5,2590,4961,2590,0
3126049052,20150318T000000,551000,4,1.75,2040,6348,1020,1020
8677900120,20141121T000000,530000,3,2.75,2100,20150,2100,0
5408100035,20150420T000000,568000,3,1,1340,7260,1340,0
3827600040,20140520T000000,749950,3,2.5,2770,10773,2770,0
7504100910,20141006T000000,535000,3,2.5,2400,12546,2400,0
2068500210,20150409T000000,234300,3,1,1140,9779,1140,0
2172000035,20140821T000000,190000,2,1,930,11450,930,0
4039400410,20141010T000000,525000,4,1.75,1820,6600,1820,0
7519000580,20141106T000000,610000,4,1,1390,3708,1390,0
9828702266,20141003T000000,520000,3,2.5,1480,1165,1480,0
2770602170,20150422T000000,375000,2,1,760,6000,760,0
3260100330,20140528T000000,600000,3,1.75,1580,7416,1150,430
925059219,20141023T000000,664000,4,2.5,1870,16200,1250,620
1257201010,20150504T000000,698000,2,1,1510,4080,1010,500
476000333,20140827T000000,418000,3,2,1250,1306,1250,0
1721059218,20140818T000000,271675,3,1.75,2140,13068,1460,680
6400700220,20150507T000000,450000,3,1,1540,9028,1540,0
524069115,20140509T000000,759000,3,2.25,2950,78843,2950,0
8818900155,20150115T000000,599950,6,3,2020,4129,1230,790
2321300325,20150122T000000,810000,4,2.75,2820,5000,2170,650
2131200925,20140729T000000,331292,3,1.75,1660,10000,1660,0
3726800220,20150406T000000,348000,3,1.75,1830,2417,930,900
3488300085,20140919T000000,435000,2,1,720,5600,720,0
6415100297,20150219T000000,530000,3,2.5,2160,9063,2160,0
9265400210,20140922T000000,227000,3,1.75,1510,9837,1510,0
2787000040,20141003T000000,285000,3,1.5,1870,42070,1870,0
3425059218,20150317T000000,740000,4,2.25,2860,26136,1640,1220
1591600676,20150311T000000,246000,3,1,990,9145,990,0
2843200085,20150217T000000,260000,3,1,1910,8710,1080,830
2561320120,20140811T000000,366000,3,2,1350,10200,1350,0
8835400775,20141026T000000,594950,4,3.25,2557,9480,2557,0
2767704525,20150327T000000,608000,3,2.75,2610,5000,1710,900
3343901848,20150408T000000,313100,3,2,1720,11875,1720,0
7137800085,20141003T000000,185000,3,1.75,1170,9085,1170,0
1443500925,20150504T000000,455000,2,1,1140,11480,1140,0
8731800210,20140711T000000,235000,3,2.5,2350,9051,1570,780
8155000040,20141030T000000,230000,3,1,1020,12289,1020,0
9279200910,20141120T000000,770000,4,2.25,2730,5000,1460,1270
7697920150,20141002T000000,240000,4,2.25,1830,7614,1830,0
7202290620,20150219T000000,461000,3,2.5,1690,3026,1690,0
5093301285,20150327T000000,1.58E+06,4,2.5,2900,10500,1450,1450
1524069044,20141009T000000,1.82E+06,4,4.5,6380,88714,6380,0
7202340450,20141123T000000,452000,3,2.5,1690,4000,1690,0
3629921120,20141003T000000,765000,4,2.5,2660,5043,2660,0
524069020,20150422T000000,1.05E+06,4,4,4550,54013,2300,2250
2273600410,20150505T000000,546000,3,3,1530,9999,1150,380
3186600515,20150122T000000,781000,3,2.5,2070,4463,1780,290
7923000360,20150120T000000,538000,4,1.75,1880,7953,1880,0
6678900150,20140819T000000,790000,4,2.5,2240,8664,1470,770
9482700455,20141021T000000,696500,4,2.75,2540,4400,1630,910
3861500330,20150430T000000,276000,3,2,1370,8137,1370,0
6163901033,20140902T000000,269000,2,1,770,8612,770,0
2426039123,20150130T000000,2.42E+06,5,4.75,7880,24250,7880,0
624069003,20150102T000000,829000,4,2.75,2970,59677,1610,1360
7454000145,20150306T000000,122000,2,1,740,6840,740,0
4402700230,20140821T000000,352500,3,1.5,1360,7680,1360,0
1432701510,20141021T000000,249000,4,2,1280,7560,1280,0
1115100119,20141208T000000,360000,4,2,1920,7803,1080,840
2553300120,20150504T000000,629500,3,2,2020,10584,2020,0
2481630180,20140625T000000,1.14E+06,4,2.25,3310,127631,3310,0
2525049246,20141017T000000,1.55E+06,2,2.25,2950,15593,1560,1390
7236300065,20140718T000000,275000,3,1.5,1320,7695,1320,0
1854900330,20140909T000000,697000,4,2.5,3160,6961,3160,0
203101210,20140507T000000,379500,2,1,1640,17335,840,800
622100074,20141110T000000,720000,3,2.75,2440,76531,1640,800
5014600180,20140513T000000,675000,4,2.5,3000,5548,3000,0
809002295,20141029T000000,1.17E+06,5,2.5,2810,6000,2810,0
7533800325,20140520T000000,1.10E+06,3,2,2390,6888,2390,0
5637500180,20140612T000000,520000,4,1,2080,3500,1260,820
3971700981,20141003T000000,415000,3,1.75,2650,7500,1590,1060
2267000453,20140627T000000,415000,3,2.5,1060,1536,1060,0
5029000120,20150407T000000,450000,3,2.25,1940,8312,1220,720
3735900325,20150427T000000,485000,2,1,1080,4080,1080,0
6187100360,20150427T000000,294000,3,2.25,1700,9600,1700,0
7237500530,20140709T000000,1.04E+06,4,3.5,4440,10660,4440,0
2207500880,20140728T000000,690000,3,1,1580,4000,1580,0
7937900220,20141009T000000,716500,5,2.75,3630,38461,3630,0
2767603615,20140903T000000,481000,2,2.25,1290,1137,1290,0
8121100325,20150419T000000,575000,4,2.75,1960,4635,1000,960
8712100720,20140815T000000,785000,3,2,2090,5015,2090,0
1223059081,20150325T000000,480000,3,1.75,1960,43995,1960,0
9323610180,20140819T000000,720000,3,2.25,2120,9297,2120,0
2722059275,20150512T000000,536000,3,2.75,2290,34548,2290,0
1545800205,20140613T000000,324900,4,2.5,1880,7965,1880,0
4303200555,20140815T000000,265000,2,1,770,5160,770,0
2267000730,20140701T000000,545000,3,2.5,1530,3210,1010,520
1926049154,20150115T000000,465000,2,1.5,1450,27075,1450,0
3300790540,20150109T000000,292500,3,2.25,1690,7320,1690,0
2652501215,20140702T000000,860000,4,1.75,1880,3720,1880,0
2426059124,20141216T000000,1.05E+06,4,3.25,4160,47480,4160,0
164000237,20140612T000000,495000,4,2.5,2140,7245,2140,0
1453602283,20150507T000000,342000,2,2,1320,1462,1320,0
8081650330,20140625T000000,320000,4,2.5,2000,10051,2000,0
3797000205,20140924T000000,444000,3,2,1460,2610,1460,0
8921000040,20140625T000000,804100,4,2.5,3070,8086,3070,0
6791100410,20140919T000000,432000,3,2.5,1660,15000,1660,0
7224000450,20141230T000000,230000,6,1.5,1810,4838,1050,760
3303980650,20140827T000000,935000,4,3.5,3510,11200,3510,0
7589200191,20140807T000000,634950,3,3,2180,2650,1410,770
9547200530,20150112T000000,780000,6,4,3300,5720,1960,1340
8635751120,20140519T000000,611000,4,2.5,2460,4200,2460,0
1982201465,20141121T000000,475999,4,1.75,1880,4175,1090,790
8648700450,20141216T000000,565000,3,2,2290,9450,1670,620
3586501085,20140808T000000,630000,4,2.5,2290,26720,2290,0
7701990040,20140617T000000,840000,4,3.5,3860,18334,3120,740
3420069060,20141107T000000,790000,3,2.5,2640,432036,2640,0
1822069052,20140709T000000,450000,5,2.5,2850,209523,1930,920
4385701285,20141223T000000,1.27E+06,4,3.25,3020,4000,1920,1100
2810600210,20150422T000000,520000,3,2,1510,3760,930,580
1624049170,20141017T000000,446800,4,2,2410,8712,1260,1150
871001085,20150129T000000,652000,3,1,1470,6122,1200,270
4104500191,20140522T000000,1.17E+06,3,2.75,2890,12130,2830,60
98030530,20140610T000000,745000,4,3.25,3490,7024,3490,0
1025049115,20140625T000000,594000,3,2.25,1270,1406,1060,210
9331800580,20150310T000000,257000,2,1,1000,3700,800,200
9826701320,20140701T000000,485000,4,1.75,1430,4096,1430,0
2426049079,20150506T000000,330000,3,1,1060,20040,1060,0
204000175,20140731T000000,381000,3,2,1680,8946,940,740
822039004,20140613T000000,849900,2,2,2280,641203,2280,0
3735900205,20150402T000000,793000,4,2.5,2450,4080,1490,960
823000174,20140728T000000,920000,3,2.25,3650,5353,2200,1450
3300701575,20150422T000000,455000,2,1,830,4000,830,0
4128500210,20140513T000000,975000,4,2.5,3490,7494,3490,0
1934800142,20141203T000000,375000,2,1.5,1050,1046,960,90
1189000205,20150311T000000,400000,2,2.5,1170,1811,1170,0
4040800120,20150211T000000,447000,3,1,1220,7200,1220,0
1238501099,20141031T000000,470000,3,1.75,1310,8600,1310,0
6705870040,20141015T000000,665000,4,2.5,3130,7582,3130,0
7340601063,20140903T000000,295500,3,1.75,1590,41550,1290,300
7212660540,20150115T000000,200000,4,2.5,1720,8638,1720,0
1426079047,20140911T000000,620000,3,2.25,2520,212137,1590,930
6817800220,20140829T000000,434900,3,2,1520,11067,1140,380
1336800065,20150324T000000,1.33E+06,4,2.25,3260,4640,2360,900
9413900035,20150109T000000,1.65E+06,4,3.25,3910,7500,3910,0
9113200180,20140905T000000,852500,4,2.5,3480,6315,2360,1120
4215250220,20141209T000000,790000,3,2.5,3040,34670,3040,0
8563030330,20150313T000000,565000,4,1.75,2030,7350,2030,0
5634500688,20150325T000000,1.13E+06,6,3.25,3870,24700,2520,1350
1657530450,20141222T000000,289950,3,2.5,1870,1436,1870,0
1624059219,20141105T000000,850000,2,2,2640,13939,1640,1000
7942600975,20140512T000000,505000,4,1.75,1940,4800,1030,910
8835200610,20141028T000000,372000,3,2.5,1710,5633,1710,0
7524200180,20141023T000000,207000,4,2,1690,7728,1690,0
5451100220,20140513T000000,780000,3,1.75,2340,10495,2340,0
4047200065,20140623T000000,400000,4,1.75,1700,20283,1340,360
3374900035,20150223T000000,440250,3,1.5,1850,8124,1850,0
7010700580,20150303T000000,585000,2,2,1370,7920,950,420
4139440360,20140918T000000,850000,4,2.5,2900,9972,2900,0
3126049154,20140925T000000,570000,3,3,2400,3192,2400,0
1331900410,20140620T000000,869000,4,3,3740,30884,3060,680
3432501395,20140924T000000,551000,4,2.75,2170,5988,2170,0
8945100530,20150313T000000,172380,3,1,970,8378,970,0
3121069038,20150326T000000,355000,3,2.5,2620,78843,1310,1310
4139440730,20150225T000000,728935,4,2.5,2980,10194,2980,0
9808640040,20150306T000000,850000,3,2.5,2340,1919,2340,0
423059077,20141223T000000,515000,5,1.75,1880,48787,1880,0
8005100571,20141205T000000,215000,2,1,1480,5325,1120,360
9324320040,20140616T000000,220000,4,2.5,2240,9826,1370,870
3825310970,20140724T000000,845000,4,2.5,2940,7675,2940,0
1930301540,20150223T000000,390000,1,1,710,4000,610,100
723049158,20150313T000000,135000,4,1,1460,18599,1460,0
6116500366,20150401T000000,439000,3,1,1530,19007,1290,240
7954300330,20140708T000000,585000,4,2.5,2630,6185,2630,0
2346800180,20150309T000000,620000,5,1,2230,16800,1700,530
452001475,20140902T000000,477000,3,1,960,3600,960,0
952006783,20141014T000000,399500,2,1.5,1180,1722,1180,0
2013802060,20140927T000000,500000,2,1,1760,27332,1300,460
1787600209,20140909T000000,432500,3,2.5,1340,8867,1340,0
9542100085,20141028T000000,940000,4,2.25,2800,18673,1650,1150
3025059124,20140828T000000,3.17E+06,5,3.5,4330,11979,2090,2240
7504021490,20140512T000000,1.08E+06,3,2.5,3720,11610,3720,0
8651440230,20140815T000000,229999,4,2,1670,5200,1030,640
1003400155,20140811T000000,233000,3,1,1100,7657,1100,0
7852190410,20140626T000000,600000,3,2.5,3240,8016,2910,330
2968801085,20150508T000000,334000,4,1.5,1680,7620,1180,500
7771300155,20140716T000000,332500,3,1,1030,8164,1030,0
9320870040,20140626T000000,249900,3,2.5,1630,7700,1120,510
623049047,20141023T000000,310000,3,2,2610,12180,1670,940
9505100035,20141105T000000,200000,2,1,1250,8520,1250,0
8114000040,20140725T000000,310000,4,1.75,1480,11200,1480,0
424000145,20140707T000000,230000,3,1,1390,6000,1390,0
7857003953,20141020T000000,420000,4,2.5,1940,5414,1940,0
3630110220,20141012T000000,785000,4,2.5,2960,4750,2960,0
251500330,20141014T000000,1.78E+06,3,2.25,4320,19225,2160,2160
1900600040,20140507T000000,265000,5,1.5,1500,7112,760,740
6163901383,20140923T000000,295000,2,1,840,10465,840,0
4054530210,20150218T000000,896000,4,2.5,3560,46644,3560,0
5088500210,20150112T000000,415000,4,2.75,2390,9968,1390,1000
424500035,20150212T000000,250000,3,1.75,1200,5478,1200,0
6762700515,20150421T000000,1.48E+06,3,2.5,2570,5000,2570,0
1562200040,20150407T000000,635000,5,2.25,2180,6000,1430,750
3401700040,20150401T000000,905000,3,2.5,3450,48787,3450,0
7202330610,20140721T000000,528000,3,2.5,2020,5613,2020,0
8835350230,20140825T000000,530000,3,2.5,2480,7480,2480,0
4057300180,20140807T000000,310000,3,1.5,1140,3104,1140,0
1023059186,20150126T000000,252000,3,1,1530,9465,1530,0
6672500040,20140811T000000,334500,3,2,1700,8160,1120,580
3265300410,20150506T000000,370000,3,1,2150,8480,1610,540
7549801565,20141219T000000,311000,3,2,1190,7840,1190,0
2114700040,20150414T000000,260000,3,2.75,1730,4131,1480,250
3375300360,20140701T000000,217500,3,1.75,1400,9546,1400,0
7237301010,20150218T000000,290000,3,2.5,2200,4240,2200,0
1245500691,20141007T000000,500000,3,1.5,960,4600,960,0
1604601225,20150420T000000,423500,3,2,1770,6000,1100,670
5411600180,20141224T000000,715000,4,2.5,2970,5722,2970,0
3331001115,20140728T000000,299000,3,2.5,1590,3121,1590,0
11300120,20140630T000000,635000,3,2.5,3350,4007,2550,800
8691310040,20140826T000000,806000,4,2.5,3370,9629,3370,0
4307350450,20140531T000000,289950,3,2.5,1960,3480,1960,0
2460700650,20141010T000000,280000,3,1.75,1360,6603,1360,0
9558050450,20150330T000000,479950,3,2.5,2780,6000,2780,0
3793500730,20140627T000000,394000,4,2.5,3000,9793,3000,0
1026069061,20150129T000000,682000,4,2.5,3600,203425,3400,200
3797002160,20140724T000000,409950,2,1,990,3000,990,0
1251200155,20140911T000000,1.00E+06,4,3.5,2990,4200,2000,990
4319200450,20150120T000000,436000,4,1,1200,6600,1200,0
2762600035,20140909T000000,279000,3,1,1530,15975,970,560
9269200150,20140715T000000,390000,1,1.75,1440,4920,720,720
2623029003,20141216T000000,635000,3,1.75,1940,167125,1480,460
104560120,20140718T000000,304400,4,2.75,2140,8100,2140,0
7266200085,20150325T000000,780000,5,1.75,2330,3800,1360,970
2622029072,20141001T000000,520000,4,3.5,2734,210201,2734,0
5101406375,20150319T000000,580000,3,1.75,1950,10633,1250,700
2698200210,20140908T000000,274000,3,1.75,1440,7198,990,450
1328340120,20150209T000000,315000,3,2.25,1530,7906,1150,380
2380000040,20140806T000000,390000,4,1.75,1910,77574,1910,0
5490700085,20140911T000000,340000,5,2,1750,8220,1750,0
1226059101,20140701T000000,502000,3,2.25,1600,45613,1600,0
1081200360,20140806T000000,260000,3,1.75,1750,11180,1750,0
148000450,20140530T000000,399000,2,1,940,4800,940,0
7831800395,20140515T000000,312500,2,1,880,6345,880,0
4024101395,20140513T000000,370000,3,1.75,1650,8254,1060,590
686550040,20140619T000000,1.24E+06,4,3.5,3820,13224,3280,540
2337000150,20150220T000000,230000,3,1.5,1900,9630,1900,0
1068000559,20141003T000000,1.28E+06,4,1.75,3720,8448,1960,1760
7899800120,20140820T000000,294350,3,1,1410,5120,1210,200
425000175,20141013T000000,208950,3,1,960,5700,960,0
8682262260,20141106T000000,515000,2,1.75,1930,5570,1930,0
5608010650,20150408T000000,965000,4,2.5,3420,9575,3420,0
5350200870,20150326T000000,925000,4,2.75,3010,3400,2240,770
1279300085,20150318T000000,654500,4,1,1780,5000,1780,0
1081300450,20140814T000000,364000,4,2.5,2080,11050,2080,0
8698600395,20150324T000000,150000,2,1,1250,5208,1050,200
5381000072,20140514T000000,349950,5,3,2257,10117,1363,894
2877103111,20140825T000000,585000,3,1.5,1670,5000,1670,0
2159800120,20150317T000000,801501,4,2.25,2250,13500,2250,0
2724079061,20141010T000000,610000,3,1.75,1650,221720,1650,0
1843100610,20140521T000000,382000,5,2.25,2880,11965,2880,0
120069003,20141201T000000,495000,4,3,3620,403693,3620,0
3226049401,20141103T000000,447500,3,1.75,1950,6504,1530,420
259800610,20150220T000000,575000,4,2.5,2280,9491,1290,990
635000145,20141007T000000,565000,2,1.75,1740,4736,1040,700
3764800540,20140522T000000,348580,3,1,1220,7876,1220,0
6672700120,20141016T000000,459000,4,1.75,2260,9703,1660,600
2126079124,20150402T000000,375000,4,2,1790,61419,1790,0
2331550120,20140904T000000,310000,4,2.5,2440,7093,2440,0
2190600243,20141118T000000,210000,3,1.5,1400,9600,1400,0
7853340330,20140911T000000,384205,3,2.75,1810,3292,1810,0
3185600040,20140522T000000,180000,2,1,1400,4500,900,500
3185600040,20141224T000000,310000,2,1,1400,4500,900,500
253600180,20150203T000000,427500,4,2.5,2010,6294,2010,0
7011201475,20140527T000000,780000,3,3,2520,2152,1560,960
2525049266,20140821T000000,1.76E+06,3,2.25,3060,16000,3060,0
9542830540,20150303T000000,339950,4,2.5,2150,4000,2150,0
8965400210,20140701T000000,820000,3,2.25,2880,9750,2880,0
8682291970,20140924T000000,398000,2,2,1300,3865,1300,0
5561300540,20140602T000000,492000,3,1.75,2770,39927,1580,1190
2722049092,20150108T000000,240000,4,1.5,1780,14810,1180,600
5469502380,20140609T000000,599950,4,3.5,3730,15029,2440,1290
2023049218,20140716T000000,105500,2,1,930,7740,930,0
2023049218,20150316T000000,445000,2,1,930,7740,930,0
1920079103,20140911T000000,390500,2,1.75,1460,426450,960,500
7760400210,20150224T000000,255000,3,2,1310,8454,1310,0
8078390150,20140626T000000,675750,4,2.5,2770,10274,2770,0
3528900401,20140701T000000,1.64E+06,3,3.25,3140,5445,2240,900
5104520720,20140930T000000,353500,4,2.5,1770,9239,1770,0
8146100580,20141020T000000,765000,3,1,1220,7585,1220,0
7852020620,20150303T000000,563500,4,2.5,2190,4944,2190,0
5249803010,20150121T000000,439000,4,2,1800,5465,900,900
5459500145,20140613T000000,975000,5,2.75,3100,10014,1660,1440
7853302110,20150406T000000,469900,3,2.5,2270,4399,2270,0
7304300905,20150423T000000,252000,3,1,1300,8184,1300,0
6119200085,20140612T000000,495000,3,2,1769,9300,1769,0
622049106,20141202T000000,570000,6,2.5,3370,15625,1770,1600
1624049275,20140812T000000,327000,4,2.5,1630,5361,1630,0
5035300871,20141014T000000,898000,2,2.25,2470,7658,1480,990
1329500120,20150109T000000,300000,4,2.5,2600,8572,2600,0
7504400620,20150413T000000,418500,3,2,1800,12440,1220,580
8029550180,20150325T000000,450000,4,2.5,2240,4616,1840,400
5072200040,20140502T000000,403000,3,2,1960,13100,1650,310
6141100330,20140612T000000,440000,3,1,1710,6556,1200,510
7131300063,20150429T000000,350000,4,1.75,2140,4959,1080,1060
2807100155,20140515T000000,240000,3,2,1400,6200,700,700
1819800286,20140616T000000,460000,2,1,890,2100,760,130
2663000580,20140919T000000,825000,4,1,1820,4000,1820,0
7749500970,20150226T000000,267500,3,2.25,1860,12000,1860,0
3599600150,20140904T000000,201000,3,1,1220,22443,1220,0
7853310720,20140617T000000,479500,3,2.75,2300,4637,2300,0
4239410220,20150402T000000,210000,2,1,1520,4700,1520,0
9136103027,20140608T000000,445000,2,1,1440,3225,960,480
3432501415,20140714T000000,265000,3,1.75,1170,8148,1170,0
3432501415,20141111T000000,399000,3,1.75,1170,8148,1170,0
1026069044,20141010T000000,785000,4,2.25,3200,53357,3200,0
1152600220,20140623T000000,831500,5,2.5,4470,35124,4470,0
9478500770,20150403T000000,360000,4,2.5,2570,4557,2570,0
6388920410,20150423T000000,655000,3,2.5,2370,7916,2370,0
3579800180,20150504T000000,449950,4,1.5,1800,10150,1800,0
8860300220,20150429T000000,612000,5,2.5,2300,7000,1290,1010
1823069287,20140729T000000,575000,3,2.5,3240,33661,3240,0
8854000410,20150212T000000,557000,3,2.5,2280,18241,960,1320
3344500183,20150128T000000,375000,4,1.75,1870,12500,1030,840
2891400410,20150227T000000,369000,3,2.25,1820,99752,1820,0
7129800063,20150420T000000,330000,5,2.75,2390,6282,1290,1100
3179100220,20150427T000000,1.03E+06,4,1.75,2110,6708,1410,700
1931300815,20150326T000000,550000,2,1,980,4800,980,0
6163900333,20141110T000000,338000,3,1.75,1250,7710,1250,0
4389201075,20140731T000000,1.90E+06,4,2.5,3680,13351,3680,0
2122700120,20140820T000000,235000,3,1,2230,8163,1230,1000
2291401115,20141125T000000,349950,1,1,1230,9300,1230,0
7229100040,20140729T000000,300000,5,2.5,2093,10350,2093,0
3204800040,20141103T000000,431000,3,1.75,1660,12865,1660,0
8092700220,20150411T000000,280000,5,2.5,1630,20750,1100,530
7503800210,20150326T000000,295000,4,2.5,1677,7209,1677,0
2781250150,20150423T000000,445000,4,2.5,2990,6383,2990,0
2024089011,20140826T000000,550000,5,1,2150,262231,2150,0
2427910040,20140826T000000,515000,4,2.5,2890,15067,2890,0
3123059107,20140520T000000,555000,3,2.5,3050,158558,3050,0
7211400506,20140908T000000,265000,3,2.5,1410,2500,1410,0
8129700085,20140924T000000,597000,4,2.5,2280,2432,1520,760
3271301175,20140815T000000,661000,2,1,1260,5800,1260,0
7203101970,20140715T000000,362764,3,2,1460,4350,1460,0
1787600146,20140821T000000,427000,4,2.5,1600,14000,1310,290
5255200220,20141205T000000,405000,3,1.75,2020,8531,2020,0
937000330,20141224T000000,157000,3,1.5,1170,11530,1170,0
937000330,20150319T000000,246500,3,1.5,1170,11530,1170,0
6817800730,20150108T000000,386500,2,1.5,1280,11071,850,430
1898900040,20140606T000000,300000,4,2.5,2680,15508,2680,0
9264901510,20141107T000000,240000,3,1.75,1770,8571,1270,500
3343301490,20140909T000000,818500,5,3.5,4790,12957,3110,1680
1645000097,20140809T000000,249000,3,1.75,1300,8500,1300,0
2923501020,20140929T000000,580000,4,2.25,2610,7700,1700,910
4139900180,20150420T000000,2.34E+06,4,2.5,4500,35200,4500,0
2621760360,20140926T000000,333000,4,2.5,2100,7366,2100,0
5702380730,20140823T000000,230000,2,2,1340,7605,1340,0
1604601855,20150213T000000,360500,3,1,970,6180,970,0
6777800150,20140722T000000,265000,3,1.75,2200,7200,1270,930
1563103040,20141025T000000,490000,2,1,990,5000,990,0
7550800736,20150506T000000,600000,2,1.75,1180,5000,880,300
1138000410,20140915T000000,307500,3,1,980,6530,980,0
7555220150,20141217T000000,670000,4,2.25,2370,9636,1660,710
3021059197,20141021T000000,247200,3,1.5,1910,10583,1910,0
2923500230,20141216T000000,2.60E+06,4,4.5,5270,12195,3400,1870
4039500610,20140820T000000,440000,3,1.75,1430,8400,1430,0
3904910610,20150506T000000,700000,4,2.5,2490,7694,2490,0
2489200230,20150311T000000,756100,4,2,2000,8317,2000,0
2600100180,20141020T000000,555000,4,2.75,2600,19275,1620,980
6909200355,20150424T000000,830000,5,3.5,2880,3750,2270,610
7575500040,20141212T000000,180000,3,1,1010,8863,1010,0
6192400180,20141006T000000,775000,5,3.5,3290,5600,2670,620
5125400385,20140805T000000,220000,4,1.75,1530,18400,1530,0
7811100230,20140724T000000,650000,4,2.75,2020,15810,1620,400
6608500220,20141224T000000,410000,3,1.75,1340,9975,1340,0
705730180,20141021T000000,339995,4,2.5,2180,5367,2180,0
4039700870,20150219T000000,1.16E+06,5,1.75,2870,9680,1440,1430
238000201,20140723T000000,440000,3,2.75,2070,9697,1330,740
4365700330,20140730T000000,275000,2,1.75,930,7080,930,0
4249000230,20140829T000000,766000,3,2.5,2270,9822,2270,0
1099750610,20140710T000000,231500,3,2.25,1630,7900,1130,500
3123089010,20141229T000000,472000,3,2,2770,89298,2770,0
9578050120,20140808T000000,1.33E+06,4,2.5,4010,37076,4010,0
1423049029,20150306T000000,265000,4,1.75,1970,8390,1140,830
1703900155,20141113T000000,325000,2,1,790,6000,790,0
1397300120,20140729T000000,364500,3,1.75,1740,8424,1040,700
7304301085,20150129T000000,322500,2,1,1130,8184,1130,0
603001020,20150416T000000,338900,3,1.75,1180,4000,1040,140
5332200530,20140613T000000,910000,5,2.5,2350,4000,2350,0
5332200530,20150424T000000,1.02E+06,5,2.5,2350,4000,2350,0
4475800065,20140613T000000,459950,3,1.75,1850,6869,1100,750
4305500180,20141014T000000,584950,4,3,3220,6224,3220,0
9269750220,20141223T000000,252000,3,1.75,2050,11313,1520,530
6802210330,20150429T000000,270000,3,2.5,1430,8470,1190,240
98020220,20141030T000000,750000,4,2.5,3210,8938,3210,0
6837700175,20141201T000000,775000,3,1.75,3520,12350,1530,1990
1895450230,20150218T000000,325000,3,2.5,2260,8120,2260,0
1853080180,20141026T000000,810000,5,3.25,3290,6422,3290,0
3582750120,20140715T000000,409000,2,2.25,1640,2128,1640,0
3319500385,20140616T000000,400000,4,1.75,1580,5340,1130,450
2783100230,20150512T000000,530000,4,2.25,1940,8270,1940,0
1238501098,20150313T000000,580000,3,2.25,1580,8506,1580,0
8562900180,20140509T000000,491300,3,1.75,1750,11340,1300,450
7140200450,20141231T000000,272000,4,2.75,1810,7350,1200,610
220069106,20150401T000000,599950,3,2.5,1970,106722,1970,0
3905040040,20150226T000000,464000,3,2.5,1770,5146,1770,0
3797000330,20140623T000000,471001,3,1.75,1800,6000,900,900
6669150530,20141117T000000,230000,3,1.5,1500,11616,1100,400
3298200620,20140714T000000,358000,3,1,940,6695,940,0
8024202170,20140820T000000,510000,3,2.25,2340,6183,1210,1130
1788900230,20140722T000000,86500,3,1,840,9480,840,0
1788900230,20150403T000000,199950,3,1,840,9480,840,0
3220200040,20140616T000000,1.71E+06,3,3.25,2940,5432,2440,500
7645900355,20150313T000000,850000,3,2.75,3180,3680,2190,990
458000065,20140923T000000,542000,4,2.5,2020,3440,1480,540
123039604,20140701T000000,102500,2,1,820,4320,820,0
1223089077,20150401T000000,718000,3,1.75,4060,136290,2810,1250
4039800180,20141222T000000,625000,4,2.25,2660,22194,2180,480
7304301005,20140523T000000,350000,3,1,1010,11244,1010,0
7899800915,20150209T000000,216000,2,1,710,5120,710,0
164000271,20140905T000000,340000,3,1,980,7228,980,0
7010700976,20141114T000000,505000,3,1,1100,5400,1100,0
6699300330,20150513T000000,372000,5,2.5,2840,6010,2840,0
8732020770,20140904T000000,263850,4,2.25,2300,7524,2300,0
1795800040,20140903T000000,1.35E+06,4,3.25,5370,20388,5370,0
5104450720,20141119T000000,325000,4,2.5,2280,9899,2280,0
2113200065,20141027T000000,289000,2,1,1010,7740,890,120
4027700799,20150226T000000,364000,3,2.25,1420,6600,1160,260
3902310210,20140822T000000,610000,4,2.5,2100,8800,1250,850
9283800230,20140625T000000,531500,4,2.75,3110,49765,3110,0
114100234,20150430T000000,402500,3,2.25,2160,9540,2160,0
7625703065,20140604T000000,375000,2,1,820,6250,820,0
427000065,20150126T000000,537500,5,2.5,4340,9108,2170,2170
7844200040,20140731T000000,375000,3,1.75,2100,9066,1440,660
9315300230,20140820T000000,293550,4,1.75,1250,8840,910,340
1774200230,20150120T000000,585000,6,3,3870,43787,2700,1170
2781250530,20140812T000000,225000,2,2.5,1360,2693,1360,0
7796600085,20150108T000000,185000,4,1,1400,8684,1400,0
3205400150,20140617T000000,402000,3,1.5,1450,7375,1010,440
2207200455,20150409T000000,585000,5,1.75,1880,16617,960,920
9523100458,20140617T000000,549000,2,2.5,1380,953,1380,0
5035300325,20150414T000000,1.81E+06,3,2.25,2910,15626,2510,400
3840700593,20150406T000000,345000,3,1.75,1380,10529,1380,0
1683800120,20141117T000000,302500,3,2.25,3100,11985,1790,1310
2722059183,20141014T000000,218500,4,1.75,1400,25500,1400,0
4083305870,20141001T000000,705000,2,2,1650,6840,1650,0
8651400730,20150428T000000,191000,3,1,840,5525,840,0
7302000120,20140610T000000,695000,3,2.5,2550,45254,2550,0
797000258,20150402T000000,350000,2,2.75,2820,11770,1630,1190
9100000040,20140807T000000,480000,3,1.75,1710,4080,1130,580
8651441520,20150302T000000,220000,3,1,820,5200,820,0
6843310120,20141029T000000,535000,4,2.25,2620,33578,2620,0
3585900150,20140519T000000,1.00E+06,2,1.75,2430,23400,2430,0
9144100206,20141125T000000,592000,3,1.75,1560,7424,1560,0
2871000360,20141124T000000,775000,4,2.5,3060,6826,3060,0
4307330120,20140917T000000,320000,3,2.5,1680,4584,1680,0
6117900120,20150317T000000,760000,3,3.25,3320,15022,3320,0
1939120540,20140722T000000,640000,3,2.5,2390,8315,2390,0
421000455,20150502T000000,253200,3,1,1360,5840,1360,0
6600790210,20140716T000000,228000,2,1,1800,9236,1800,0
1771000540,20141104T000000,325000,3,1,1160,9525,1160,0
5561300730,20140605T000000,530000,4,3.25,4160,35654,2760,1400
9542830210,20150211T000000,300000,4,2.25,1660,3200,1660,0
263000155,20140505T000000,418000,3,2,1410,6030,1410,0
4058801575,20141217T000000,415000,4,1.75,2230,9625,1180,1050
7852150120,20140520T000000,384000,3,2.5,1700,4000,1700,0
2095500040,20140613T000000,325000,3,2.5,2070,8337,2070,0
8832900120,20141222T000000,600000,3,1.75,2300,12682,2300,0
9542850580,20141010T000000,760000,4,2.25,3040,9690,1940,1100
3530430155,20140530T000000,168000,2,1.5,1220,3568,1220,0
2225039081,20141020T000000,405000,3,1,960,3960,960,0
7923300230,20150504T000000,479000,3,1,1480,10094,1480,0
8021701115,20140826T000000,549000,3,2,1560,5130,1150,410
5515600087,20141209T000000,215000,3,1.5,1100,33600,1100,0
952006680,20150129T000000,550000,2,1.5,900,5750,900,0
6411600043,20140702T000000,389000,4,1.75,2400,7700,1500,900
1523089266,20140722T000000,447500,3,2.5,2320,15024,2320,0
866400040,20141013T000000,540000,5,3,2570,5590,1580,990
8092500150,20150428T000000,273500,4,2.75,1300,9638,1300,0
5637200450,20141017T000000,257000,5,2.75,2930,10148,2930,0
5126400230,20140524T000000,199000,2,1,720,7200,720,0
7137950720,20150304T000000,339100,4,2.5,2350,10655,2350,0
1473120230,20141223T000000,435000,4,2.5,2940,7590,2940,0
1604600085,20140711T000000,400000,3,2.5,2020,3000,1010,1010
123079023,20141124T000000,356000,2,1,1430,365904,1010,420
705000120,20150406T000000,395000,3,1,950,6951,950,0
1930300410,20150304T000000,575000,2,1,1250,4320,850,400
9393700065,20150423T000000,515000,3,1.75,1300,5120,1300,0
6814600355,20140619T000000,618250,4,3.25,2520,3360,1550,970
9477100620,20150219T000000,245000,3,1.5,1330,7125,1330,0
6788203060,20141010T000000,690000,3,2.75,2480,3240,1890,590
5706200360,20141106T000000,465000,5,2.25,3020,10010,1510,1510
8732130730,20141120T000000,280000,3,1.75,1770,8240,1240,530
4202400395,20150316T000000,285000,3,1.75,1930,6533,1230,700
705700210,20150316T000000,320000,3,2.25,1650,7047,1650,0
2817100040,20150213T000000,355000,4,3,2580,9601,2130,450
686300880,20150427T000000,670000,3,2,2570,10078,2570,0
8122100355,20140924T000000,550000,1,1,2880,7560,1440,1440
3797000145,20141015T000000,765000,4,2.75,2660,4500,1860,800
1704900180,20141030T000000,430000,3,1,1560,5225,1260,300
9241900150,20140827T000000,950000,3,2.5,3080,8448,3080,0
5249803185,20141015T000000,525000,4,1.75,2540,7200,1270,1270
1598600209,20141020T000000,300000,6,2.5,3080,8163,1580,1500
3260810580,20150417T000000,345000,3,2.75,2190,7258,2190,0
2423059060,20150420T000000,838000,3,3.75,2930,150945,2930,0
5461300150,20141211T000000,1.80E+06,5,2.75,2880,20274,1660,1220
3422059010,20150327T000000,390000,3,1.75,2160,98445,2160,0
6795100330,20140625T000000,1.15E+06,3,2,2110,18815,2110,0
1776420150,20140723T000000,295000,4,2.25,1830,5720,1830,0
3735900770,20141017T000000,775000,4,4,3180,7650,2530,650
4123840210,20150318T000000,380000,3,2.5,1880,6047,1880,0
5076700145,20150427T000000,550000,3,1,1140,8180,1140,0
2482500040,20140717T000000,199900,5,1.75,1798,11232,1798,0
2589300065,20140916T000000,329900,3,1.75,1670,5209,1670,0
2332700081,20140901T000000,898000,3,2.25,2580,11060,2580,0
9201000610,20140603T000000,875000,4,2.25,3720,12384,1860,1860
2822049254,20140516T000000,375000,4,2.5,2790,7956,2790,0
2310110120,20140808T000000,365000,3,2.5,2190,5091,2190,0
2887700995,20140508T000000,530000,4,2.75,2280,2850,1540,740
8651410120,20150318T000000,225500,3,1,1100,5200,1100,0
7399000580,20141117T000000,318000,4,2.25,2180,7000,1680,500
7524950210,20150401T000000,910000,4,2.5,2770,9798,2770,0
1021049057,20141008T000000,207000,3,1,1980,18730,1280,700
824059042,20140530T000000,1.89E+06,5,3.5,4180,17935,4180,0
7525410120,20140905T000000,624500,6,3,3030,31920,1670,1360
2770600841,20140604T000000,640000,3,2.5,1690,1553,1690,0
2423069164,20150410T000000,500000,3,2,1990,65340,1990,0
3876000120,20150304T000000,390000,5,1.75,2250,8970,1500,750
3705000120,20140729T000000,284000,3,2.25,2080,2050,1550,530
323069158,20140626T000000,620000,3,2,2460,41343,2460,0
6669240230,20150317T000000,306000,3,2.5,2588,5702,2588,0
7504400120,20140919T000000,495000,4,1.75,2570,12039,1910,660
1038000040,20140605T000000,499950,3,2.5,2370,12753,2370,0
9238450330,20141110T000000,330000,3,1,1070,10563,1070,0
1982200330,20140513T000000,665000,3,2,1940,5820,1150,790
1732800175,20140630T000000,850000,3,2.5,2650,2387,1830,820
8078350220,20140911T000000,599950,4,2.5,2290,6318,2290,0
3990200065,20141022T000000,360000,4,2.5,2050,9143,2050,0
3825311210,20140827T000000,699000,3,2.5,2680,5497,2680,0
1862400087,20150313T000000,475000,3,1.75,1520,8100,760,760
3522029124,20141203T000000,575000,3,2,2690,435600,2690,0
1250200418,20140527T000000,345000,2,1.5,1180,844,990,190
7967900150,20150430T000000,367950,4,2.5,3030,9500,3030,0
5631501073,20140625T000000,374500,3,2.25,1400,11400,1400,0
2826049197,20140804T000000,607500,4,2.5,3000,8100,3000,0
1775920210,20140530T000000,374000,3,1,1200,9800,1200,0
5272200035,20140903T000000,390000,3,1,1000,6947,1000,0
9525100040,20150407T000000,705000,4,3.25,2740,5339,2740,0
7853221010,20141029T000000,467000,3,2.5,1990,4978,1990,0
2500600297,20140814T000000,243500,3,3,2110,7794,2110,0
8562791010,20140707T000000,593000,3,2.75,1830,1850,1690,140
3550800040,20141114T000000,223000,3,1,940,7980,940,0
8857640210,20150420T000000,574000,4,2.5,2980,10179,2980,0
8898700120,20140604T000000,400000,3,2,2260,11305,1130,1130
1242700035,20141103T000000,772000,4,2.75,3470,70131,1750,1720
7200001005,20150501T000000,593777,3,1.75,1510,10450,1510,0
4174600072,20141223T000000,539500,4,3.5,2710,5722,2040,670
3630060150,20150401T000000,550000,3,2.5,2080,2625,2080,0
3348401490,20140630T000000,265000,2,2,1860,10856,1260,600
7214810150,20141002T000000,428000,3,1.75,2120,9350,1280,840
1566100450,20150428T000000,505000,3,2,1110,8375,1110,0
7851990120,20140701T000000,925000,5,5.5,5190,12637,5190,0
8937500040,20150102T000000,230000,3,1.75,1520,15344,1520,0
1149600120,20140820T000000,695000,4,2.5,2650,9990,2650,0
7853240040,20150414T000000,700000,4,2.75,3350,7857,3350,0
7517500085,20150425T000000,712500,3,1.75,1770,2800,1770,0
9527310180,20150403T000000,480000,3,2.5,2200,4692,2200,0
3558900580,20140922T000000,470000,3,2.5,2000,8424,1300,700
4046500180,20140724T000000,335000,3,1.75,1730,15003,1150,580
6386300120,20150417T000000,270000,3,1.5,1300,7907,900,400
3395350210,20150324T000000,810000,5,3.25,2950,67475,2530,420
9578080040,20140812T000000,589000,3,3,1720,954,1460,260
5683500085,20140926T000000,415000,2,1,880,4558,880,0
8645500360,20150311T000000,197000,4,2.25,1790,13200,1220,570
4222310220,20140825T000000,235500,3,1.5,1380,7600,790,590
2394600157,20150407T000000,460000,3,2.25,1530,1840,1240,290
9238900085,20141029T000000,572500,5,1.75,2330,4947,1380,950
2739200040,20140924T000000,302000,5,2,1540,9629,1540,0
3893100456,20140813T000000,870000,3,2.5,3210,8630,2530,680
1370803940,20141007T000000,485000,3,1,1130,5758,960,170
4222200120,20150205T000000,240000,3,2,1460,7526,1460,0
9477000120,20141022T000000,383000,3,1.75,1410,7215,1410,0
7228501065,20140626T000000,750000,4,2.75,1750,5080,1750,0
9266701085,20140603T000000,409950,2,1.75,1370,5125,1370,0
985001082,20140521T000000,246000,3,1.5,1780,23819,1780,0
8815400410,20150403T000000,860000,4,1.75,1890,4500,1490,400
2459500210,20140507T000000,339950,3,2.25,1630,12295,1630,0
1219000043,20140509T000000,315000,5,1.75,2320,8100,1160,1160
4379400580,20140813T000000,698000,3,2.5,2580,4636,2580,0
2159900120,20140822T000000,419000,2,2.5,1470,2034,1470,0
1243100191,20150122T000000,372000,3,1,2298,10140,2298,0
7852150530,20140911T000000,425000,3,2.5,1960,4709,1960,0
7508700085,20140724T000000,386500,3,2.25,2950,8036,1950,1000
8820903370,20141117T000000,348000,2,1,670,7312,670,0
1923000150,20150424T000000,754000,5,3.5,3020,15305,2230,790
3920900220,20141215T000000,269950,4,3,2390,7309,2390,0
8835700330,20141211T000000,891500,3,2.5,3090,20785,3090,0
7338402160,20141009T000000,349950,4,1.75,1780,5000,890,890
3223059141,20140509T000000,360000,2,1,1420,81892,1180,240
524059052,20141209T000000,975000,4,2.25,2420,15482,2420,0
6145600865,20140505T000000,449250,4,2,1480,3844,1480,0
2325400330,20141201T000000,350000,4,2.25,2190,3850,2190,0
9530100085,20150401T000000,790000,4,1.75,1820,6137,1690,130
3024059044,20140909T000000,990000,3,1.75,1810,24586,930,880
5015000596,20141201T000000,834000,3,2.25,2550,4089,2550,0
4443801285,20140814T000000,466950,3,1,1360,3880,1060,300
3751606606,20140717T000000,262500,3,1.75,2259,26831,1491,768
1829300210,20140506T000000,762300,4,2.5,3880,14550,3880,0
2767601085,20150126T000000,733000,6,2.75,2730,5000,1780,950
8832900155,20150414T000000,439000,4,2.5,2800,17279,1560,1240
8805900065,20141112T000000,1.16E+06,5,3.25,4290,7019,3590,700
8635760040,20141008T000000,420000,3,2.5,1770,3993,1770,0
8651540040,20140718T000000,549000,3,2.25,1920,10961,1920,0
9818700455,20140826T000000,518000,4,2.5,2320,4000,1510,810
924069210,20140603T000000,695000,4,2.5,2961,12146,2961,0
1954430180,20150105T000000,485000,3,2.5,1680,7385,1680,0
5111400081,20140603T000000,280000,3,1.75,1590,27200,1590,0
5559200065,20150507T000000,306500,2,1,1420,16400,1420,0
1266200120,20150321T000000,720000,2,1,1370,9460,1370,0
8141310180,20141118T000000,277500,3,2.5,2620,4558,2620,0
6102400166,20140905T000000,649000,3,2,1810,17006,1810,0
3126059023,20150303T000000,3.40E+06,4,3.5,4730,47870,2940,1790
408100150,20140514T000000,267800,2,1,700,6000,700,0
3905081520,20150325T000000,625000,4,2.75,2390,6979,2390,0
9324800220,20140917T000000,600000,4,2.5,2070,8127,1590,480
3996900555,20141017T000000,395000,4,2,1780,8149,1780,0
9456200450,20150427T000000,212000,4,2.5,1900,21780,1900,0
9165100330,20141212T000000,425000,2,1,1040,4040,940,100
2877103615,20150511T000000,870000,4,1.75,2370,5000,1770,600
7853210210,20150325T000000,420000,3,2.5,1970,3667,1970,0
7524950540,20150403T000000,800000,4,2.25,2120,9921,2120,0
200500410,20150506T000000,575000,3,2.5,1960,9535,1960,0
9103000365,20140620T000000,915000,3,3.25,2660,4000,2170,490
6076500220,20140903T000000,400000,3,2.25,1180,14258,1180,0
1818800144,20140502T000000,750000,3,2.5,2390,6550,1440,950
2569600150,20141103T000000,235000,3,1,1250,7592,1250,0
3448000344,20141112T000000,599950,5,3,2600,13674,1300,1300
7170200085,20150327T000000,481203,2,1,940,3800,940,0
4094800120,20140619T000000,1.82E+06,5,3,3880,13000,3880,0
2591010180,20140709T000000,379000,3,2.5,1530,2913,1530,0
3052701135,20140626T000000,626000,3,1.75,2430,5000,1760,670
625049281,20140521T000000,535000,2,1,1030,4841,920,110
5427110040,20140609T000000,1.23E+06,4,2.5,2740,16007,2740,0
9528103443,20140724T000000,410000,2,1.5,1180,1034,1120,60
7855800730,20150210T000000,940000,4,2.5,3090,9238,1680,1410
395300650,20140721T000000,326250,3,1,1060,9663,1060,0
7812800995,20140905T000000,200000,2,1,790,5985,790,0
9541600355,20140813T000000,880000,4,2.5,3070,8250,2100,970
774100355,20141103T000000,370000,2,2,2100,58488,2100,0
2781280150,20140801T000000,190000,2,2.5,1100,1737,1100,0
7338000150,20150129T000000,160000,2,1,1070,4200,1070,0
6977000040,20140823T000000,625000,4,3,2190,12825,1520,670
9558050230,20150507T000000,590000,4,3.5,3450,6873,2750,700
1241500155,20140805T000000,575000,3,2.5,2070,3599,2070,0
9266700256,20141013T000000,470000,2,1,1190,5200,1190,0
2354300456,20150311T000000,130000,2,1,600,1500,600,0
7789000120,20150421T000000,229000,3,1,940,8400,940,0
3210200395,20140822T000000,279900,3,1,1280,12928,1280,0
8658303065,20140519T000000,307000,3,1,1370,7500,1370,0
4046601010,20141023T000000,399950,3,1.75,2450,15001,1980,470
526059183,20140801T000000,405000,4,2.25,1970,15743,1370,600
5056500210,20141007T000000,539950,4,2.75,2910,9000,2130,780
6146600175,20141107T000000,129000,2,1,760,5240,760,0
6057700120,20140917T000000,340000,3,1.75,1270,8422,1270,0
8651442060,20140611T000000,214950,3,1.75,1570,4875,1310,260
7129301445,20140625T000000,450000,4,2.75,2310,5650,1330,980
7881500330,20150304T000000,515000,3,1.75,1900,5000,950,950
1336800880,20140822T000000,1.40E+06,4,2.25,3780,5160,2510,1270
7147600220,20140626T000000,230000,3,1,1060,9946,1060,0
2600030210,20140707T000000,681000,3,1.75,1880,10032,1880,0
6303400150,20140929T000000,255000,3,1,1160,8636,1160,0
9136103136,20150313T000000,580000,2,1,860,4013,860,0
8898700880,20150317T000000,295000,2,2,1590,8000,910,680
4318200360,20140730T000000,286000,2,1,1170,6543,1170,0
6798100610,20150108T000000,425000,3,1.5,1190,8100,830,360
7466900220,20141212T000000,170000,2,1,1300,11400,1300,0
7435500085,20140528T000000,380000,3,2,1660,8281,1660,0
7977200995,20150506T000000,506000,3,2,1160,6120,1160,0
1862900360,20140922T000000,315000,3,2.5,1950,9618,1950,0
7852040210,20140617T000000,449950,4,2.5,2470,3811,2470,0
3343901961,20150331T000000,255000,3,1,1430,12420,1430,0
3874010220,20140624T000000,289000,3,2.5,1970,9607,1090,880
2724069103,20140828T000000,389000,3,1.75,1400,10018,1400,0
1520069052,20140721T000000,327000,3,1.5,1510,344124,1510,0
5316101075,20140926T000000,2.89E+06,7,3,5350,14400,5020,330
8113100150,20140714T000000,210000,3,1,920,6612,920,0
3459900230,20141125T000000,1.68E+06,4,3.75,7620,29536,5980,1640
3955900150,20141229T000000,360000,4,2.5,2490,4751,2490,0
7701960210,20150427T000000,875000,4,2.5,3030,16000,3030,0
686450210,20141104T000000,550000,4,2.25,1650,7200,1650,0
3451000442,20140717T000000,257500,3,1.5,1210,12500,1210,0
5700003221,20141210T000000,1.08E+06,4,2.75,2990,7389,2090,900
8651402700,20141028T000000,202950,2,1,1060,5144,1060,0
3526039101,20141030T000000,622000,4,1.75,2680,6120,1340,1340
1136100072,20150213T000000,455000,4,1.75,1790,45738,1410,380
2050100210,20141117T000000,805000,3,2.5,2690,17461,2690,0
9141100210,20140908T000000,257000,2,1,770,9497,770,0
1153000150,20140625T000000,744500,5,2.5,2700,16570,1750,950
1245000438,20150413T000000,885000,4,2.5,2620,9157,2620,0
1498300775,20140624T000000,355000,2,2.25,930,747,630,300
4051100230,20140820T000000,240000,3,1,1340,7000,1340,0
121039038,20140819T000000,169000,3,1.5,1470,18459,1470,0
1523550220,20150328T000000,639900,3,2.5,2330,4160,2330,0
1622059095,20140604T000000,292000,3,1.75,1730,11325,1730,0
7853220210,20140922T000000,563500,4,2.5,2780,7838,2780,0
8682291510,20150126T000000,389000,2,2,1200,7131,1200,0
7397300220,20140529T000000,2.75E+06,4,3.25,4430,21000,4430,0
3764500230,20140821T000000,661000,3,2,1820,4418,1820,0
8682260870,20140912T000000,344000,2,2,1300,4659,1300,0
369000365,20150422T000000,510000,1,1,680,6600,480,200
9238901020,20140916T000000,289000,2,1,780,4132,780,0
3343901641,20140827T000000,365000,3,2.25,2430,7614,1900,530
3024079057,20140730T000000,410000,3,1.5,1750,32500,1750,0
7518507330,20140724T000000,535610,3,1,1610,5100,1010,600
2968801510,20141113T000000,397950,4,1.75,2120,7620,2120,0
2822100175,20140827T000000,284000,3,1.75,1430,4850,930,500
3826000385,20141217T000000,201000,4,1.5,1360,8100,1360,0
2301400540,20141215T000000,734000,4,2.25,2530,5000,1690,840
2111010760,20150108T000000,357500,5,3,3270,9146,3270,0
23500220,20141015T000000,550120,5,2.5,2620,8050,1520,1100
8001600150,20150310T000000,300000,3,1.5,1810,8232,1810,0
9149000180,20140819T000000,374950,3,2.5,2120,9653,2120,0
7525420150,20150413T000000,602500,4,1.75,2190,41000,2190,0
1003000175,20141222T000000,221000,3,1,980,7606,980,0
2902200874,20150410T000000,920000,5,3,2230,4400,1730,500
7131300032,20150306T000000,235000,4,2,1540,9279,1540,0
3581100330,20140804T000000,375000,3,1,980,7296,980,0
3629970870,20140827T000000,599000,4,2.5,2120,3640,2120,0
2561360210,20140603T000000,562100,3,2.25,2090,12112,2090,0
9828702245,20150316T000000,640000,3,2.5,1620,1377,1100,520
8687800150,20141120T000000,294000,3,2,1650,11256,1250,400
3825310760,20141229T000000,714000,4,2.5,3230,7766,3230,0
7284900385,20140521T000000,970000,4,3.25,2790,5420,1130,1660
5702380770,20150428T000000,280000,4,2.25,1600,7916,1600,0
2095600150,20141112T000000,260000,4,2.5,1790,4358,1790,0
4166600230,20141119T000000,294000,3,1.5,2060,15050,2060,0
3521059042,20140728T000000,255500,4,1,1370,41194,1370,0
3625059043,20140904T000000,3.30E+06,5,4.75,6200,13873,4440,1760
1926069054,20140508T000000,450000,3,2,1510,43560,1510,0
9238450150,20140512T000000,368000,3,1,1280,9898,1280,0
8146200150,20141110T000000,830000,4,2.25,2180,11056,1370,810
3841600220,20140715T000000,282500,2,1.75,1440,11210,1130,310
943100683,20140502T000000,335000,3,2.25,1580,16215,1580,0
952001765,20140707T000000,558000,2,2,1580,5750,790,790
3744600704,20150224T000000,270000,4,1.5,1730,8505,1730,0
1822059057,20140725T000000,152000,2,1,700,13500,700,0
2126059219,20140617T000000,493000,4,1.75,2030,18295,2030,0
4139400910,20140815T000000,740000,4,2.5,2500,10330,2500,0
9808630210,20150313T000000,789800,3,2.5,2605,2216,2090,515
2920700220,20150508T000000,275000,2,1,910,4191,910,0
1338800365,20140507T000000,1.50E+06,6,2.5,3560,6480,3560,0
1175001135,20140929T000000,424000,3,1.75,1140,3395,620,520
3867400180,20150327T000000,715000,2,1,1000,3513,1000,0
7954300220,20140730T000000,600000,4,2.5,3010,7953,3010,0
7784400035,20140813T000000,802000,2,1.75,2110,8700,1760,350
4435600330,20140726T000000,165000,3,1,910,8700,910,0
5016001285,20140609T000000,750000,4,3.25,2050,5000,1370,680
6817800330,20140812T000000,405000,2,1,1090,10481,780,310
8680500220,20141203T000000,521900,3,2.5,2100,12338,2100,0
3211600650,20140722T000000,275000,3,1,1000,8018,1000,0
4008400035,20141015T000000,600000,5,3.25,4410,58157,2330,2080
2473002060,20140519T000000,442500,3,1.75,1800,10200,1800,0
4059400515,20140909T000000,229950,2,1,920,7716,920,0
2916610150,20150120T000000,274950,3,2,1410,7265,1410,0
8887001215,20141107T000000,407185,3,1.75,1860,48076,1860,0
3876313040,20140709T000000,468000,4,2.5,2100,8400,1240,860
6021501320,20140930T000000,450000,2,1,1030,4365,1030,0
2372800145,20141023T000000,219950,2,1,940,8997,940,0
7120000210,20150122T000000,275000,2,2.5,1340,5995,1340,0
1180003175,20150410T000000,229950,2,1,850,6000,850,0
2902200915,20141125T000000,675000,3,1.75,2130,4400,1430,700
2473530150,20150323T000000,412950,4,2.5,2430,6796,2430,0
2366400150,20150429T000000,670000,5,2.25,2290,39000,2290,0
4040800360,20140923T000000,420000,3,1.75,1230,10005,1230,0
1269200150,20150113T000000,358000,3,1.5,1150,27319,1150,0
9510970530,20150424T000000,680000,3,2.5,2120,3600,2120,0
3856904825,20141104T000000,380000,2,1,980,3400,980,0
326069101,20141205T000000,515000,3,2.5,2130,219978,2130,0
254000175,20140819T000000,325000,2,1,1050,4800,1050,0
8086000201,20141204T000000,875000,3,2.5,1820,6848,1820,0
9284800085,20150420T000000,426000,3,2.5,2210,5750,1710,500
2287000330,20140915T000000,868500,5,2.5,2490,9639,1610,880
2025760210,20140611T000000,657500,4,2.75,4140,24190,4140,0
3330500085,20140918T000000,366000,2,1,1210,3090,860,350
1231001225,20140916T000000,385000,2,1,1010,4000,1010,0
984000650,20140908T000000,300000,4,2,2050,8750,1300,750
1962200145,20150320T000000,810000,3,1.75,2060,3300,1500,560
4074300150,20150417T000000,460000,4,1.75,1560,7200,860,700
8665050220,20141021T000000,459000,3,2.5,1780,4000,1780,0
2212700180,20150319T000000,260000,3,1.75,1460,10000,1460,0
8077200360,20141112T000000,557865,4,2.5,3030,6813,3030,0
8850000180,20150420T000000,295000,4,1,980,3000,980,0
1643500072,20140905T000000,375000,4,2.25,1450,7245,1450,0
6065300330,20140620T000000,2.11E+06,3,2.25,3230,17833,3230,0
6149700191,20140819T000000,307300,2,2,1520,1020,1520,0
1555200180,20140827T000000,225000,4,1,1410,7000,1410,0
9407100720,20141107T000000,290000,3,1.75,1390,13200,1390,0
5700000515,20141120T000000,690000,4,2,2230,5000,1510,720
5451200530,20140705T000000,825000,4,2.25,2110,12653,2110,0
868000530,20140702T000000,645000,3,1.75,2270,11472,1370,900
1777600210,20150217T000000,590000,4,2.25,2530,10611,1320,1210
7174800760,20140725T000000,667000,5,2,1900,5470,1180,720
8635750330,20140925T000000,664000,4,2.5,2390,8432,2390,0
4058800925,20150428T000000,452100,4,2.5,3160,6540,1580,1580
272000620,20141202T000000,290000,2,1,900,2728,900,0
7779200355,20150422T000000,950000,3,3,3610,17483,3610,0
510000641,20150130T000000,662500,3,2,2070,4200,1670,400
8835200230,20140702T000000,475000,4,2.5,1850,5444,1850,0
8718500555,20140915T000000,450000,3,1.5,1440,9711,1140,300
1722049154,20140707T000000,538250,3,2.25,2590,15229,2590,0
6450304130,20140505T000000,329950,2,1,1140,5250,1140,0
6908200155,20150122T000000,1.10E+06,4,3.5,2760,5040,2760,0
1773101020,20141020T000000,307000,5,1.5,1310,4800,1110,200
1105000571,20140610T000000,433000,3,1.75,1870,7189,1270,600
5153200666,20150114T000000,212000,3,2.25,1900,18000,1280,620
7660100085,20140908T000000,750000,5,2.75,2860,6000,2380,480
1843130530,20141125T000000,279000,3,2,1640,5650,1640,0
7010700905,20140611T000000,476000,3,1,1140,5500,1140,0
6790600790,20150326T000000,368000,5,1.75,2590,9394,1390,1200
8651442520,20141015T000000,228950,4,3,2160,5200,1320,840
2722059010,20140618T000000,568450,5,3.5,3260,58806,3260,0
6884800210,20140605T000000,619000,4,1.75,1660,3800,1660,0
7349600230,20140729T000000,275000,3,2.25,1640,6044,1640,0
6699300210,20141027T000000,321500,4,2.5,2620,5457,2620,0
7883607520,20140508T000000,230000,3,1.75,950,6000,790,160
1450000210,20150128T000000,179500,3,1,900,8100,900,0
1387301430,20140818T000000,460000,3,2.25,1650,7313,1220,430
2517010230,20150226T000000,286000,3,2.5,1800,3980,1800,0
9828201020,20141031T000000,427500,3,1,1480,4200,1480,0
2461900175,20140522T000000,400000,3,1,1040,6250,1040,0
8682250330,20140624T000000,675000,3,3.5,2300,5611,2300,0
3031200230,20150226T000000,350000,3,1,2480,8906,1240,1240
3824100166,20141122T000000,385000,4,1.75,1970,10358,1540,430
7011201445,20140702T000000,525000,2,1.75,1530,3503,830,700
7262200150,20150121T000000,315000,2,1,970,18557,970,0
1623069023,20140729T000000,820000,4,2.5,2920,252648,2920,0
7523700210,20150415T000000,205000,3,1,970,7700,970,0
2915200210,20141205T000000,500000,2,1,680,5250,680,0
3904990210,20140822T000000,599000,4,2.5,2640,6738,2640,0
1333300145,20150304T000000,2.23E+06,3,4,4200,30120,3600,600
7461400360,20150421T000000,299000,1,2.5,1980,7521,1180,800
7631200085,20140512T000000,947500,3,2.75,2980,27144,2180,800
6145600040,20140623T000000,385000,3,3.25,1630,1677,1630,0
6372000155,20140811T000000,639950,2,1.75,1780,4520,890,890
6821600145,20141110T000000,824000,2,1,1210,8400,780,430
7983100150,20140602T000000,199950,3,1,1010,7245,1010,0
723000150,20150408T000000,1.01E+06,3,2.5,2570,5000,1480,1090
2493200155,20150403T000000,950000,4,2.25,2770,5320,2440,330
2592210150,20140923T000000,822000,3,2.5,2290,9158,2290,0
2595300210,20141106T000000,473600,4,1.5,1780,8400,1080,700
3902100150,20150202T000000,490000,5,2,2150,4500,2150,0
3329520410,20140505T000000,245000,3,1.75,1920,9306,1000,920
4013800206,20140828T000000,199000,4,1,1220,11730,1220,0
1370803460,20140507T000000,1.34E+06,3,3,2960,5500,2440,520
4046600220,20141017T000000,418000,3,1.75,1500,19113,1500,0
6190701484,20150311T000000,450000,7,3.5,2830,8625,1830,1000
8016200530,20140718T000000,280000,3,2.5,1580,7000,1580,0
6802210210,20150303T000000,273000,3,2.25,1230,11601,910,320
4305600040,20140505T000000,549000,4,2.5,2910,6338,2910,0
7856570150,20140625T000000,913888,5,2.25,2370,15512,2370,0
7576200040,20140718T000000,689888,4,2.25,1930,3500,1540,390
6300500183,20141212T000000,305000,4,2,1780,5043,870,910
3204950120,20140529T000000,602500,4,2.5,2760,6850,2760,0
7857004225,20150424T000000,355000,2,1.75,1620,3640,900,720
7732400360,20140821T000000,756000,3,2.5,2160,7525,2160,0
4388000120,20150423T000000,289950,4,2.25,2190,6906,1040,1150
8653900150,20140505T000000,800000,3,2.5,3240,7857,3240,0
3362400472,20141202T000000,403000,2,1,720,3255,720,0
8857100180,20150413T000000,350000,3,2.25,1410,1340,1370,40
8156600210,20150326T000000,1.29E+06,5,3.5,2980,5100,2370,610
4038700720,20140918T000000,525126,5,2.25,1950,8025,1150,800
2634500085,20140812T000000,241450,3,1,1100,8138,1100,0
1077100035,20150122T000000,320000,3,1.5,1400,9087,1400,0
5466700360,20141023T000000,234000,4,2,1710,7455,1030,680
1250201165,20141121T000000,441000,5,2.5,2000,3600,1150,850
1250201165,20150317T000000,474500,5,2.5,2000,3600,1150,850
4083301120,20150422T000000,705000,3,1,1440,2618,1440,0
3905100610,20150409T000000,517500,4,2.5,1520,3370,1520,0
4330600360,20140617T000000,142500,4,0.75,1440,13300,1440,0
345700150,20141106T000000,310000,2,1.5,1010,10005,1010,0
7732100150,20141028T000000,749500,4,2.5,2440,9727,2440,0
5379800862,20150429T000000,360000,5,3,2480,7200,1560,920
4396000180,20141121T000000,267500,3,1,1090,22080,1090,0
1447600410,20141009T000000,290000,3,1,1480,32700,1380,100
3325059177,20141105T000000,850000,5,2.5,2800,11325,1400,1400
2652500155,20141029T000000,815000,4,1.75,1820,4500,1820,0
824059305,20150108T000000,2.20E+06,5,4,5840,11652,4410,1430
5318101565,20140703T000000,1.63E+06,4,3.25,2980,3600,2150,830
2460600040,20140616T000000,175000,3,1.5,1220,7300,1220,0
9527000040,20141002T000000,429950,3,1.75,1830,9758,1300,530
2909300150,20140714T000000,675000,4,2.5,2900,5505,2900,0
8078600330,20140708T000000,580000,3,2.25,1940,5980,1520,420
4338800720,20150224T000000,240000,4,2,1750,7800,1750,0
4016800120,20140820T000000,374000,3,2.5,1850,17808,1210,640
2021201085,20141212T000000,862500,4,2.5,3220,4400,2180,1040
1922059010,20150121T000000,140000,2,1,1080,6052,1080,0
1133000385,20140530T000000,740000,5,3.75,3990,18897,3090,900
2397100155,20150224T000000,589000,3,1.75,920,3600,820,100
7461420210,20150223T000000,275000,3,1.75,1290,9760,1290,0
6204050040,20140711T000000,489900,4,2.5,2090,4196,2090,0
4099100210,20140813T000000,545000,3,2.5,1900,3366,1900,0
316000145,20150325T000000,235000,4,1,1360,7132,1360,0
3331000455,20150217T000000,230000,3,1,1000,4000,1000,0
9839300775,20140710T000000,655000,4,2.25,2170,4080,1920,250
2320069107,20140822T000000,185000,2,1,820,16030,820,0
2599001010,20150326T000000,196000,3,1,1090,7400,1090,0
2193340120,20140604T000000,572000,3,2.25,1830,7897,1290,540
7954310210,20150430T000000,615000,4,2.5,3010,6903,3010,0
2425049107,20150305T000000,1.95E+06,4,3.75,4150,17424,3130,1020
1338300555,20150320T000000,1.23E+06,6,2.25,2930,4320,2130,800
8944310330,20140819T000000,375000,3,2.5,1520,5649,1520,0
2551500180,20140905T000000,295000,3,1.75,1250,9486,1250,0
9212900180,20140625T000000,760000,4,2.5,2760,6000,2230,530
2473460650,20150407T000000,347000,3,1.75,1330,7848,1330,0
2856101755,20150504T000000,712000,3,2,1700,5100,1500,200
3080000040,20140515T000000,495000,4,2,2050,4000,1210,840
1224049080,20140620T000000,925000,4,2,3140,10437,2040,1100
9547200835,20150402T000000,775000,3,1,2030,4080,1840,190
4363700365,20140801T000000,429000,4,2.5,2100,7920,1400,700
7683800212,20141218T000000,229000,3,1,1010,12705,1010,0
1324079054,20140922T000000,400000,4,1.5,1980,113691,1980,0
2141330360,20140729T000000,625000,4,2.25,2100,8290,2100,0
6450302546,20141021T000000,130000,2,1,840,6654,840,0
7972600676,20141104T000000,349000,3,1.75,1690,5080,1190,500
922059161,20140922T000000,365000,3,2,2140,26600,2140,0
2770601461,20150317T000000,487500,3,2.5,1810,1988,1350,460
8079010230,20140603T000000,475000,3,2.5,2600,7210,2600,0
5458800620,20140924T000000,685000,3,1.75,1650,8400,1470,180
5318101075,20140811T000000,960000,3,1.75,2460,4800,1230,1230
5430300120,20141113T000000,1.10E+06,5,2.25,4320,7620,2880,1440
1442700360,20150320T000000,428000,3,2.25,2600,15000,2600,0
5651010150,20150510T000000,435000,3,2.5,1930,5790,1930,0
6908200021,20141028T000000,769950,3,2,2190,5400,1260,930
2201500555,20140929T000000,385000,3,1,1420,10980,1200,220
255550150,20141118T000000,352000,3,2.5,2090,3002,1670,420
524069011,20140911T000000,622500,3,2.5,2290,14374,2290,0
7504010760,20150212T000000,660000,3,3,2470,11900,2290,180
1788800610,20140902T000000,105000,3,1,840,8400,840,0
7192800145,20141202T000000,420000,2,1,2100,4480,1400,700
5566100145,20140903T000000,499950,3,1.5,1360,11250,1360,0
2024059052,20140814T000000,975000,6,3,3420,22421,2270,1150
2436700540,20141001T000000,665000,3,2.75,1930,2960,1490,440
7200001608,20140701T000000,540000,4,2.5,2180,10140,1180,1000
5612100065,20140529T000000,400000,4,2,1670,12056,1670,0
7785380150,20141215T000000,469950,4,2.75,2720,6427,1650,1070
4178310040,20141016T000000,777000,4,2.5,3170,9900,3170,0
1708400555,20140625T000000,346500,2,1.75,1610,6300,1010,600
3629760330,20150311T000000,685000,3,2.5,2370,4950,2370,0
5469501830,20140624T000000,396500,3,2.5,2590,18980,2590,0
9829201058,20140504T000000,783500,3,2.5,2850,7130,1990,860
1931300175,20140702T000000,575000,4,2,1660,4800,1660,0
7237500360,20141106T000000,1.50E+06,4,4.25,5550,12968,5550,0
923000120,20150408T000000,515000,3,1.5,2200,7620,1130,1070
1446800995,20140805T000000,300000,3,2.5,2020,6628,1250,770
8732000410,20150114T000000,272000,3,1.5,1760,9600,1760,0
7303100210,20140527T000000,355000,4,2.25,1810,4970,1810,0
3348401622,20140731T000000,223000,3,2,1310,8440,1310,0
3793501400,20140820T000000,397000,4,2.5,3000,8584,3000,0
2872100385,20150318T000000,460000,2,2,1080,5000,1080,0
1689400150,20150206T000000,848000,3,2.75,2170,2738,1550,620
2887701251,20141007T000000,392800,2,1,740,4275,740,0
3528000040,20141001T000000,1.69E+06,3,3.25,5290,224442,4540,750
3528000040,20150326T000000,1.80E+06,3,3.25,5290,224442,4540,750
3787000120,20150122T000000,577000,3,2.25,2370,7878,2370,0
5693500760,20140707T000000,570000,3,1,1890,3330,1390,500
8892900180,20140617T000000,250000,3,1.75,1160,6134,1160,0
5458800330,20140904T000000,645000,4,1.75,1550,7350,1550,0
1560930450,20141024T000000,567500,3,2.5,3090,67082,3090,0
6699930360,20140722T000000,337000,4,2.5,2610,5240,2610,0
1423900580,20140625T000000,280000,3,1.75,1230,8250,1230,0
7338000730,20140728T000000,167000,3,1.5,1280,5547,1280,0
4364700730,20140530T000000,280000,2,1,1880,7560,940,940
7305300760,20141222T000000,317500,2,1.5,1220,8409,1220,0
2488200455,20140703T000000,405500,2,2.75,1350,1252,1120,230
318900120,20150123T000000,495000,4,2.5,2370,15336,2370,0
7504110330,20150128T000000,691000,4,3,3040,11651,3040,0
2222039011,20141103T000000,480000,5,1.75,2080,217800,2080,0
6021502300,20150211T000000,549010,2,1.75,1560,4141,880,680
3630110360,20150422T000000,750000,5,3.5,2980,5809,2980,0
1529300410,20150224T000000,365000,2,1,870,5689,870,0
2426049154,20150305T000000,412500,3,1.75,1660,10716,1100,560
6204420180,20140603T000000,425000,3,2.25,1870,9000,1440,430
8085400410,20150331T000000,920000,3,1,1410,9656,960,450
8731980880,20141222T000000,340000,4,2.25,2180,8000,1630,550
626049115,20141105T000000,405000,4,2.5,2620,8960,1520,1100
6388910040,20150324T000000,537100,3,2.5,2450,7051,1870,580
1748800120,20150318T000000,353500,4,2.5,3250,4650,3250,0
4077800582,20140912T000000,522000,3,1,1150,7080,1150,0
7202260210,20141010T000000,710000,4,2.75,2780,6978,2780,0
5095600360,20150312T000000,329950,3,1.75,1360,13320,1360,0
2607801120,20150420T000000,830000,5,2.5,2810,14207,1540,1270
9542200610,20150219T000000,800500,4,2.5,1780,11130,1780,0
8092000330,20140528T000000,168500,3,1,1100,10125,1100,0
7852020790,20140627T000000,490000,3,2.5,2230,5348,2230,0
6379500227,20141006T000000,579000,3,2.5,1710,1904,1140,570
6790200180,20140603T000000,600000,4,2.5,2620,9873,2620,0
1781500155,20140529T000000,445000,4,1.75,1990,4725,1190,800
3424069154,20140624T000000,362500,4,1.75,1450,8450,1450,0
1683500180,20140514T000000,234000,4,2,1630,9010,1050,580
1523300180,20140709T000000,321500,1,1,730,1942,730,0
1868901120,20140606T000000,660000,3,1.75,1980,3300,1140,840
822059101,20140925T000000,319000,4,1,1730,36356,1730,0
3421069020,20141020T000000,314000,3,1.75,1350,217852,1100,250
2769602710,20141006T000000,517950,3,2,1410,5000,740,670
6071300180,20140714T000000,525000,5,2.5,2360,10081,1180,1180
3211101010,20150211T000000,319500,3,1,1190,8450,1190,0
9471201175,20140506T000000,1.58E+06,4,3.25,3760,10920,2400,1360
2009003136,20140822T000000,325000,1,1,1220,12426,1220,0
7574910220,20140731T000000,795000,4,2.5,2920,32219,2920,0
1370801465,20140619T000000,850000,2,1.75,1590,5136,1320,270
1245500730,20141208T000000,1.01E+06,5,3.25,3510,10930,3510,0
2767603591,20140804T000000,475000,3,2.5,1320,1310,1320,0
8718500665,20140724T000000,375000,3,1,1610,11250,1090,520
106000395,20140624T000000,405000,3,1,1410,8053,1410,0
5538300120,20141015T000000,420000,4,2.5,2170,10500,1570,600
9405800040,20141016T000000,775000,4,1.75,1890,4800,1390,500
3630180450,20150407T000000,800000,4,2.75,3260,5000,3260,0
8126300610,20150401T000000,436800,3,1.75,2080,12714,1540,540
546000910,20141203T000000,620000,3,1.75,2040,4005,1740,300
2268000180,20150325T000000,230000,3,1,1250,9035,1250,0
3333002450,20140708T000000,165000,1,1,850,8050,850,0
3333002450,20150122T000000,490000,1,1,850,8050,850,0
6072000910,20140806T000000,480000,3,1.75,1600,8400,1600,0
4113800330,20140606T000000,570000,3,2.5,2400,6975,2400,0
3764500180,20150124T000000,615000,3,2.25,1870,4894,1750,120
1326049170,20140924T000000,280000,3,1,1720,9605,860,860
9238450210,20140623T000000,326000,3,1,1030,9834,1030,0
2436700666,20150216T000000,550700,2,2.25,1190,1499,1100,90
3043200035,20140701T000000,600000,2,1,910,2002,910,0
1424069044,20140910T000000,450000,3,1,1290,47044,1150,140
3037200141,20150309T000000,546000,2,2.25,1530,1324,1280,250
1323089107,20150121T000000,585000,3,2.5,2330,33750,2330,0
8024201714,20141117T000000,489000,3,1.75,2090,7667,1200,890
9829200325,20140617T000000,765000,3,2,1570,7000,1050,520
723039189,20150102T000000,519000,3,1.75,1560,26099,1560,0
1352300120,20140529T000000,262000,2,1,1500,4120,880,620
5101404351,20140702T000000,550000,4,2.75,2160,5005,1430,730
7211401485,20140606T000000,285000,2,1,780,5000,780,0
5631500967,20150204T000000,476000,4,1.75,2340,17541,1360,980
2425049061,20140825T000000,2.20E+06,3,2,3570,30456,2070,1500
7518503065,20140623T000000,335000,1,1,720,5100,720,0
1796000120,20141023T000000,510000,4,2,2990,102366,2990,0
1922059197,20140918T000000,291000,3,2.25,1860,13939,1860,0
7849201020,20140821T000000,335000,4,1.75,1950,13440,1950,0
1126049103,20140829T000000,415000,3,1.5,1860,9003,1490,370
65000085,20140708T000000,430000,3,2,1550,6039,830,720
9211510410,20150407T000000,270000,3,1.75,1610,6205,1210,400
2301400325,20150407T000000,760000,3,2,1810,4500,980,830
7132300540,20150508T000000,450000,2,2,1730,4248,1730,0
323059103,20150403T000000,425000,3,2.5,1230,23522,1230,0
4083306705,20141121T000000,725000,4,2.5,2130,3420,1730,400
1245001216,20140721T000000,700000,3,2.75,2190,11060,1610,580
293760210,20140826T000000,998000,5,4.5,4130,10404,4130,0
3782400040,20150508T000000,396000,3,2.25,1680,9766,1680,0
2726049164,20140605T000000,547000,3,2.5,1480,8381,1480,0
9183701085,20150415T000000,302000,4,1.5,1790,10200,1210,580
1623300325,20141021T000000,999000,5,3.5,2810,2700,1900,910
7987401010,20140703T000000,633000,4,2.5,2360,10000,1980,380
2131200065,20141211T000000,265800,3,1.75,1460,7361,1460,0
6141600065,20141016T000000,530000,3,2.25,2160,8114,1460,700
1562100220,20150501T000000,605000,6,2,2610,9132,1320,1290
7853300970,20150421T000000,489000,4,2.5,2170,4587,2170,0
8687800065,20140702T000000,305000,2,1,2160,12960,1360,800
1504800097,20140613T000000,513000,4,2.75,2020,7070,1010,1010
3630160610,20140716T000000,765000,4,2.5,2980,5000,2980,0
6852700477,20140916T000000,550000,2,1.5,1300,2970,990,310
2592220040,20140724T000000,974350,4,2.5,3090,10730,2420,670
7524950730,20150327T000000,653675,4,2.25,2280,7229,2280,0
1545807920,20141015T000000,245000,3,1.75,1260,8614,1260,0
3213200180,20150505T000000,700180,2,1.75,1530,4387,1020,510
3577300040,20150430T000000,510000,3,2.5,1830,8133,1390,440
2064800610,20141025T000000,390000,3,2.5,1610,10292,1190,420
7215730120,20150504T000000,606500,3,2.5,2170,5500,2170,0
629800540,20140909T000000,1.50E+06,4,4.25,5020,26319,5020,0
7575610760,20150507T000000,290000,3,2.25,1620,7772,1620,0
104500730,20150224T000000,115000,3,1.75,1080,7942,1080,0
8137500730,20140507T000000,500000,3,2.5,1940,37565,1940,0
9543000205,20150413T000000,139950,0,0,844,4269,844,0
3543900418,20140515T000000,580050,3,2.5,2360,4638,2360,0
8929000230,20150306T000000,550000,3,2.5,2010,2261,1390,620
2856100360,20150409T000000,465000,3,1,800,3060,800,0
6413600276,20150324T000000,354950,3,1,970,5922,970,0
8562720230,20141107T000000,980000,4,3.25,3720,7150,3720,0
3579000410,20140905T000000,500000,3,2.25,2010,7447,2010,0
3856904655,20150329T000000,667750,4,1,1430,4080,1430,0
8832900360,20150428T000000,735000,3,1.75,2250,11520,2250,0
4058200040,20140917T000000,361000,3,1.75,2130,8742,1330,800
4178501020,20150105T000000,276750,3,2,1620,12482,1290,330
8562790730,20140822T000000,760000,4,3.25,3140,3680,2310,830
455000841,20140829T000000,475000,2,1,870,7975,870,0
2154900330,20140827T000000,234000,4,2.5,1820,8217,1120,700
8159610150,20141117T000000,234950,3,2,1510,9153,1510,0
1545800730,20150222T000000,269950,2,1.75,1320,7540,1320,0
3904980360,20150112T000000,495000,3,2.5,1800,7318,1800,0
5100403321,20150318T000000,438000,2,1,1120,6380,1120,0
1326069151,20150224T000000,260000,3,1.75,2160,22702,2160,0
629410180,20141208T000000,697000,4,2.5,3220,6399,3220,0
7452500815,20150310T000000,212625,2,1,960,5000,960,0
6840701135,20141110T000000,593000,5,2.5,2640,4400,1840,800
5104512060,20141212T000000,410000,4,3,2430,7243,2430,0
2917200365,20140610T000000,445434,2,1,1470,7137,1020,450
5151600040,20140911T000000,200126,3,2.5,2040,15463,1340,700
2025700790,20140811T000000,290700,3,2.5,1670,6666,1670,0
7686204675,20150129T000000,248000,4,1,1010,7515,1010,0
126039305,20141013T000000,345000,1,1,540,10125,540,0
1930300915,20140820T000000,525000,3,1,1240,4800,800,440
9477100330,20141212T000000,400000,3,1.75,1510,8385,1510,0
513000665,20150408T000000,532000,3,1,1820,5750,1120,700
8581400450,20141028T000000,159995,2,1,1000,5026,760,240
1061500360,20141016T000000,287000,5,1.5,2040,11772,1030,1010
1373800330,20150420T000000,1.12E+06,4,2.5,3690,11191,2190,1500
2597520790,20150423T000000,765000,3,2.5,2310,11993,2310,0
2525300540,20141114T000000,185000,3,1.5,1090,9605,1090,0
3797000035,20140521T000000,430000,3,1,1150,3000,1150,0
3709600180,20140526T000000,346000,4,2.5,2100,3916,2100,0
3902300210,20140715T000000,607000,4,2.75,2150,16728,1240,910
2113700620,20140804T000000,417000,3,1.5,2500,6000,1730,770
5700003705,20140619T000000,930000,5,2,3530,9385,3530,0
34001540,20150423T000000,573300,2,1.75,1290,6600,870,420
2976800145,20150406T000000,260000,4,1.75,2010,10816,1410,600
7549801385,20140612T000000,280000,1,0.75,420,6720,420,0
9103000360,20141218T000000,825000,4,2.5,2180,4000,2180,0
7304300720,20140610T000000,307000,4,1,1150,8184,1150,0
1254200835,20140813T000000,595000,4,1.75,2000,5100,1130,870
8562700410,20150415T000000,528000,5,1.75,2780,7786,1390,1390
7558800620,20140822T000000,600000,2,1.75,1550,7764,1550,0
2122049038,20150302T000000,275000,2,1,2180,12875,1480,700
2397101075,20140702T000000,782000,2,1.5,1570,3600,1320,250
7695470120,20140808T000000,610000,3,2.5,2260,33042,1660,600
4083304700,20141125T000000,488000,3,1,1600,3200,1600,0
7857001225,20150403T000000,320000,3,1,1630,5000,930,700
4356200210,20150318T000000,153500,3,1,890,4810,890,0
3840700205,20150319T000000,414500,3,1,1350,9450,1350,0
7739100155,20140804T000000,750000,5,1.75,2850,11860,2850,0
1720069029,20150313T000000,349990,3,1,1350,165092,1350,0
921049141,20141201T000000,645000,3,2.25,3280,79279,3280,0
6909700205,20150406T000000,425000,2,1,1090,6000,1090,0
2725069164,20140805T000000,785000,4,2.5,2990,9374,2990,0
3523069060,20141107T000000,290000,3,1.75,1340,63597,1340,0
3523069060,20150401T000000,415000,3,1.75,1340,63597,1340,0
4302200790,20140814T000000,248500,2,1,720,5160,720,0
8899210610,20140723T000000,325000,3,2.5,2330,8627,1480,850
5631500905,20140723T000000,272925,2,1,1280,5728,1280,0
2770601530,20140826T000000,500000,2,2.25,1570,1269,1280,290
7831800411,20141020T000000,250000,4,1.75,1510,5500,1510,0
326049103,20140922T000000,470000,4,2.5,2470,8536,2470,0
1231001115,20141001T000000,440000,2,1,1190,3400,990,200
1041440360,20150105T000000,299999,4,2.5,1981,4828,1981,0
5001700040,20150327T000000,255000,3,1.75,1590,7810,1590,0
4037200665,20140813T000000,415950,3,1.75,1150,7700,1150,0
5249802520,20140805T000000,402000,5,2.75,2160,7200,1220,940
3585300410,20150424T000000,729000,3,1.5,1770,30689,1770,0
1624049087,20140917T000000,635000,2,2.5,2470,8840,1780,690
8121200530,20141008T000000,479000,3,2.5,1710,8998,1710,0
6705120540,20141222T000000,462370,2,2.25,1860,2670,1860,0
3353402390,20150501T000000,171500,3,1,1150,6480,1150,0
6190000035,20140715T000000,925000,5,3,3850,9457,2910,940
1313000220,20140513T000000,675000,5,3,3410,9600,1870,1540
921059161,20140623T000000,320000,4,1.5,1890,43560,1890,0
1823069279,20140520T000000,499950,5,3.5,3200,43560,3200,0
826059152,20141117T000000,435000,5,1,2170,65340,1670,500
4136930360,20140605T000000,359800,4,2.5,2390,6426,2390,0
7697870530,20140507T000000,239900,3,2,1410,7566,1410,0
1024000109,20140710T000000,295000,2,1,740,4459,740,0
5112800234,20150304T000000,380000,3,2.5,2150,25705,2150,0
8122101115,20150421T000000,435000,4,2.5,2180,6500,1410,770
6933600540,20140820T000000,508000,2,1,820,5040,820,0
6169900790,20140620T000000,2.40E+06,6,4.5,5480,10800,4430,1050
8001210120,20140916T000000,234500,4,2.5,1960,7875,1220,740
1931300870,20140528T000000,355000,2,1,1270,3200,960,310
8651441210,20140801T000000,230000,3,2,1710,5200,1030,680
1217000481,20150211T000000,345000,3,1.75,1930,9000,1150,780
7925100271,20140520T000000,430000,3,1.75,1200,4500,1200,0
1233100366,20141215T000000,500000,3,1.5,1680,17409,1680,0
9250900124,20150505T000000,378000,4,1,1300,6075,1300,0
7852050220,20140808T000000,345000,3,2.5,1540,3237,1540,0
9297301520,20150329T000000,410000,2,1.75,870,4000,870,0
8615800325,20140822T000000,750000,2,2.25,1890,5400,1610,280
9512500610,20150122T000000,485000,4,1.75,2050,8913,1330,720
4311700120,20150317T000000,105000,3,1,880,18109,880,0
1930301325,20150423T000000,1.03E+06,3,2.75,2780,4000,1960,820
3888100133,20141014T000000,360000,3,1,1160,10988,1160,0
9510900610,20141030T000000,294000,5,2.75,2300,7600,1400,900
5469502060,20141009T000000,400000,4,2.5,3140,12792,3140,0
2946002914,20150102T000000,325000,3,1.75,2300,6200,1150,1150
7856640180,20140904T000000,770000,3,2.5,2900,23550,1490,1410
6204200180,20140709T000000,443000,3,2.25,1920,8223,1920,0
5145100180,20140917T000000,325000,3,1,1150,7486,1150,0
3905090410,20150123T000000,760000,4,2.5,3120,8792,3120,0
5363200180,20140515T000000,640000,4,2,2560,7798,1890,670
8806900040,20150406T000000,415000,3,2,1410,4303,1410,0
3674400035,20140512T000000,156000,3,1,970,8580,970,0
6648150150,20140922T000000,996000,3,3.25,3620,8131,2730,890
9266700175,20150327T000000,415000,2,1,880,5100,880,0
3678900450,20140926T000000,615000,3,1.75,1900,3783,1110,790
9526600210,20141007T000000,717000,4,2.5,2540,4241,2540,0
631000040,20150331T000000,548000,4,1.75,1690,7794,1090,600
2026049122,20150401T000000,425000,3,1.5,1120,6653,1120,0
7523850150,20141027T000000,325250,4,2.75,2130,9339,1330,800
2326059080,20140801T000000,1.23E+06,3,2.5,3420,79279,3420,0
3211700035,20140625T000000,557500,3,1.75,1900,11165,1900,0
9365700385,20140714T000000,1.26E+06,4,2.5,3730,16950,3730,0
2734100736,20140910T000000,249950,3,3,1790,2003,1480,310
5029460180,20140916T000000,260000,4,2.75,2250,7345,1320,930
632000065,20140611T000000,1.99E+06,3,2.5,2880,13500,1520,1360
6821101765,20140621T000000,442900,4,1.75,1780,2788,890,890
7525050150,20140613T000000,475000,3,2.25,1580,12177,1200,380
2591780180,20140813T000000,365000,5,2.75,3260,9253,3260,0
4027700666,20150426T000000,780000,4,2.5,3180,9603,3180,0
4083300620,20150227T000000,930000,3,1.75,2460,4240,1230,1230
2303900035,20140611T000000,2.89E+06,5,6.25,8670,64033,6120,2550
6300500515,20140818T000000,350000,3,1,1020,4980,850,170
6163900952,20141218T000000,357500,3,1.75,1630,9403,1630,0
5631500369,20140521T000000,520000,4,2.5,3290,11446,3290,0
9558010230,20140509T000000,330000,4,2.5,1940,3784,1940,0
9407102245,20140604T000000,310000,3,2,1350,11150,1110,240
1430800191,20150213T000000,279000,3,1,1110,6060,1110,0
7635801371,20140725T000000,540000,4,1.5,2993,19400,2233,760
2215450150,20140530T000000,322000,4,2.5,2280,7200,2280,0
7146400040,20150312T000000,380000,5,3.25,3800,15500,2490,1310
7635800180,20150428T000000,320000,2,1,850,8400,850,0
114100297,20140922T000000,400000,3,1.75,1560,8456,1560,0
6145601510,20140822T000000,412000,3,1,1000,3844,900,100
9550200155,20150407T000000,887200,3,1,1400,5100,1400,0
8122100905,20140624T000000,395000,4,1.75,1540,5120,770,770
2025069025,20150429T000000,895000,4,3,3570,10273,2630,940
5595900210,20141119T000000,195000,2,1,800,5280,800,0
3157600325,20140620T000000,390000,3,1,1160,3750,1160,0
1432400120,20141111T000000,165000,3,1,1010,7690,1010,0
1432400120,20150508T000000,255000,3,1,1010,7690,1010,0
3811000230,20150316T000000,589000,4,2.25,2390,57599,2390,0
8665050770,20140619T000000,505000,3,2.5,1610,4611,1610,0
2976800360,20150223T000000,335750,3,3,2400,7260,1440,960
871001484,20150115T000000,719000,3,1.75,1800,5816,900,900
9528104910,20140909T000000,796000,4,3.25,2110,3000,2110,0
6929602721,20150408T000000,95000,2,1,960,7000,960,0
7203600530,20140529T000000,525000,3,3,2600,5238,1890,710
2206500395,20140515T000000,417000,3,1.5,1340,10224,1340,0
9277200180,20150420T000000,410000,3,1,1410,5000,980,430
6672900220,20150112T000000,984000,4,2.25,2390,12292,2390,0
1139000072,20150403T000000,325000,2,1.5,1180,834,1180,0
7229900975,20140507T000000,314950,3,1,1040,16986,1040,0
5631500594,20140923T000000,350000,3,2.25,1840,9929,1200,640
6861700156,20141027T000000,1.05E+06,4,2.25,2630,4000,1810,820
6388930620,20140710T000000,657000,4,2.5,2640,25038,2640,0
2887970040,20150408T000000,234950,2,2.5,1720,3132,1720,0
726049213,20150320T000000,410000,4,1.75,2320,7500,1220,1100
442000210,20150417T000000,625000,3,1.75,1840,5664,1270,570
5525400530,20150423T000000,706000,5,2.5,2890,15891,2890,0
6093000065,20140519T000000,485000,3,1.75,2200,7706,2200,0
7519000085,20141002T000000,685000,4,2.75,1660,5150,1280,380
2525310220,20141016T000000,242050,3,2.5,2170,9900,1690,480
3630120970,20140922T000000,770000,3,3.25,3310,5000,3310,0
1232001985,20150428T000000,557000,2,1.5,1450,3840,950,500
3422049158,20140711T000000,246000,3,1.75,1440,11325,1440,0
2501600150,20150310T000000,194000,4,2,1760,7700,1760,0
3326059254,20141124T000000,720000,3,2.5,3170,7187,3170,0
2624049103,20150325T000000,449000,2,1,1250,4576,1040,210
1525069095,20140619T000000,925000,4,2.5,3280,209088,3280,0
4077800455,20150326T000000,570000,4,3,2460,10401,1700,760
968000120,20141112T000000,395000,3,2,1470,10125,1470,0
629000704,20140729T000000,1.00E+06,4,2,1780,15648,1780,0
7129300175,20140701T000000,406000,4,1,1580,8475,1580,0
2887703186,20141023T000000,574800,3,1.5,1630,2946,1630,0
3832500790,20150420T000000,309000,4,2,2240,9240,1120,1120
2423069170,20140603T000000,770000,3,2.5,2430,54059,2430,0
225039029,20150317T000000,525000,3,1.5,1940,5625,1440,500
7852180650,20140718T000000,419000,3,2.5,1970,4058,1970,0
5422500220,20150411T000000,479000,4,2.5,2050,6705,1230,820
8649400790,20150113T000000,160000,3,1,1340,18552,1340,0
2473001210,20140916T000000,333000,4,1.75,1880,9880,1880,0
9485700175,20140930T000000,310000,2,1,860,12160,860,0
7694800180,20150205T000000,666000,3,2.5,2140,2868,1770,370
7936500109,20140725T000000,2.23E+06,3,3,3620,28064,2370,1250
104560540,20140917T000000,310000,4,2.75,2370,7320,2370,0
8161000220,20141227T000000,350000,3,2.5,1860,21876,1860,0
2487200775,20140512T000000,610000,4,3,2110,5000,1640,470
3905030330,20141008T000000,564800,3,2.25,1990,8501,1990,0
2881700522,20150421T000000,438000,3,2.25,1820,9150,1320,500
7856620870,20140813T000000,855000,3,2,3120,9400,1820,1300
179001046,20140508T000000,229000,3,2.5,1190,3000,1190,0
7562100065,20140725T000000,260000,3,2,1170,5450,1170,0
6891800360,20140918T000000,609000,3,2.5,2630,10131,2630,0
7211400760,20140528T000000,277000,4,1,1450,6250,990,460
123039207,20141209T000000,283000,4,2,2100,8160,1200,900
3426049124,20150318T000000,334000,2,1.75,1680,8367,840,840
4222500410,20150226T000000,267000,4,1.75,2000,7350,1100,900
6716700325,20140714T000000,385000,3,1,1030,3000,830,200
431500155,20141024T000000,640000,5,1.75,2020,6565,1120,900
626059220,20150506T000000,532500,4,2,2220,23750,2220,0
1328340540,20140523T000000,335000,4,2.5,1750,8476,1240,510
9269200120,20141030T000000,415000,3,2.5,1710,4920,1710,0
2225059170,20140917T000000,1.10E+06,6,3.25,3560,107362,2760,800
8835900220,20140828T000000,1.44E+06,2,2.5,2720,16637,2160,560
3192000085,20140807T000000,180000,3,1,1010,10215,1010,0
5104520610,20140714T000000,335000,4,2.5,1830,4500,1830,0
3530210180,20140723T000000,835000,4,3,4480,42717,4480,0
6840701225,20141003T000000,592500,4,1.5,2080,4400,2080,0
7979900210,20140808T000000,418900,3,1.5,1470,11112,1470,0
3343901183,20140709T000000,340000,3,1,1600,7324,1600,0
5249804825,20140702T000000,545000,3,2,1340,7200,1340,0
1234000704,20150403T000000,1.38E+06,5,3.5,3680,8680,3680,0
646910150,20150326T000000,183750,3,2.5,1770,3451,1770,0
9407001320,20140522T000000,295000,4,2,980,10640,980,0
9527000180,20140711T000000,625000,4,3,2530,5625,1470,1060
7225000155,20140609T000000,290000,4,3,2390,4500,2390,0
3622069103,20150123T000000,760000,4,2.5,3600,155509,3600,0
3345100286,20150219T000000,560000,4,2.5,3270,24750,1690,1580
203100910,20140923T000000,475000,5,2.5,2300,28480,2300,0
1257201530,20140513T000000,620000,3,1,1710,4050,1710,0
3083000365,20150508T000000,330000,4,2,1170,4000,1170,0
1245000865,20150408T000000,620000,3,2.25,1990,6256,1390,600
5104220120,20150107T000000,320000,4,1.75,1710,10480,1710,0
9828701608,20140915T000000,525000,3,2.5,1740,2350,1120,620
98020410,20140721T000000,802500,4,3.75,3320,8030,3320,0
3416601021,20140926T000000,569500,4,1,1960,3194,1960,0
3052700610,20141216T000000,850000,6,3.5,2820,5400,1620,1200
8818400155,20150405T000000,630000,3,1,1590,4080,1590,0
8562901830,20140805T000000,454800,4,2.25,2490,10720,1400,1090
8651430870,20150303T000000,177000,3,1,870,5200,870,0
721049207,20140619T000000,275000,3,1.75,1860,15681,1860,0
3463400330,20150416T000000,460000,3,2,2930,29136,2240,690
6003500995,20140617T000000,729000,3,1,1580,3840,1580,0
4139430910,20141021T000000,935000,4,3.25,4110,15488,4110,0
1232000915,20140509T000000,481450,3,2,1410,4800,1410,0
1954700365,20150317T000000,860000,3,2,2090,4190,1490,600
8074200175,20141106T000000,274000,3,1.75,1400,8364,1400,0
6821101762,20140605T000000,499000,3,3.5,1690,1432,1360,330
1774230180,20140917T000000,696500,5,2.25,3210,61419,3210,0
2051200506,20150413T000000,390000,3,1,1190,85226,1190,0
7851200040,20141216T000000,265000,3,1,960,9748,960,0
4027701326,20140709T000000,470000,4,2.25,2380,17199,1530,850
923049110,20150129T000000,168500,2,1,1020,7742,1020,0
3329500730,20141111T000000,220000,3,1.75,1290,8250,1290,0
5476800201,20141020T000000,295000,3,2,1830,17321,1100,730
4139910180,20150114T000000,1.48E+06,5,4,4770,31570,4770,0
7278100515,20140821T000000,1.30E+06,2,2.5,2910,19449,1940,970
9353300220,20150408T000000,285000,3,1,950,10723,950,0
5253300173,20141022T000000,294950,3,1,1160,8950,1160,0
98000150,20150102T000000,1.47E+06,4,4,4930,22093,4930,0
8608900205,20150403T000000,565500,3,1.75,1780,5850,980,800
2895200150,20141013T000000,230000,3,2,1410,10625,1410,0
621069057,20150323T000000,569950,4,3.5,2700,443440,2700,0
8712100760,20140924T000000,721000,2,1.5,1790,4250,920,870
255520180,20141218T000000,565000,3,2.5,4040,8653,2900,1140
1025059186,20140917T000000,438000,3,1.75,1990,9885,1030,960
797000330,20150402T000000,369900,3,1.75,2150,19127,1650,500
6403510410,20140905T000000,405000,4,2.5,1850,9136,1850,0
4324210120,20140527T000000,282000,3,2.5,1680,15711,1240,440
6381500450,20141104T000000,380950,2,1,1430,7819,1110,320
7609700065,20140630T000000,349810,3,1,960,8855,960,0
6192410760,20140526T000000,690000,4,2.5,2700,8810,2700,0
441000065,20150505T000000,653000,2,1.5,1290,5141,1050,240
9238510220,20141028T000000,526500,3,2.5,1860,43170,1860,0
293760150,20141017T000000,1.04E+06,4,3.5,4320,8490,3280,1040
3331001765,20140923T000000,335000,3,1,2130,3825,2130,0
1423069077,20140915T000000,570000,2,1.75,2870,102366,1770,1100
8123450450,20150310T000000,1.08E+06,5,3.5,3740,11340,3740,0
1795910360,20140922T000000,475000,3,2.5,2130,8022,2130,0
7883603965,20150212T000000,315000,4,2,1210,4250,1210,0
7937600087,20141209T000000,405000,6,2,2800,29985,1400,1400
3396820150,20140506T000000,562000,5,2.25,3040,8111,3040,0
3654800040,20150424T000000,295000,3,2.5,1570,6932,1570,0
8039900360,20140708T000000,383000,3,2.25,2090,15000,2090,0
3876540410,20150413T000000,242000,3,2.25,1690,7292,1250,440
7230300610,20150403T000000,352500,3,1.5,1470,17577,1470,0
1180005280,20140723T000000,239950,4,1,1460,6000,730,730
714000210,20140903T000000,998000,4,2.5,3030,6820,2530,500
3902100205,20150417T000000,515000,3,1.75,1190,4500,1190,0
9285800790,20150406T000000,590000,5,1,1840,6710,1840,0
1922000180,20150402T000000,1.16E+06,4,3.75,3560,13959,3560,0
6121800065,20141104T000000,289000,3,1.75,1580,9750,1580,0
4427100145,20150323T000000,424000,3,1.5,1230,7200,1230,0
7227800065,20141016T000000,199000,4,2,1440,9477,1440,0
7853220330,20141006T000000,730000,4,3.5,4420,7902,3350,1070
1430800258,20140527T000000,244000,3,1,910,5250,910,0
7454001075,20140618T000000,240000,2,1,670,10920,670,0
4038500210,20150422T000000,797000,4,2.75,2650,8610,2650,0
2310040230,20140520T000000,350000,4,2.25,2220,6953,2220,0
1727500230,20141119T000000,415000,3,1.75,1640,6435,1190,450
3874900205,20150414T000000,378510,2,1,770,5185,770,0
269000085,20140708T000000,1.20E+06,4,3.5,3960,6654,2850,1110
7972602510,20141006T000000,379900,2,1.5,1140,7620,1140,0
7202340720,20140520T000000,620000,3,2.5,2480,9041,2480,0
1254201106,20140829T000000,524500,3,1.5,1580,3172,900,680
7349650330,20140609T000000,270000,4,2.75,1990,7252,1270,720
9211520150,20140528T000000,236000,4,2.25,1830,9485,1200,630
3438501020,20141105T000000,308500,2,2,840,14564,840,0
5460900120,20141208T000000,989900,5,2.25,3320,11350,1660,1660
7459810210,20141002T000000,299000,4,2.25,2050,26000,2050,0
4032500035,20140913T000000,295000,2,1.75,1560,43748,1560,0
8018600880,20140611T000000,110000,2,1,800,15000,800,0
2807100156,20140703T000000,295950,2,1,1190,6200,1190,0
2112700845,20140528T000000,270000,3,1.75,1300,4127,650,650
3022079087,20140521T000000,712000,4,2.5,3400,247421,3400,0
2767603577,20150506T000000,475000,2,1.5,1170,1250,1170,0
3955900220,20150317T000000,410000,4,2.5,2510,5258,2510,0
3761100276,20150313T000000,588000,4,2.25,2510,19550,1810,700
6979970150,20141212T000000,420000,3,2.5,2390,3903,1970,420
8857640410,20150119T000000,355000,4,2.25,2200,3404,2200,0
6052400175,20140623T000000,446000,2,1,2550,21675,1610,940
2525059077,20140520T000000,765000,4,2.25,2560,12100,1760,800
5040800120,20140527T000000,967500,3,3.75,3250,5797,2370,880
8682262380,20140905T000000,381000,2,2,1340,4447,1340,0
2521059060,20150501T000000,490000,3,2.25,2840,107157,2840,0
7526800040,20140827T000000,716000,4,2.25,2480,9780,1900,580
4104900150,20150414T000000,605000,5,3.5,3060,8862,3060,0
5409800120,20140919T000000,312200,4,2.5,2910,8596,2910,0
2423039122,20140718T000000,327000,4,1,1900,9000,1290,610
6143600555,20140609T000000,229950,4,1.75,1300,21000,1300,0
5029451010,20140711T000000,160000,3,1.5,1480,7000,1000,480
6649500040,20140812T000000,255000,3,1,1250,9472,1250,0
2922700155,20141125T000000,530000,4,2.5,2000,4700,1220,780
422049203,20141024T000000,239000,3,1.5,1330,6540,900,430
5412200180,20150228T000000,285000,3,2.25,1840,6214,1270,570
6338000032,20140827T000000,537000,4,2,1560,7104,1140,420
8161000210,20140814T000000,530000,3,2.5,3150,21893,3150,0
5028600360,20140725T000000,213675,3,2.25,1560,6013,1560,0
1952000150,20140506T000000,530000,5,2.5,2910,9636,1690,1220
9510920040,20150305T000000,780000,3,2.5,2940,15875,2940,0
9834200411,20141113T000000,390000,3,1,950,3621,950,0
2960900040,20140521T000000,450000,2,1,1200,4000,1070,130
1112000035,20150311T000000,420000,2,1,1000,5375,1000,0
1982200790,20150127T000000,550000,3,2,1490,3880,1490,0
3361401011,20150219T000000,110000,2,1,600,6120,600,0
1695900150,20140528T000000,700000,2,1.75,2320,5500,1720,600
1240100065,20150424T000000,807500,4,2.5,3190,24170,3190,0
421049254,20141002T000000,179000,2,1,990,8760,990,0
9412400220,20140710T000000,1.61E+06,4,2.75,5470,18200,3730,1740
1726069060,20150409T000000,655000,4,2.75,2890,46609,2890,0
6150200040,20150316T000000,472500,3,2,1790,6800,1240,550
7300400150,20141027T000000,299000,4,2.5,2350,6958,2350,0
2621730220,20140514T000000,740000,4,2.5,3430,10157,3430,0
4122700040,20141010T000000,860000,3,1.75,2600,15064,1700,900
9161100730,20140701T000000,620000,4,3,2130,6325,1440,690
9357001010,20141010T000000,410000,3,1.75,1660,5987,960,700
8643000210,20150304T000000,343000,5,3.5,2473,9282,2473,0
9828701739,20140617T000000,465000,2,2.75,1430,1425,995,435
3204400040,20150304T000000,273950,3,2.25,1570,3109,1570,0
3342103282,20141017T000000,825000,2,1,1240,42247,1240,0
2420069604,20150330T000000,255000,3,2.5,1720,6200,1720,0
8078050040,20140908T000000,250000,3,2,1140,11161,1140,0
7663700150,20140822T000000,635000,4,3.25,2690,7200,1720,970
4167700210,20140826T000000,240000,3,1.75,1520,9600,1520,0
2423020180,20150507T000000,670000,4,2.25,2040,7031,2040,0
2824600180,20141024T000000,713414,3,2.5,2830,6000,1730,1100
2013801086,20150513T000000,245000,3,1.5,1340,7391,1340,0
4022900150,20141209T000000,600000,4,2.5,2520,10850,1680,840
3295710150,20141015T000000,270000,3,2.5,1660,5550,1660,0
9476200035,20141120T000000,190000,2,1,880,6900,880,0
1937300180,20140606T000000,435000,3,2,980,5000,980,0
4226900211,20141023T000000,560000,4,1,1360,5814,1360,0
424069018,20140905T000000,998000,3,3.75,3710,34412,2910,800
6684500040,20141202T000000,725000,3,1,940,8377,940,0
8948500065,20141124T000000,210000,2,1,970,8874,970,0
1972201960,20140825T000000,513000,3,2.25,1500,1312,1500,0
7436200040,20141105T000000,290000,5,2.5,2780,9652,1390,1390
3835502815,20140925T000000,1.26E+06,3,2.5,3110,9930,1640,1470
8856960540,20140620T000000,330000,3,2.25,1860,11227,1860,0
1432400065,20140605T000000,189000,3,1,1010,7560,1010,0
4370700065,20150504T000000,907500,3,2.25,2850,6281,1900,950
1725079047,20141104T000000,410000,3,2.25,2280,200811,2280,0
7855000325,20150220T000000,1.05E+06,4,3,3080,10757,3080,0
2826049098,20141204T000000,622100,4,2.5,2280,14290,1510,770
3750603685,20140723T000000,250000,3,1.5,2030,14400,1310,720
1797500230,20140818T000000,1.18E+06,4,3,2570,4000,1750,820
3459600330,20150209T000000,925000,3,2.75,3640,10300,2060,1580
546001020,20150218T000000,554000,3,2,1760,4046,960,800
7227502507,20140709T000000,545000,3,2.5,2760,17377,2760,0
326049060,20140909T000000,660000,3,2.5,2650,11250,2650,0
1525059261,20150505T000000,1.90E+06,5,4.5,5160,44315,5160,0
7399300120,20140502T000000,260000,4,2,1480,8625,1480,0
7812801590,20141030T000000,219900,3,1,860,6664,860,0
6699930530,20150325T000000,373500,4,2.5,2610,4978,2610,0
1523069151,20140711T000000,380000,2,1,1470,81021,1470,0
7525950180,20140701T000000,1.06E+06,4,2.5,4570,16015,4570,0
3623500408,20150330T000000,2.60E+06,3,3,3410,16015,2220,1190
7312200120,20140723T000000,450000,3,2.25,1760,10013,1760,0
4123810210,20140716T000000,379950,3,1.75,2040,12065,2040,0
3902600150,20140820T000000,834800,3,3.5,3470,4171,3470,0
9126101201,20140916T000000,365000,2,1,680,4800,680,0
2423029009,20140617T000000,465000,2,2,1494,19271,1494,0
3300701285,20140730T000000,452000,3,1.5,1250,4000,1250,0
2391601445,20150304T000000,840000,3,3,3570,6250,2710,860
7625701175,20141103T000000,465000,4,2,2000,6250,1480,520
1843130360,20150507T000000,295000,3,2.5,2030,4867,2030,0
6150700264,20150224T000000,396000,3,1,1390,6160,1390,0
3226049080,20150224T000000,397000,2,1,1030,12350,1030,0
7889602020,20140819T000000,240000,3,1,1280,9000,1280,0
3613600150,20150105T000000,300523,3,2.5,2370,6840,2370,0
3599600276,20141106T000000,215500,3,2,1380,9000,1380,0
2193320210,20140805T000000,552500,5,3,2320,7229,1370,950
9117100040,20140828T000000,375000,5,1.5,2050,9360,1520,530
522039106,20140606T000000,160000,3,1,1210,103237,1210,0
2424059018,20140612T000000,1.07E+06,4,2.5,3270,35445,3270,0
1959700540,20141104T000000,952000,3,2.5,2450,4400,1800,650
2767900355,20140627T000000,523460,5,1.75,1890,5000,1090,800
1310820150,20140812T000000,305950,4,2.5,2007,4968,2007,0
6802200230,20150209T000000,220000,3,2.5,1430,9044,1430,0
3421049044,20150409T000000,289000,2,1.75,2056,52333,1048,1008
4036400040,20150209T000000,648000,5,2.5,2210,10772,1430,780
1193000450,20150410T000000,825000,5,1.75,2330,6000,2080,250
3819800580,20141204T000000,400000,4,2,2070,10800,2070,0
6873000120,20140512T000000,420000,2,2.5,1480,1369,1480,0
9830200230,20150120T000000,389000,2,1.75,1160,4848,1160,0
2301400276,20140908T000000,865000,4,2.5,2520,4950,2520,0
5153200150,20141203T000000,345000,2,1,1770,16660,1220,550
1465400120,20150326T000000,700000,3,2.5,3110,123710,2430,680
8121200620,20150416T000000,550000,3,2.5,1680,10455,1680,0
324000530,20140708T000000,201500,3,1,1320,5000,1320,0
324000530,20150323T000000,459000,3,1,1320,5000,1320,0
1328320760,20141218T000000,327000,3,2.5,1810,7350,1310,500
3626039268,20140516T000000,540000,1,1,1140,6700,1140,0
3585900665,20140606T000000,805000,5,2.5,4600,19831,2300,2300
7625701830,20141023T000000,521000,3,2,1840,6000,1840,0
3524049042,20140527T000000,375000,3,1.5,2000,7294,1520,480
9211500150,20150117T000000,235000,3,1.75,1480,6592,1080,400
7760400880,20140929T000000,240000,4,2.5,2040,11841,2040,0
686450330,20140915T000000,575000,4,2.25,2060,12155,2060,0
2617900035,20141201T000000,1.52E+06,6,3.5,3720,11690,3720,0
7936800150,20140702T000000,394500,4,2.5,3002,6042,3002,0
8651441750,20140515T000000,174950,3,1,1060,5200,1060,0
3664500133,20141117T000000,383000,4,2,1830,21183,1060,770
1823069213,20140505T000000,249950,3,2,1550,15040,1550,0
7525211520,20150318T000000,431000,3,2.5,1690,2752,1690,0
4034900065,20140530T000000,459900,3,1.75,2580,11000,1290,1290
2558690150,20140707T000000,475000,5,2.5,2510,8050,1490,1020
5016001325,20140516T000000,605000,3,2.25,1290,2500,1290,0
1311800220,20150218T000000,234950,4,2,1450,7560,1450,0
4128000020,20140613T000000,419000,4,2.5,2690,7947,2690,0
1125059071,20140522T000000,910000,4,3.25,3340,10890,2240,1100
3274850130,20141203T000000,392000,4,2.5,2600,8921,2600,0
1925069099,20140825T000000,915000,3,2.5,3140,9808,2500,640
3395050050,20141114T000000,630000,3,3.25,3800,13995,3800,0
4058800500,20140710T000000,416100,4,1.75,2320,5490,1160,1160
1311600020,20140821T000000,285000,4,2.5,2360,7350,1440,920
8679400130,20150506T000000,353000,4,1.5,1100,9600,1100,0
9485760050,20140826T000000,297950,3,2,1390,5127,1390,0
4055700920,20141007T000000,750000,2,2,2180,21392,2180,0
8673400177,20150402T000000,525000,3,3,1730,1074,1730,0
3500100089,20140715T000000,495000,5,1.75,2760,18112,1510,1250
8730600050,20140825T000000,710000,3,1.75,2430,11448,1620,810
3755100005,20140730T000000,310000,3,2,2010,12950,2010,0
8651442880,20140516T000000,205000,5,1.75,1730,5200,1050,680
1720069075,20150508T000000,530000,3,3,2450,211266,2450,0
4309700190,20140724T000000,725000,4,2.5,3300,28433,3300,0
3972300169,20141125T000000,195000,2,1,720,9520,720,0
6817810190,20140701T000000,401000,3,2,1240,11172,1000,240
7855400630,20140922T000000,1.03E+06,5,2.5,3050,8200,1650,1400
1163400020,20150403T000000,251000,3,1.5,1590,21600,1590,0
7214400095,20141027T000000,667500,3,2,2040,4841,1020,1020
6799300130,20140623T000000,300000,4,2.5,1840,5550,1840,0
4376800010,20140814T000000,610000,4,2.25,1960,9021,1960,0
2125059163,20140703T000000,1.04E+06,4,5,4110,43560,4110,0
1770000460,20141203T000000,430000,3,2.25,1830,19965,1400,430
1125079088,20150402T000000,455000,2,1,1330,92782,1330,0
1842300050,20140702T000000,600000,5,2,2190,9072,1110,1080
9828702156,20150219T000000,638000,3,3.25,1720,1587,1410,310
7625702155,20141014T000000,561000,3,1.75,1710,5000,1360,350
585000095,20141216T000000,625000,3,2.5,2180,5000,1240,940
3903200050,20150324T000000,263950,3,1.75,1700,11613,1180,520
8563080020,20141028T000000,740000,3,2.5,2960,9350,2960,0
5379805475,20140609T000000,234999,3,1,1330,8912,1330,0
9558050780,20150414T000000,380000,4,2.5,1940,3200,1940,0
3782400190,20140812T000000,329500,3,2.25,1500,9656,1170,330
1423069063,20140711T000000,464950,4,2.5,2230,64438,1230,1000
2926049504,20150402T000000,500000,3,2.25,1700,9008,1340,360
126039252,20140709T000000,415000,4,1.5,1840,11367,1840,0
2622029073,20140905T000000,437500,3,2.25,2100,205603,2100,0
9187200345,20140709T000000,599000,7,2.5,2580,5750,1880,700
2621760480,20141014T000000,367000,4,2.5,2350,8182,2350,0
7986401205,20150425T000000,530000,2,1,760,3000,760,0
4447300137,20140604T000000,989000,5,3.5,3280,4000,2440,840
2147300050,20140822T000000,462600,3,2,1320,4000,1020,300
4458300190,20150424T000000,875000,3,2.5,1690,10592,1690,0
3751606785,20140722T000000,335000,3,2.25,2060,47318,1600,460
4287400005,20140731T000000,393000,4,2,1450,5456,1450,0
6613000715,20140721T000000,1.34E+06,4,3,2760,4905,1840,920
7702010050,20150323T000000,590000,3,2.5,2830,5788,2830,0
2770602360,20150421T000000,671000,4,2.75,1890,1475,1200,690
9551201155,20140728T000000,925000,3,3.25,2610,4500,1660,950
1823049242,20141006T000000,245000,3,2.25,1900,7250,1250,650
1513800170,20150402T000000,392500,3,1,930,6572,930,0
4027700396,20140828T000000,505000,4,2,2730,12000,1410,1320
7203210170,20140819T000000,702000,4,2.5,2650,6240,2650,0
3013300895,20140718T000000,337000,2,1,1010,4000,1010,0
5608010050,20141229T000000,920000,4,2.5,3550,10233,3550,0
6370000005,20140827T000000,495500,3,1.75,2130,6360,1720,410
1922059102,20140924T000000,245000,2,1.75,1840,7230,1570,270
6738700005,20140529T000000,395000,2,1,1320,1824,1320,0
1138020020,20150217T000000,335000,3,1,990,6315,990,0
5437820250,20141110T000000,187000,2,1.75,1020,10346,1020,0
7923700020,20141121T000000,450000,4,2,1570,7320,1570,0
293600080,20140617T000000,280000,4,2.25,1930,7207,1360,570
3627800050,20140715T000000,1.38E+06,5,4,3760,22763,1910,1850
4047200950,20140609T000000,265000,2,1,1000,31505,1000,0
5458800425,20150423T000000,795000,3,1.75,1930,9600,1930,0
2887700826,20140529T000000,510000,3,1.5,2240,3800,1370,870
7856700920,20140628T000000,699900,4,2.5,2190,11500,1430,760
627300190,20140812T000000,839000,4,2.75,2400,12469,1760,640
5634500182,20140715T000000,396000,4,1.75,1970,12409,1220,750
2472950170,20150507T000000,365000,3,2.25,2860,8458,2860,0
9557300190,20140711T000000,440000,3,2.25,1900,7225,1220,680
2314300170,20141104T000000,405000,4,2.5,2090,6667,2090,0
7547300050,20140515T000000,295000,3,1.5,850,2500,850,0
7985400089,20140515T000000,275000,4,2.5,1840,1562,1400,440
322059049,20141003T000000,295000,2,1,820,288367,820,0
2344300170,20140815T000000,1.50E+06,5,3.5,4370,12240,3270,1100
11501330,20140902T000000,795000,3,3.5,3190,10223,2560,630
7300200290,20140506T000000,650000,5,3.5,3480,36615,2490,990
4331000595,20140910T000000,260000,3,1,1690,13184,1690,0
7853340660,20140806T000000,382000,2,2.5,1650,2710,1650,0
7525570020,20150421T000000,790100,4,2.5,2590,9341,2590,0
6306100190,20140521T000000,220000,4,2.5,2160,8005,2160,0
1424059142,20140605T000000,799000,4,3.5,3500,8547,2500,1000
5700003810,20140723T000000,1.48E+06,4,2.25,3920,7200,3120,800
2595650170,20140609T000000,367300,4,2.75,2190,14937,2190,0
9530100225,20150409T000000,805000,4,2,1890,4500,1490,400
3856901760,20141215T000000,730000,2,1,1860,3400,1010,850
1387301350,20141123T000000,402000,3,2,1720,7704,1160,560
7974200822,20140530T000000,750000,4,2.75,2600,4674,1560,1040
8039900130,20140730T000000,458000,3,1.5,1570,12196,1570,0
4139460290,20140828T000000,898000,3,2.5,3530,9753,3530,0
8078520280,20150323T000000,308000,4,2.5,1960,5642,1960,0
8691510290,20150506T000000,385000,3,2.5,2230,8296,2230,0
4217400680,20141006T000000,1.02E+06,4,3,2720,4800,1790,930
1336800670,20141229T000000,1.43E+06,5,3,2840,6240,2440,400
1545801850,20140723T000000,240000,3,1.75,1260,7362,1260,0
6386600170,20141001T000000,217000,3,1.5,1860,8505,1860,0
1373800170,20140630T000000,972000,4,1.75,2010,6300,1610,400
1394300005,20140507T000000,361280,2,1,820,6400,820,0
7011201087,20140804T000000,385000,3,1.75,1220,1450,620,600
1623069071,20141105T000000,475000,3,2.5,2220,60984,2220,0
1982200480,20150402T000000,724950,4,2.5,2860,3638,1720,1140
8089510170,20141027T000000,935000,5,4.5,4230,9701,4230,0
5560000480,20140908T000000,169950,3,1,840,8470,840,0
6308000010,20141208T000000,585000,3,2.5,2290,5089,2290,0
6308000010,20150423T000000,585000,3,2.5,2290,5089,2290,0
4136960010,20150327T000000,480000,5,3.5,3480,12821,2890,590
8665900168,20141105T000000,635000,4,2.5,4260,36360,4100,160
8691510170,20150204T000000,368750,3,2.5,2230,5717,2230,0
9187200095,20141202T000000,432500,6,2,3080,5500,3080,0
4221260050,20140903T000000,589000,3,2.5,2250,4337,2250,0
8562740480,20150414T000000,840000,4,3.25,3160,6327,2280,880
6806100250,20150305T000000,316500,3,2.5,1770,3873,1770,0
7853300280,20150213T000000,536000,4,2.5,2880,8833,2880,0
6446200190,20150420T000000,563750,4,2.75,2690,25000,1750,940
4222310010,20141226T000000,152500,4,1,1730,7350,1730,0
4222310010,20150420T000000,267950,4,1,1730,7350,1730,0
4054550010,20150413T000000,1.64E+06,5,4,4780,118047,4780,0
1440700190,20140623T000000,269950,4,2.5,2540,8400,2540,0
5569620050,20140721T000000,731688,4,3,2630,5772,2630,0
1840200080,20141203T000000,240000,3,1.5,1890,9000,1190,700
9268200585,20140903T000000,555950,2,1,1220,5040,1220,0
7454000585,20150427T000000,289000,2,1,710,6300,710,0
7504021310,20140506T000000,525000,3,2.5,2970,11985,1770,1200
7504021310,20141204T000000,745000,3,2.5,2970,11985,1770,1200
8024201795,20141117T000000,397000,2,1,1000,7664,1000,0
8638500170,20150422T000000,233000,3,1,1980,8505,1030,950
5437400630,20141016T000000,625000,4,2.25,1920,8259,1920,0
9264000010,20140729T000000,535000,3,2,2740,23505,2740,0
3832600080,20150504T000000,270000,3,2.25,1740,7345,1380,360
9477001350,20140722T000000,360000,3,1.75,1300,7770,1300,0
809001060,20140513T000000,1.11E+06,4,1.5,2740,4000,1930,810
2771604120,20141111T000000,970000,4,1.75,4060,4000,2890,1170
9541800190,20141010T000000,915000,5,2.5,3490,18850,1840,1650
4038400130,20140711T000000,412000,4,1.75,1430,10500,1130,300
1253200290,20150212T000000,265000,4,1.75,1860,9112,1110,750
2558650130,20140916T000000,426000,4,2.25,2120,7700,1490,630
8732190170,20141210T000000,266000,4,2.25,1860,12693,1140,720
1703400585,20141215T000000,325000,3,2,2330,4950,1430,900
1250202115,20150120T000000,615000,3,1.75,1670,5100,990,680
9264911150,20150423T000000,310000,3,1.75,2130,7140,1580,550
7696300080,20140914T000000,340000,4,1.75,1900,7313,1900,0
1931300010,20150501T000000,562500,2,1,1170,2800,1170,0
2771602425,20140721T000000,447000,2,1,980,1600,980,0
2210500010,20140930T000000,2.45E+06,7,4.25,4670,23115,4670,0
1253200170,20140520T000000,250000,4,1.5,2500,6300,1500,1000
6646200420,20150102T000000,633000,4,2.5,2020,8044,2020,0
8822901024,20150423T000000,310000,3,2,1290,886,1290,0
1323089056,20141110T000000,439000,2,1.75,1620,113862,1620,0
3629950010,20140820T000000,470000,3,3.25,1710,2381,1360,350
7889100020,20150414T000000,270000,3,2.5,1720,8550,1720,0
7212680020,20141219T000000,299500,3,1.75,1820,8813,1820,0
2222049108,20140918T000000,227000,3,1,1130,10018,1130,0
7129303070,20140820T000000,735000,4,2.75,3040,2415,3040,0
6744700424,20140626T000000,537000,3,3,2410,7479,2410,0
1727000680,20141209T000000,699000,4,2.5,2440,14470,1660,780
3226049134,20140902T000000,330000,2,1,800,4533,600,200
1760600009,20140829T000000,229000,3,1,1030,7800,1030,0
3352400351,20141121T000000,200000,3,1,1480,5600,940,540
8563000250,20140812T000000,522500,3,1.75,1710,9707,1710,0
1370800680,20150324T000000,1.30E+06,3,2.75,3450,5350,2590,860
2726049034,20141110T000000,2.00E+06,3,3.25,2610,16387,2610,0
3623059027,20141022T000000,200000,2,0.75,780,55764,780,0
3205500020,20150408T000000,352000,3,1.75,1260,7200,1260,0
8924100305,20150325T000000,855000,4,3,2590,6250,2240,350
7524300020,20140820T000000,267000,3,2.5,1580,12250,1580,0
2436200715,20140506T000000,484000,2,1.75,1660,6000,1160,500
5469501850,20140629T000000,402000,4,2.75,2950,15540,2120,830
9187200275,20150420T000000,905000,4,2.25,2240,5000,1770,470
274000020,20140808T000000,274000,4,1.75,1940,7500,1720,220
6151800225,20150409T000000,475000,3,1.75,1850,26445,1850,0
8924600020,20141114T000000,1.54E+06,4,4.5,5770,10050,3160,2610
4003000285,20140504T000000,628000,4,2,2280,6010,1140,1140
290000095,20140617T000000,675000,6,1.75,2740,6360,1370,1370
1565930130,20141104T000000,429900,4,3.25,3760,4675,2740,1020
6123000225,20140625T000000,260000,3,1.5,1580,8184,1140,440
4385700285,20140903T000000,690000,3,1.75,1600,4400,1030,570
2469000010,20150323T000000,1.08E+06,4,2.25,2100,12172,2100,0
5205000020,20150409T000000,360000,4,2.5,2610,7333,2610,0
461002890,20140619T000000,499000,3,1.75,1840,5000,920,920
1823059030,20140818T000000,159000,3,1,1320,6534,1320,0
8848400020,20150327T000000,430000,3,1.75,1540,8100,940,600
4122500095,20150413T000000,1.05E+06,5,2.75,2520,18625,1660,860
2597300020,20141113T000000,725000,5,2.5,3780,20000,1890,1890
2788400020,20140710T000000,150000,3,1,1200,9527,1200,0
7856610130,20140721T000000,840000,4,2.25,2720,8712,2720,0
3303860460,20150415T000000,499000,4,2.5,3100,5700,3100,0
2112700920,20141014T000000,285000,3,1.75,1630,4000,1100,530
6880210020,20150308T000000,340000,4,2.5,1910,7201,1210,700
6139100101,20150505T000000,405100,4,2,1580,7300,1580,0
7202330920,20140807T000000,464000,3,2.5,1690,4898,1690,0
8146300020,20140529T000000,723000,4,2.25,1960,8680,1290,670
7418000130,20141211T000000,430000,8,3.25,4300,10441,2800,1500
9276200635,20150430T000000,645000,3,1.75,1840,4255,940,900
251610020,20150508T000000,1.58E+06,4,2.75,3480,19991,2630,850
8825900020,20140811T000000,925000,5,3,2710,4200,1890,820
3856903495,20140709T000000,759000,4,1.75,2100,4750,1340,760
6382500020,20140805T000000,690000,4,2,1760,7800,1760,0
522059352,20150326T000000,358800,4,2.5,2155,8140,2155,0
1778500595,20150413T000000,683000,5,1.5,1720,4000,1520,200
4083300595,20141208T000000,650000,3,1,1430,4240,1430,0
2100200020,20141209T000000,288000,5,2.75,2790,4807,2140,650
2597500840,20140707T000000,209950,3,1.5,1180,7300,1180,0
7935000595,20141008T000000,939000,3,3.5,2450,9248,1960,490
7857003318,20140816T000000,320000,3,1,1330,5850,930,400
9211520020,20140822T000000,283748,3,2.25,1940,9560,1940,0
1460000080,20140731T000000,370000,3,2.25,1600,7620,1280,320
3444120130,20150327T000000,399950,4,2.75,3210,41689,1610,1600
908000010,20141212T000000,360000,5,2.5,2880,6902,1680,1200
3123800080,20141112T000000,365000,2,1.5,1160,8060,1160,0
8641500345,20141219T000000,396900,3,2,1360,3120,1360,0
3717000250,20150422T000000,321000,3,2.5,2014,4500,2014,0
7697860130,20150106T000000,245000,3,2,1440,7008,1440,0
9169100130,20141007T000000,502000,2,1,1570,4704,1570,0
2944500470,20140605T000000,257000,4,2.75,2330,7642,1800,530
7424110130,20140515T000000,423000,4,1.75,1880,7303,1010,870
4037000635,20150327T000000,485000,4,2.25,1850,9911,1850,0
2141500020,20141217T000000,500000,4,2.5,2230,8560,2230,0
952000725,20141021T000000,442000,2,1,990,4313,990,0
9550204620,20150512T000000,475000,3,1.75,1720,3825,1720,0
6891800250,20150406T000000,625000,4,2.25,3230,9935,3230,0
7812801850,20141015T000000,194000,3,1,1180,6050,820,360
7504180170,20140707T000000,410000,3,2.25,1450,19206,1450,0
686800080,20140612T000000,1.03E+06,4,2.5,2370,10858,2370,0
7853300290,20150324T000000,490000,4,2.5,2570,6157,2570,0
7905380380,20141209T000000,348500,4,1.75,1870,7575,1480,390
1972202320,20150427T000000,380000,3,1,1220,3000,1220,0
1710400007,20141211T000000,660000,3,2,1770,2150,1770,0
2985800225,20150401T000000,525000,3,1,1500,6800,1500,0
1721059069,20140717T000000,235000,3,2,1110,8724,1110,0
7852160170,20150422T000000,1.21E+06,4,3.75,4980,18069,4980,0
626049102,20150324T000000,397950,4,1.75,2360,8116,1180,1180
7349660050,20141118T000000,268000,3,1.75,1600,7711,1600,0
1231000660,20140521T000000,525000,3,1,1450,4000,950,500
9558900010,20141006T000000,549950,3,2.5,2680,5860,2680,0
3897100170,20140827T000000,370000,3,1.75,1150,6600,1150,0
1150700170,20140926T000000,299000,4,2.25,1870,6693,1870,0
2769600305,20150115T000000,715000,6,2.75,3400,5000,2860,540
3876001330,20150424T000000,430000,4,1.5,1810,7200,1810,0
984220290,20150210T000000,345000,3,1.75,1860,7191,1260,600
3616600250,20140527T000000,1.60E+06,3,3.25,3790,19000,3790,0
1529200480,20140518T000000,534640,3,2.5,2130,3500,1210,920
2533300680,20141007T000000,1.23E+06,3,2.5,2860,4500,1980,880
6752600130,20150413T000000,351000,4,2.5,2370,7274,2370,0
9332800020,20140715T000000,745000,4,2.25,2290,10409,2290,0
1121000095,20141105T000000,320000,2,1,1120,5329,750,370
6751500285,20140731T000000,555700,3,2,1810,12420,1810,0
1310370020,20140708T000000,690000,4,2.5,3220,35400,3220,0
4019300680,20141231T000000,449000,3,1.75,1660,9697,1660,0
4408100095,20140502T000000,308500,2,1,850,6174,850,0
8944460020,20150305T000000,340000,4,2.5,2665,5868,2665,0
8824900020,20150327T000000,937750,4,2.75,2580,3560,1710,870
7135520780,20140506T000000,725126,4,2.5,3200,12369,3200,0
179001101,20150105T000000,135000,3,1,840,3000,840,0
4177100005,20150403T000000,635000,4,2.5,2970,7961,2020,950
910000104,20140806T000000,245500,2,1,790,7500,790,0
3353400840,20141202T000000,230000,6,1.5,2140,36509,2140,0
8964800050,20150304T000000,1.77E+06,3,2.5,2580,14603,2580,0
726049217,20141110T000000,425000,5,2.5,2180,7875,1200,980
2926049376,20150420T000000,220000,2,1,1060,10423,1060,0
5589300715,20140829T000000,370000,3,2,1860,9100,1860,0
7229900285,20140917T000000,390000,3,2,1840,16815,960,880
2722059215,20140603T000000,239000,3,1.75,1340,16480,1340,0
2473372040,20150102T000000,345000,4,2.25,2320,7350,2320,0
3546000630,20140826T000000,289000,3,2.5,2110,8304,2110,0
7888400500,20150508T000000,285000,5,1.5,1840,8050,1840,0
1823049182,20140915T000000,147400,3,2,1080,9225,1080,0
8712100020,20150127T000000,600000,2,1,1290,4636,1290,0
7961500010,20140806T000000,245000,3,2.25,2210,10794,1540,670
7961500010,20150304T000000,520000,3,2.25,2210,10794,1540,670
2424400130,20140518T000000,352500,3,2.25,1410,14110,1170,240
9406510130,20150505T000000,448000,5,3.5,3740,24684,2760,980
3832700250,20140929T000000,270000,4,2.75,2440,7150,1200,1240
809000525,20140826T000000,872500,3,2.5,2040,6000,1840,200
1370800225,20150318T000000,2.15E+06,4,3.25,3840,6214,2590,1250
3388100020,20140812T000000,225000,3,1.5,1660,7221,980,680
2770604615,20141121T000000,735000,4,2,1640,6000,1640,0
3754700420,20150401T000000,375000,3,1,1310,8400,1310,0
6669020290,20141023T000000,169000,3,1.75,1720,9775,1720,0
6669020290,20150304T000000,279950,3,1.75,1720,9775,1720,0
5493110020,20150116T000000,1.95E+06,4,2.75,4020,18745,2830,1190
6064800470,20140805T000000,310000,3,2.25,1960,2345,1750,210
9304400010,20140730T000000,975000,4,2.5,3240,35083,3240,0
5566100170,20141029T000000,650000,10,2,3610,11914,3010,600
3025049028,20141216T000000,930000,2,1.5,1800,4500,1000,800
2848700095,20150402T000000,412000,4,1.5,1960,5000,980,980
2172000894,20150417T000000,225000,3,1,1250,10200,1250,0
3034200660,20140619T000000,507000,3,2.5,2120,7201,2120,0
3304700130,20150128T000000,1.76E+06,4,4,3860,67953,3860,0
6661200080,20141117T000000,230000,3,2.5,1340,3011,1340,0
8835800480,20150223T000000,316000,1,2,1780,188465,1780,0
7853430660,20140910T000000,616200,5,3.25,3920,4832,3030,890
7511200020,20140829T000000,509900,3,1.75,1690,53578,1690,0
2597670080,20150316T000000,370000,4,2.5,2570,7753,2570,0
2423010130,20150306T000000,619100,3,1.75,1870,7030,1870,0
2927600415,20140821T000000,805000,3,2.25,2860,11250,2290,570
2770604665,20150202T000000,612125,2,1.5,1670,6000,1090,580
425049181,20140912T000000,350000,2,1.5,1070,937,1070,0
3223059217,20141104T000000,225000,2,1,940,15000,940,0
6669240130,20141022T000000,335000,3,2.5,2588,5701,2588,0
3303960080,20150331T000000,972800,5,3.25,3500,10457,3500,0
2413910190,20150202T000000,500000,3,1.75,1690,48096,1690,0
9185700285,20141223T000000,2.20E+06,4,3.75,3790,7200,2530,1260
4040800050,20141119T000000,415000,3,1.5,1090,8400,1090,0
3438500742,20140826T000000,399000,3,3,2240,10479,1710,530
2326300010,20140520T000000,376000,2,1,1150,4000,1150,0
4322200050,20141217T000000,340000,3,2,1870,3378,1120,750
6403510130,20141114T000000,490000,5,2.75,2990,7200,2990,0
4307340130,20140622T000000,374000,4,2.5,2580,6260,2580,0
7237600130,20150326T000000,852000,4,1,2220,3588,1470,750
5706300020,20141125T000000,473000,3,2.25,1620,12309,1620,0
6446200050,20150504T000000,540000,3,1.75,2590,25992,1970,620
7744500020,20140826T000000,431000,2,2,1390,12530,970,420
3971700635,20150506T000000,435000,4,3,2270,7245,1410,860
3625059109,20140508T000000,1.05E+06,4,3,2920,33976,1460,1460
6379500216,20140513T000000,450000,3,2.75,1250,892,1040,210
1123049027,20150319T000000,157500,3,1,1100,27008,960,140
1938400010,20141217T000000,244000,3,1.75,1500,7475,1500,0
3204900010,20150211T000000,550000,3,2.5,2800,10603,2800,0
6979900010,20140905T000000,975000,4,2.5,3420,183387,3420,0
1422069069,20150205T000000,426500,4,2.75,2100,88426,2100,0
9834200305,20140716T000000,350000,3,1,1790,3876,1090,700
9834200305,20150210T000000,615000,3,1,1790,3876,1090,700
3396820010,20150223T000000,542000,3,2.25,2220,12056,2220,0
1929300415,20141119T000000,710000,4,1.75,2000,6000,1000,1000
8001600130,20150501T000000,289950,3,2.5,1770,9450,1770,0
3835500585,20141016T000000,1.90E+06,4,2.75,4280,12668,3900,380
7518505910,20141119T000000,528000,2,1,1260,5100,1120,140
7518505610,20150325T000000,471000,2,1,840,5100,840,0
5412100920,20141203T000000,250000,4,2.75,1830,6643,1830,0
2329700440,20141027T000000,155000,3,1.5,970,8400,970,0
923000413,20140818T000000,515000,4,1.5,1740,8160,1400,340
9406521150,20150305T000000,336600,3,2.25,1654,8464,1654,0
810000080,20150310T000000,915000,3,2.25,2390,2750,1580,810
3762900130,20140715T000000,350000,2,1.75,1080,7242,1080,0
1651800010,20140702T000000,1.30E+06,4,1.75,2610,21600,2610,0
3876500290,20150305T000000,175000,3,1,1070,6164,1070,0
4443800545,20150330T000000,545000,2,2,1430,3880,1430,0
9218400050,20141227T000000,475000,4,3,2400,5400,1600,800
1023059108,20150430T000000,390000,2,1,670,11505,670,0
2787250190,20140717T000000,645000,4,2.5,2860,14000,2860,0
4019301205,20141202T000000,410000,3,1.5,2270,8187,1420,850
2607760190,20150331T000000,480000,4,2.5,2180,9861,2180,0
1250203135,20140701T000000,725000,3,1.75,1860,6000,1860,0
1424069069,20140522T000000,1.15E+06,6,4.5,6040,219542,4100,1940
7304301300,20140702T000000,300000,2,1,1010,11919,1010,0
8835400290,20150309T000000,752000,4,2.5,2570,8178,1710,860
3630030440,20140923T000000,585000,4,2.5,1950,3720,1950,0
1088000050,20150213T000000,678700,3,1.75,1970,10548,1300,670
7504010480,20150417T000000,603000,4,2.25,2110,11155,2110,0
8644500010,20150320T000000,715000,3,1.75,1650,7276,1150,500
1326059142,20141028T000000,1.40E+06,4,3,3520,128502,3520,0
3754501205,20150429T000000,1.09E+06,3,2.5,2840,7500,2840,0
7625701900,20150222T000000,467500,2,1.75,1490,4800,750,740
1926049398,20141013T000000,359000,3,2.25,1650,7218,1230,420
6372000190,20140826T000000,745000,4,2,1960,4520,960,1000
3622059088,20140513T000000,450000,3,2.25,2450,42180,2450,0
809003105,20150408T000000,935000,3,2,1720,2000,1060,660
8956000250,20140903T000000,615000,3,2.5,1980,3128,1890,90
1241500351,20140929T000000,1.03E+06,3,2.5,4110,35741,4110,0
7457400250,20150106T000000,283500,4,2.5,1990,5577,1990,0
6154900130,20141202T000000,340000,2,1,860,7102,860,0
1853500130,20150225T000000,370000,4,2.5,2320,9264,2320,0
1854750010,20140820T000000,1.15E+06,3,2.5,4190,9624,4190,0
9320500080,20140510T000000,265000,4,1,1940,9533,1080,860
7228500415,20140826T000000,480000,4,2.25,2520,2370,1690,830
3142600130,20140617T000000,667500,3,2,1880,3800,1030,850
629000605,20150227T000000,1.40E+06,3,2.5,2910,10044,2910,0
5536100005,20140808T000000,2.30E+06,7,4.75,5310,8816,3650,1660
3990000050,20140616T000000,465000,3,2.25,2670,7500,1640,1030
1320069249,20141020T000000,192500,1,1,470,63737,470,0
9357000635,20150323T000000,345000,3,1,1060,5600,760,300
2207200635,20140602T000000,439800,3,1.5,1120,6900,1120,0
3798000130,20140725T000000,468000,4,1.75,2250,8580,1330,920
2680700010,20140724T000000,775000,4,2.5,2070,8473,1250,820
3066200440,20140608T000000,684680,4,2.25,2370,9360,2370,0
3293400020,20150116T000000,910000,4,3.5,3570,27699,3570,0
2425049063,20140911T000000,3.64E+06,4,3.25,4830,22257,4830,0
114101426,20140617T000000,375000,3,1.75,1160,22470,1160,0
100500020,20140911T000000,250000,3,2.5,1610,6600,1610,0
1732800780,20150212T000000,3.07E+06,5,3,4150,7500,3510,640
7955050250,20141125T000000,442500,4,2.25,1840,7575,1390,450
3521059134,20140523T000000,900000,3,3.5,4080,217697,4080,0
6908200006,20140919T000000,699000,3,2,1820,4080,1820,0
4012800010,20140506T000000,360000,4,2,2680,18768,2680,0
629800660,20140909T000000,1.68E+06,4,4.75,4790,25412,4790,0
425059024,20150129T000000,675000,5,2,2420,21000,2420,0
8911000425,20140918T000000,345000,2,1,1130,8081,1130,0
3438502066,20150408T000000,229000,4,1,1320,5000,1320,0
3022039069,20150326T000000,300000,3,1,1290,12415,1290,0
1862400471,20140820T000000,392500,3,3.25,1600,1289,1600,0
7518505851,20140616T000000,552000,3,1,1120,2300,820,300
5101408678,20141120T000000,457000,2,1.75,2060,7192,1420,640
3296900130,20141007T000000,518000,4,2.5,2830,13760,2830,0
9513900050,20140812T000000,237000,3,2,1210,6634,1210,0
2624089022,20150314T000000,399950,3,2.25,1560,11997,1260,300
4024100670,20150506T000000,605000,3,2.25,2260,17114,2260,0
1862910050,20140722T000000,295000,4,2.5,1850,8198,1850,0
8651720420,20150428T000000,513000,4,2.5,1930,8040,1380,550
2619920170,20141001T000000,772500,4,2.5,3230,4290,3230,0
2619920170,20141219T000000,765000,4,2.5,3230,4290,3230,0
225039069,20141010T000000,696950,4,2.75,2450,5376,1550,900
3878900525,20150213T000000,329000,3,1,1200,5650,1200,0
7137970130,20141218T000000,339999,3,2.5,2360,8093,2360,0
6632300122,20140714T000000,364500,3,1,1060,9506,1060,0
2770602135,20140514T000000,607500,5,1.75,2220,6000,1420,800
3584800010,20150408T000000,550000,3,1,880,6664,880,0
8950500250,20150421T000000,479900,4,2,2510,9750,1630,880
7011201306,20150212T000000,1.12E+06,4,4,2530,1774,2100,430
4438400020,20140512T000000,192000,2,1,700,10540,700,0
8651440250,20150413T000000,250000,3,2,1500,5200,1060,440
203900920,20140715T000000,340000,3,2,1130,9879,1130,0
2458400345,20141028T000000,340000,3,2,1420,6060,830,590
6664000130,20141013T000000,635250,3,2.25,2210,22040,1510,700
2685600005,20150407T000000,324800,2,1,1170,5043,880,290
40000362,20140506T000000,78000,2,1,780,16344,780,0
3582700130,20150409T000000,400000,4,1.75,1770,12875,1770,0
3013300980,20150506T000000,640500,3,1,1070,4505,1070,0
2597000130,20150430T000000,570000,3,2,1930,10929,1260,670
6169900545,20140625T000000,1.33E+06,3,1.5,1940,2885,1940,0
1328340630,20150403T000000,330490,3,2.75,1440,7350,1040,400
705730280,20140819T000000,325000,3,2.5,1740,5267,1740,0
705730280,20150421T000000,335000,3,2.5,1740,5267,1740,0
5379805910,20141113T000000,314000,5,2.75,2210,13500,1460,750
2887700091,20140923T000000,625000,4,2,2190,3622,1990,200
7732410420,20140617T000000,809000,3,2.5,2590,7720,2590,0
7806500290,20140818T000000,535000,3,2.5,2790,19485,2790,0
1565600130,20140821T000000,275000,5,1.75,2180,9178,1140,1040
2473100280,20150417T000000,358000,4,2.75,2580,11900,1620,960
3826000460,20150313T000000,297975,3,2.25,2820,8100,1720,1100
1823069088,20150504T000000,492000,2,1.75,1300,22239,1300,0
1901600095,20140626T000000,210000,2,1,720,8040,720,0
9285800020,20140827T000000,622500,3,2.5,2260,4550,1380,880
3383900048,20141022T000000,550000,3,2.5,1550,1092,1390,160
1423700680,20150226T000000,190000,3,1.75,1390,7700,1390,0
9264930980,20140728T000000,340000,4,2.5,2380,9362,2380,0
3825311190,20140725T000000,678000,3,2.5,2640,5964,2640,0
9122500080,20150428T000000,275000,5,2,2260,11970,1250,1010
1189000130,20140915T000000,493000,3,2.75,1720,6720,1270,450
3347400525,20141216T000000,147000,3,1,1070,14000,1070,0
8091411100,20150204T000000,334000,3,2.25,2000,7225,2000,0
4384000020,20140703T000000,605000,4,2.5,2800,10786,1420,1380
321059132,20150427T000000,365000,3,1.75,1450,61419,1450,0
1016000080,20141125T000000,345000,3,1,1620,10610,1620,0
3585900305,20141030T000000,999000,3,2.5,2710,23292,2080,630
2922701305,20150402T000000,470000,2,1.75,1520,4220,840,680
8123500050,20140624T000000,599000,5,2.75,2730,22572,2080,650
5547500050,20140917T000000,255000,3,2.25,1740,10378,1740,0
5469700020,20150206T000000,295000,4,1.75,1800,28650,1800,0
9358400080,20140627T000000,550000,4,3.5,4150,16197,4150,0
1257200050,20140731T000000,1.31E+06,5,3.5,3270,4080,2180,1090
1180005220,20150505T000000,225000,2,1,1070,6000,1070,0
9536600010,20141223T000000,520000,4,0.75,1960,8277,1320,640
6140100022,20140826T000000,345000,3,3.25,1600,1882,1360,240
6140100095,20140520T000000,475000,4,1.75,1650,7775,1150,500
4037800020,20141008T000000,497500,5,1.5,2170,8610,1230,940
322069180,20141120T000000,649500,3,3,3730,383328,2230,1500
9348700020,20140825T000000,734500,4,2.75,3280,6845,3280,0
7414200010,20141218T000000,276000,3,1,870,8040,870,0
7849200635,20140630T000000,235000,2,1,900,28800,900,0
1524800005,20140812T000000,325000,2,1,1400,10800,1400,0
8045600130,20140528T000000,425000,4,2.75,1680,9545,1080,600
5559200170,20150430T000000,307000,4,2,2390,23972,1720,670
5700000275,20140528T000000,635000,3,2.5,2300,5500,2000,300
3224900130,20140514T000000,223000,3,1.75,1340,7473,1340,0
4397010480,20150413T000000,425000,3,2.75,2600,10874,2600,0
2310000250,20150506T000000,190000,3,2.25,1640,7730,1220,420
8731902340,20140918T000000,275000,4,1.75,1960,6177,1960,0
3630000080,20140606T000000,450000,3,2.5,1480,1961,1480,0
4139900050,20140519T000000,1.47E+06,4,3.25,5010,34460,5010,0
9191200380,20141222T000000,550000,4,2,1540,5000,1540,0
930000415,20141204T000000,835000,4,2.75,4030,10240,3310,720
5450300020,20140618T000000,900000,6,3,3020,13783,3020,0
8898700440,20141124T000000,290000,2,2,1590,9375,910,680
1238501188,20140808T000000,1.04E+06,4,2.5,2910,9131,2910,0
644210020,20150105T000000,780000,4,2.5,3020,15164,1730,1290
3066200460,20141218T000000,572500,3,2,2290,11200,2290,0
3422049088,20150324T000000,389000,3,1.75,2180,9220,1090,1090
6433000050,20140821T000000,350000,4,1.75,2740,10086,1440,1300
7215410430,20140728T000000,476000,4,2.5,2740,33158,2740,0
5316100255,20140904T000000,1.05E+06,2,3,2330,3600,1870,460
2413300980,20141217T000000,287000,3,2.25,2300,7200,1550,750
1175000280,20141107T000000,707500,4,4,1550,6596,1550,0
7304300420,20140801T000000,464500,4,2.5,1750,11381,1610,140
59000250,20141203T000000,720000,3,1.5,2180,5000,1090,1090
1441300130,20141224T000000,319000,3,2.5,1610,8544,1610,0
1075100050,20140916T000000,330000,3,1,1570,9136,1570,0
7972000010,20140520T000000,120750,3,1.75,1140,9628,1140,0
7972000010,20141021T000000,195000,3,1.75,1140,9628,1140,0
5113400364,20150126T000000,650000,4,1.5,2480,6383,1380,1100
5076900010,20140513T000000,530000,3,1.75,1690,8190,1690,0
3526039193,20150407T000000,825000,4,3,2910,8027,1800,1110
7905380280,20140822T000000,436000,4,2,1600,15044,1600,0
7936500221,20150114T000000,658000,2,1,1010,14244,1010,0
5100404761,20140813T000000,547500,3,2,1850,9570,950,900
510000050,20141203T000000,762000,3,1.75,2150,2527,1400,750
7148700050,20150126T000000,340000,3,1.75,2650,7378,1460,1190
3271800185,20141121T000000,880000,4,1.75,2510,5800,1830,680
2652501470,20140521T000000,1.22E+06,4,2.5,3240,3600,2060,1180
1568100920,20150408T000000,1.95E+06,4,2.5,3440,14554,2170,1270
7738500185,20140923T000000,382500,3,2,1150,6249,1150,0
9133600130,20150105T000000,344500,3,1.75,1890,9535,1210,680
3298720010,20150412T000000,375000,4,2.75,1430,7403,1030,400
2856101479,20140701T000000,276000,1,0.75,370,1801,370,0
5710610250,20140701T000000,500000,5,3.25,3130,12087,2180,950
163000010,20140702T000000,330000,4,2.5,2105,6093,2105,0
1062100095,20140822T000000,328000,3,1,890,5965,890,0
1437900020,20150225T000000,450000,3,1.5,1340,7200,1340,0
8073000585,20140715T000000,840500,4,2.25,2290,12174,1490,800
3342700491,20140814T000000,679000,3,2.5,2770,9350,2770,0
3395800305,20140605T000000,270000,3,1.5,1890,9450,1090,800
2923500010,20150114T000000,757500,5,2.25,3160,8065,3160,0
3629970680,20141112T000000,524950,2,2.5,1830,2856,1830,0
2408800130,20140723T000000,424900,4,2.75,2950,49658,2950,0
2204500480,20150107T000000,551100,3,1,1430,8640,1430,0
7708000010,20141107T000000,421000,3,2,1420,12655,1420,0
2639400020,20140801T000000,635000,4,1.75,2460,7560,2460,0
7883604095,20141209T000000,255000,3,1,1340,6120,1340,0
3055800020,20150310T000000,419950,4,1,1530,7920,1030,500
7195800009,20141210T000000,325000,6,3,2650,12870,2650,0
8946750170,20150421T000000,281000,4,2.25,1677,3600,1677,0
5603700095,20140610T000000,655275,3,1.75,2050,11856,1460,590
8819900170,20140825T000000,861000,3,2,2520,3959,1270,1250
3999300290,20141016T000000,850000,3,3.5,2620,11148,2060,560
2791500280,20141119T000000,246000,3,2.5,1650,6675,1290,360
8820903560,20141216T000000,380000,2,1,700,4836,700,0
4401200460,20141020T000000,813000,4,2.5,3430,7508,3430,0
3394100020,20141120T000000,990000,4,2.5,3140,11049,3140,0
2880100795,20141105T000000,650000,3,2.5,2350,3750,1740,610
104560280,20140522T000000,273000,4,3,1990,6180,1990,0
2133010290,20140724T000000,398000,4,2.5,2050,14724,2050,0
1723049008,20140822T000000,200000,2,1,930,8665,930,0
8146100095,20140515T000000,839000,3,1,1230,12305,1230,0
7715800430,20141104T000000,502000,3,2.5,1870,9135,1250,620
9510900630,20140617T000000,305000,3,2.25,2110,7665,1360,750
9414610020,20140618T000000,574950,5,3.25,3160,10000,3160,0
1160000255,20140818T000000,311000,3,1,1120,8631,1120,0
777100005,20141122T000000,1.65E+06,3,2.25,2750,6203,1620,1130
3205100130,20140506T000000,387000,3,1,1230,9568,1230,0
2929600020,20140805T000000,375000,3,1.5,1190,20672,1190,0
2420069242,20140925T000000,175000,2,1,740,3434,740,0
5009600010,20140612T000000,248000,4,2.5,1770,5855,1770,0
2414600255,20150403T000000,336750,4,2.25,1720,7803,1350,370
9359300250,20140604T000000,685000,4,2.5,2770,45514,2770,0
3629980920,20140715T000000,645000,4,2.75,2330,3917,2330,0
6679001060,20141218T000000,279000,3,2.5,1660,7388,1660,0
1702900664,20150416T000000,479000,2,2.5,1730,1037,1730,0
928000020,20150128T000000,466000,3,2.25,1880,7279,1280,600
705710290,20150420T000000,361500,4,2.75,2190,6740,2190,0
8155830020,20141202T000000,404000,3,1.75,1720,7202,1720,0
9378700190,20150316T000000,319000,4,3.25,2360,8344,2360,0
5104200420,20150316T000000,320000,3,1.5,1490,10132,1490,0
9550202140,20141117T000000,1.31E+06,4,3.75,3490,5625,2610,880
7855300460,20140923T000000,1.00E+06,3,2.75,2370,8900,1670,700
9346960050,20141107T000000,660000,4,2.5,2290,9120,2290,0
2254501440,20150421T000000,546000,4,3,1790,3600,1790,0
3732800525,20140709T000000,300000,4,1.75,1820,5015,1190,630
2525059134,20141016T000000,500000,2,1.5,1760,12000,1760,0
8562891100,20140910T000000,381500,4,2.5,2430,5556,2430,0
4094800380,20150427T000000,990000,3,2.25,2630,12899,2630,0
5104530680,20150116T000000,278226,4,2.5,2390,4639,2390,0
2917200675,20150127T000000,340000,2,1.75,1500,4158,1220,280
8732030440,20140813T000000,305000,4,2.5,2510,12000,1520,990
7779200275,20140613T000000,760000,4,2.5,2420,10285,1700,720
6121800050,20141029T000000,195000,4,1.5,2170,9948,2170,0
5652601155,20150415T000000,564000,4,1.75,1960,6138,1260,700
3261020080,20141224T000000,539500,4,2.25,2280,8550,1660,620
4060000020,20140918T000000,299980,4,1.5,1580,10230,790,790
5468730280,20141013T000000,290000,4,2.5,1850,5674,1850,0
7304301045,20150203T000000,257000,2,1,770,11084,770,0
4077800507,20140821T000000,518500,4,3,2120,5520,1420,700
1041500020,20140908T000000,657000,4,2.75,3060,35380,1810,1250
1423089134,20140815T000000,590000,3,2.25,2680,41250,2680,0
3992700048,20140718T000000,526000,4,1.75,2220,6350,1110,1110
2172000285,20150323T000000,254500,2,1,1150,11250,1150,0
8813400345,20150414T000000,575000,2,1,980,3663,980,0
5487300020,20150121T000000,464550,3,1.5,1690,10500,1690,0
7201800280,20140715T000000,409950,3,1.75,1320,6030,1320,0
8856000545,20140507T000000,100000,2,1,910,22000,910,0
567000380,20150302T000000,365000,2,1.5,820,1270,820,0
1450100020,20150209T000000,208000,3,1,1300,7420,1300,0
7950302995,20141110T000000,497950,4,2.5,1950,3000,1550,400
1446110020,20140910T000000,405000,5,3.5,3672,9742,3006,666
8914100080,20150311T000000,568000,3,2.5,2740,22499,2740,0
3333000655,20150511T000000,334000,2,1,890,6000,890,0
8019201061,20150115T000000,235000,3,2,1090,8400,1090,0
8570900328,20140603T000000,295000,2,1,1170,10621,1170,0
5631500947,20150122T000000,610000,4,3,2600,29539,2600,0
254000020,20140605T000000,453500,4,1.75,2000,6032,1300,700
1929300305,20140623T000000,1.22E+06,4,3.75,3520,3944,2200,1320
4202400078,20150128T000000,175000,2,1,1410,7000,1410,0
4202400078,20150428T000000,335000,2,1,1410,7000,1410,0
2968800010,20140904T000000,275000,3,1.5,1950,7620,1010,940
2880100675,20140514T000000,400000,2,1,980,2130,860,120
1024000050,20140718T000000,915000,3,2.75,3390,7000,1740,1650
6072400280,20140619T000000,619850,4,2.5,2270,9247,1500,770
2329600280,20150202T000000,225900,3,1,1510,8800,1010,500
6822100050,20140918T000000,525000,2,1.5,960,7200,960,0
1420400130,20141226T000000,215000,4,2.25,1900,9600,1900,0
7732400280,20140514T000000,802000,3,2.5,2580,13096,2580,0
4397000500,20140630T000000,330000,4,2.5,2340,11784,2340,0
9560700010,20140801T000000,549800,3,2.25,1580,11680,1580,0
6131600285,20141024T000000,195500,4,1,1230,8636,1230,0
8956500020,20140818T000000,338000,3,2.5,1590,7819,1590,0
624069108,20140812T000000,3.20E+06,4,3.25,7000,28206,3500,3500
1727500280,20140820T000000,480000,4,2.25,1770,7000,1770,0
4029400080,20150406T000000,383000,4,2.5,1850,8310,1200,650
2873000920,20150331T000000,257000,3,1.75,1430,7210,1430,0
1402900460,20150223T000000,335000,4,2.75,2190,9209,2190,0
8125200480,20150508T000000,422000,4,2.5,2310,6650,2310,0
1087900050,20140603T000000,560000,3,1.75,2000,10182,1400,600
7937900280,20150424T000000,680000,4,2.75,3620,35429,3620,0
1096100010,20141028T000000,320000,2,1,1210,7040,1210,0
2050100250,20140903T000000,665000,3,2.5,2330,15536,2330,0
8691370500,20150326T000000,751000,3,2.5,2840,6854,2840,0
7147600225,20141113T000000,320000,6,2.75,2410,10763,1310,1100
4021100095,20150121T000000,290000,4,1.75,1820,22043,1820,0
7524000280,20141030T000000,250000,4,2,1470,7412,1470,0
3205200430,20150415T000000,423000,3,1.75,1100,10005,1100,0
7922720250,20150506T000000,601002,4,2.5,2050,8094,1050,1000
3644100095,20150205T000000,352900,2,1.5,1240,1892,1240,0
3425079088,20140819T000000,509950,3,2.5,2210,70567,2210,0
8730000250,20150205T000000,360000,2,1.75,1340,1050,1340,0
2581900235,20141110T000000,1.08E+06,4,2.75,2580,8100,1780,800
3793500920,20140731T000000,349950,3,2.5,2390,6441,2390,0
2472920780,20141126T000000,395000,4,2.5,2250,6840,2250,0
8860200010,20150107T000000,273500,3,1.5,2000,15265,1540,460
6823100225,20150414T000000,700000,4,1.75,1870,6000,1670,200
6669070080,20150417T000000,699000,3,2.5,2370,10968,2370,0
7214810050,20150416T000000,537000,4,2.25,2640,8800,1620,1020
3791500050,20150429T000000,405000,3,1.5,1240,9975,1240,0
4340610080,20140804T000000,269500,2,1,800,1200,800,0
7686203620,20140925T000000,260000,4,2.5,2050,12500,1300,750
2013800095,20140904T000000,266750,3,2.25,1650,10000,1650,0
4030100005,20141209T000000,1.80E+06,5,3.75,4320,39094,4320,0
8931100095,20140821T000000,779000,2,2.25,2130,5920,1830,300
1954630080,20140619T000000,500000,3,2.5,2840,48716,1870,970
3361402066,20150403T000000,365000,4,1.75,3080,32997,3080,0
579000595,20140906T000000,724000,2,1,1560,5000,1560,0
7701960250,20140811T000000,890000,4,2.75,3220,15467,3220,0
1250200595,20140724T000000,431000,4,2.5,1450,3600,1250,200
2632000080,20140710T000000,242000,2,1,960,21850,960,0
9323000010,20150416T000000,415000,4,2.5,2670,8279,2670,0
3052700225,20140814T000000,727160,7,3.75,2310,5000,2310,0
3459900305,20141211T000000,1.11E+06,4,3.25,3520,19354,2010,1510
3530410020,20150114T000000,265000,2,1.75,1090,3272,1090,0
461005435,20150202T000000,519000,3,1.75,2000,5680,1080,920
8851500050,20150112T000000,262000,4,1.5,1840,9009,1840,0
4094800190,20140623T000000,1.19E+06,4,2.5,3160,13194,3160,0
2025701190,20150507T000000,295000,3,1.75,1520,6559,1170,350
226059120,20150123T000000,615000,3,1.75,2110,56192,1480,630
1818800235,20140905T000000,1.10E+06,4,2.75,3410,7750,1710,1700
3905080250,20140926T000000,575000,4,2.5,2630,6247,2630,0
3126049415,20150407T000000,388000,3,1.75,1350,2325,1350,0
1245000500,20141103T000000,750500,4,2.5,2860,9159,1530,1330
2924069132,20140527T000000,527500,3,1.75,2310,78844,1760,550
922069169,20140529T000000,503000,3,2,2590,108900,1980,610
5015000346,20141104T000000,1.05E+06,4,3.5,3500,4000,2560,940
8122101440,20140708T000000,325000,2,1,800,7260,800,0
6413600285,20140825T000000,402000,3,1.75,1580,6127,1580,0
6145601995,20140924T000000,370000,3,1.5,1560,6774,1060,500
1214000080,20140626T000000,329950,3,1,1750,7800,1150,600
3361400980,20150512T000000,135000,2,1,600,6120,600,0
2826049260,20140620T000000,482500,4,3,1630,7626,1110,520
1001200050,20140923T000000,259000,4,1.5,1260,7248,1260,0
8732130680,20141027T000000,210000,3,2.25,2140,9775,1470,670
1310430130,20141009T000000,459000,4,2.75,2790,6600,2790,0
2380000190,20140701T000000,375000,3,1.75,2530,35150,1800,730
123039626,20141022T000000,295000,3,2.25,1330,7200,900,430
1257200290,20140512T000000,910000,3,2,2700,6120,1350,1350
318900080,20141010T000000,470000,4,1,1740,37238,1740,0
8118600080,20150220T000000,565000,4,2,2070,7980,2070,0
2023049372,20141107T000000,339950,4,2.25,2670,9040,2170,500
126059005,20150115T000000,547000,5,3,2200,103237,1160,1040
6303401150,20140924T000000,125000,2,1,810,8382,810,0
1732801150,20140701T000000,2.30E+06,4,4.75,3970,9778,3390,580
7893800250,20150430T000000,348000,3,2.5,2370,7500,1620,750
1922059298,20150414T000000,175000,3,1,1460,11880,1460,0
2391600950,20140502T000000,439950,3,2.5,1770,2875,1770,0
3623029034,20150311T000000,230000,3,1,1120,32250,1120,0
13001991,20140902T000000,207000,3,2.5,1520,2550,1520,0
1156000250,20140602T000000,320000,5,2.5,3020,21441,1510,1510
1326059182,20150406T000000,1.09E+06,5,3.25,5600,107157,3440,2160
3755500080,20140606T000000,510000,4,1.5,1320,14250,1320,0
5042300095,20141031T000000,730000,4,1,1870,4992,1670,200
7772800020,20140813T000000,750000,3,3.75,2460,7630,1940,520
3629000080,20150410T000000,237000,3,1.5,960,7400,960,0
5126210280,20140926T000000,560000,3,2.5,3440,103672,3440,0
3062600050,20140714T000000,745000,3,2.75,3010,12432,1890,1120
5493110080,20140815T000000,1.83E+06,3,3.75,6030,39317,4440,1590
2560801222,20140618T000000,180000,3,2.25,1990,6350,1990,0
2560801222,20141113T000000,309950,3,2.25,1990,6350,1990,0
2660500095,20150506T000000,715000,4,1,1710,6050,1410,300
4083800345,20150427T000000,620000,4,2.25,1890,4300,1350,540
587800130,20141231T000000,330000,3,2.5,1990,9995,1990,0
8901000585,20150401T000000,525000,4,1.75,1600,7400,1210,390
8650000250,20140607T000000,611000,6,2.5,3820,53173,2040,1780
4137050130,20140612T000000,294000,4,2.5,2210,8465,1490,720
3288300920,20150421T000000,463000,3,1.75,2020,11095,1480,540
3374500290,20140714T000000,320900,3,2,1770,7251,1770,0
1137400420,20141028T000000,369950,4,2.5,2050,4502,2050,0
3222059130,20140616T000000,565000,4,2.75,3130,139392,3130,0
3959400345,20150311T000000,589500,4,1.5,3520,4933,2270,1250
3971701990,20140812T000000,400000,4,1.75,1810,9750,1810,0
686530170,20141022T000000,458000,3,2.25,2150,9900,1450,700
808300470,20141202T000000,436000,4,2.5,2495,5751,2495,0
7129303180,20141002T000000,310000,3,2,1290,6150,1290,0
8944460290,20141023T000000,398000,5,2.5,3004,5700,3004,0
2128000050,20140815T000000,625000,4,2.25,2070,7200,1390,680
4139910170,20141216T000000,1.01E+06,5,3.25,4050,35600,4050,0
8122100235,20150413T000000,435000,2,1,960,6250,740,220
1117000050,20150313T000000,250000,3,2.25,1900,9990,1300,600
5361700020,20150317T000000,430000,3,1.5,1450,7316,1450,0
1315300095,20140812T000000,790000,4,3.5,2720,3000,2250,470
5093300280,20140709T000000,1.68E+06,5,5.25,4830,18707,3930,900
3438503214,20150407T000000,250000,4,2.75,1920,7102,1130,790
2346800461,20140613T000000,1.12E+06,5,1.5,2540,6660,2340,200
1826049408,20150427T000000,383900,3,1.5,1600,8040,1050,550
5468780020,20150326T000000,330000,4,2.5,2210,5929,2210,0
1126059091,20140915T000000,624000,3,2.5,2510,47044,1910,600
3010300415,20150211T000000,383000,5,2,2280,5750,1140,1140
619079016,20140602T000000,687000,4,3.25,4400,186846,4400,0
3449800010,20150309T000000,558000,4,3.25,3160,8876,2460,700
1231000500,20140905T000000,275000,3,2,1380,3500,1380,0
4191500130,20140728T000000,687500,5,2.75,3320,10500,2020,1300
104550660,20140728T000000,275000,3,2.5,1870,6821,1870,0
1769600066,20141211T000000,700000,3,3.5,3030,11550,3030,0
3762900020,20140624T000000,342500,2,1.75,1210,7507,1210,0
1626069253,20140506T000000,483500,4,2.5,2740,45732,2740,0
3904100089,20140801T000000,190000,3,1.75,1350,7370,1350,0
3904100089,20150318T000000,300000,3,1.75,1350,7370,1350,0
1797500780,20140521T000000,540000,3,2,1470,1691,1000,470
7614100080,20150211T000000,140000,3,1.75,1270,8991,1270,0
87000006,20150413T000000,275000,4,1.75,1680,19405,1560,120
8074200185,20140825T000000,370000,3,2.75,2120,7650,2120,0
9310300185,20150325T000000,227000,2,1,1040,9100,1040,0
1433100010,20150128T000000,312000,4,1,1730,8706,1010,720
7129302555,20141003T000000,260000,2,1,1410,5650,1410,0
809002705,20140710T000000,797000,3,2.5,1370,1911,1370,0
3026079005,20141017T000000,640000,6,2,2840,228690,2720,120
2413910050,20150213T000000,605000,4,1.75,3280,35160,2080,1200
8078550190,20150302T000000,329950,3,2.25,2070,7995,1350,720
2225079030,20141212T000000,180000,2,1,960,87991,960,0
2019200480,20140813T000000,220000,3,2.25,1470,7518,1160,310
9274202005,20140702T000000,723000,4,2.25,2430,4748,1630,800
3834500170,20150116T000000,375000,3,1.75,1430,8412,1070,360
1223039242,20150126T000000,388000,3,1.75,1760,9277,1760,0
7657600005,20141031T000000,249950,5,2,1730,7375,1730,0
8963300005,20141106T000000,390000,5,1.75,2290,7900,1190,1100
2287000280,20140917T000000,705000,4,1.75,1690,11739,1690,0
686300420,20140623T000000,590000,4,2.5,3220,7875,3220,0
9335400005,20141010T000000,292000,4,1.75,2130,11097,1370,760
2321059093,20140805T000000,506000,3,2.5,2100,213008,2100,0
7732410380,20140604T000000,907500,4,2.5,2770,8642,2770,0
3625049088,20140702T000000,2.27E+06,4,3.25,4040,18916,4040,0
13001795,20141014T000000,319500,4,2.75,2500,5100,1420,1080
1604602195,20150223T000000,265000,5,1.75,1580,5292,980,600
1003400250,20140605T000000,237000,3,1,1130,10650,1130,0
42000006,20140910T000000,235000,5,1,1500,9282,1500,0
1193000380,20150330T000000,740000,4,2.25,2230,6000,1810,420
6300500545,20140709T000000,359000,3,1.5,1550,4980,1080,470
538000190,20150213T000000,334950,4,2.5,2230,5500,2230,0
2826049091,20140929T000000,259950,2,1,790,8100,790,0
6147650170,20140514T000000,253000,4,2.5,2230,4541,2230,0
3630030500,20140612T000000,561000,3,2.25,1710,4140,1710,0
6844701680,20150325T000000,455000,2,1.5,1260,5100,1260,0
9542000275,20150406T000000,675000,4,2.5,2420,18470,920,1500
1423600020,20140626T000000,267000,3,1.5,1090,8160,1090,0
8944460170,20141106T000000,368000,4,2.5,2689,5724,2689,0
6431000005,20141123T000000,599995,3,1,1620,3000,1620,0
3755000020,20140917T000000,342500,3,1,940,10500,940,0
1503200050,20141118T000000,252000,4,1.75,1940,13370,1940,0
2599000130,20140716T000000,247200,3,1,1590,11200,1590,0
871001980,20140506T000000,910000,3,3.5,3020,4082,2080,940
1774000170,20150105T000000,419950,4,1.75,1870,16549,1870,0
8945300290,20150226T000000,160000,3,1,880,8976,880,0
9433000480,20140922T000000,799950,4,3.5,3030,5494,3030,0
6672920050,20140617T000000,400000,3,2.25,2140,11266,2140,0
7893805650,20140505T000000,210000,5,2,2050,10200,1430,620
7893805650,20150313T000000,475000,5,2,2050,10200,1430,620
9542830480,20150504T000000,355900,3,2.5,2090,3821,2090,0
3824100364,20150120T000000,420000,3,2.25,2520,26943,1760,760
9542850290,20140825T000000,710000,4,2.5,2630,8580,1700,930
5726500130,20150407T000000,518000,4,1.75,2560,15000,1880,680
1862400285,20141016T000000,375000,3,1,1200,5404,1200,0
6123600285,20141107T000000,185000,3,1.5,1010,7755,1010,0
6838000170,20140829T000000,402000,3,2.5,1520,3425,1520,0
2922069134,20140829T000000,585000,3,1.75,2170,153767,2170,0
2767603165,20150122T000000,500000,4,2,1980,4500,1980,0
1118001835,20141223T000000,1.72E+06,4,2.5,3070,7207,2670,400
4030100290,20141001T000000,1.68E+06,5,3.5,5170,7197,3520,1650
9828702335,20150212T000000,570000,2,2,1140,690,760,380
8141200080,20140814T000000,680000,8,2.75,2530,4800,1390,1140
9407101850,20141209T000000,345000,3,2.25,1690,14615,1690,0
9542830050,20150422T000000,355000,4,2.5,2150,3600,2150,0
4038300010,20140922T000000,390000,3,1.5,1180,7700,1180,0
1898700050,20150428T000000,128000,3,1,1400,9690,1400,0
826000480,20140826T000000,448500,3,1.75,1300,4800,1300,0
6163901150,20141109T000000,346000,3,1.75,1590,9636,1590,0
3956900480,20140903T000000,779000,3,1.75,1990,5600,1330,660
3824100020,20150203T000000,335000,3,1.75,1510,9720,1510,0
5026900235,20140911T000000,1.85E+06,4,3.25,2910,1880,1830,1080
1330850130,20150218T000000,799990,3,2.5,2850,21780,2850,0
1726059134,20141010T000000,1.08E+06,3,2.5,2830,56628,2830,0
2767604551,20140822T000000,371000,2,1.5,1110,1189,1110,0
7424600020,20141027T000000,620000,4,2.5,1900,9775,1900,0
8731000010,20140515T000000,343000,4,1.75,2290,10290,1340,950
5104200380,20141014T000000,265000,3,1,1010,14948,1010,0
1311030430,20140804T000000,1.00E+06,5,2.5,4670,15857,4670,0
3585900190,20141006T000000,825000,3,2.5,3400,38400,1870,1530
98020630,20150414T000000,889000,4,3.5,4070,10976,4070,0
3826500470,20150415T000000,305000,3,2.25,1630,10962,1100,530
5422560660,20141030T000000,407000,2,2.5,1700,6635,1700,0
267000130,20140603T000000,613000,5,2.5,2070,12000,1340,730
6117502230,20141201T000000,1.64E+06,3,3.5,4660,21164,4660,0
2402100675,20150210T000000,645000,3,3.75,2050,6000,1550,500
1624059224,20140618T000000,1.16E+06,4,3.5,4680,9700,3360,1320
3811000250,20140929T000000,610000,3,2.25,2320,38186,2320,0
8029520250,20150318T000000,450000,3,2.5,3800,13071,2730,1070
3438501150,20140728T000000,300000,3,2,720,7598,720,0
3582900280,20140606T000000,1.12E+06,5,2.75,4400,18500,2250,2150
3521069142,20150224T000000,418200,3,2.5,2260,74297,2260,0
646910020,20140828T000000,250000,3,2.5,1650,2802,1650,0
1026069134,20140825T000000,619000,3,2.5,2560,43608,2560,0
5230000020,20140630T000000,500000,4,3,3720,15048,3720,0
1442740010,20141107T000000,465000,4,2.5,2590,16437,2590,0
7937600010,20141212T000000,322000,4,1,1750,68841,1750,0
1545801410,20150128T000000,276900,3,2.5,1620,7320,1620,0
1235700073,20150318T000000,660000,3,2.25,1700,12615,1300,400
7806450050,20141029T000000,480000,3,2.5,2450,28185,2450,0
3250500103,20150408T000000,925000,3,1.75,1610,10796,1070,540
2624300080,20140724T000000,825000,3,3,3730,35900,2960,770
7568700525,20150318T000000,326000,2,1,1210,7440,780,430
7683800010,20150421T000000,205000,3,1,1300,9880,1300,0
3089000005,20140724T000000,150000,2,1,850,54000,850,0
9510970010,20150429T000000,593567,3,2.5,1770,3205,1770,0
9560800290,20140814T000000,440000,3,2.5,2060,11231,2060,0
1385100050,20140716T000000,751000,3,2.5,3090,13316,3090,0
3294700101,20140909T000000,295000,2,1.75,1050,6500,1050,0
8021700725,20140904T000000,422500,3,2,1300,2250,1300,0
4038200480,20141201T000000,480000,3,1,1160,8800,1160,0
3630180380,20140725T000000,890900,4,2.5,3420,6233,3420,0
2782100280,20140529T000000,672500,4,2.75,2620,6707,2620,0
3797002575,20141010T000000,605000,4,1.5,1880,3500,1080,800
9315600050,20150317T000000,1.68E+06,5,3.25,4560,19080,2490,2070
1939110080,20140926T000000,565000,4,2.5,2330,7936,2330,0
5423030380,20150506T000000,725000,4,1.75,2350,7574,1720,630
5693501100,20140731T000000,640000,3,3,1560,1466,1560,0
1612500170,20150226T000000,253750,4,1,1380,7110,1380,0
6116500290,20140714T000000,799950,6,2.75,3040,36721,1760,1280
2450000275,20140716T000000,595000,4,1.5,1350,8113,1350,0
2194100050,20140929T000000,850000,4,2.5,3180,11652,3180,0
3782760280,20141002T000000,366000,3,2.5,1790,4065,1790,0
4320200020,20140922T000000,715000,4,3,1986,6000,1746,240
2944500420,20141211T000000,300000,4,2.5,2400,7215,2400,0
3616600231,20140603T000000,960000,4,3,4590,9150,3490,1100
6758700050,20150401T000000,812000,3,2,1970,3420,1970,0
2545900050,20140509T000000,234950,3,1,1360,9948,1360,0
8824900050,20140612T000000,656500,4,2,2710,4750,1460,1250
6300000213,20140703T000000,255000,2,1.5,920,1598,920,0
2211700290,20141204T000000,538000,3,2.75,2000,7204,1250,750
739500050,20140701T000000,260000,3,2.25,1920,9680,1300,620
6190500380,20141027T000000,546200,3,2.5,2678,6607,2678,0
5129000006,20150419T000000,280500,3,1,1220,4541,890,330
2112700280,20140811T000000,295000,3,1.75,1440,4000,1050,390
9828702895,20141022T000000,700000,4,1.75,2420,520,2420,0
2026059181,20141120T000000,560000,3,2,2090,15790,2090,0
3295610080,20150401T000000,912000,4,2.75,4030,10888,4030,0
1474000050,20140508T000000,437000,3,1.75,1310,9282,1310,0
2896400170,20150316T000000,447000,3,2.5,1800,3074,1800,0
3342103281,20141020T000000,500000,4,1,1160,20100,820,340
7172200080,20150319T000000,508300,3,1,1160,5969,880,280
5209200010,20140731T000000,485000,3,1.5,1870,7853,1300,570
6744700427,20140507T000000,540000,7,5.75,3700,7647,3700,0
1328310440,20140916T000000,356000,3,2.25,2280,8765,2280,0
2710600080,20140825T000000,525000,4,2,1720,6099,860,860
8651611980,20150324T000000,962800,4,2.75,3630,11775,3630,0
1541700010,20141001T000000,315000,4,2.5,2040,6300,2040,0
477000019,20140620T000000,525000,3,2.25,1750,1879,1750,0
8165501700,20150430T000000,325000,2,2.25,1550,2285,1550,0
9534400010,20150423T000000,965800,4,1.75,2500,8725,1500,1000
7577700185,20140709T000000,550000,4,1,1440,3600,1440,0
257000263,20141021T000000,182200,4,1,1130,13927,1130,0
8638500020,20140911T000000,315000,3,1,1210,8505,1210,0
452001310,20140825T000000,500000,2,1,960,5000,960,0
7852000500,20140702T000000,480000,5,2.5,2160,7737,2160,0
4219401236,20140520T000000,1.69E+06,3,1.75,3400,8965,1820,1580
1622069127,20141118T000000,525000,5,3.25,3960,321908,2690,1270
2644300005,20150412T000000,407500,4,2.5,1900,9075,1900,0
3211260290,20150309T000000,443000,4,3,2620,35124,2620,0
3625500130,20140530T000000,1.26E+06,4,2.5,3150,13700,3150,0
6819100380,20140830T000000,642000,3,1,1040,4480,870,170
8562600500,20150109T000000,520000,3,1.75,1540,7558,1540,0
9279200280,20140623T000000,750000,3,2,1820,5000,1720,100
6788201440,20150407T000000,855000,5,1.5,1930,4500,1930,0
2624089026,20141002T000000,275000,4,1,1430,27153,1430,0
8698600080,20140910T000000,265000,5,2.75,2920,5250,1800,1120
425069136,20150410T000000,894400,3,2.5,3100,45738,3100,0
5528600050,20150211T000000,546000,2,1,1200,12856,1200,0
8682290660,20141126T000000,699950,2,2.5,2390,7489,2390,0
1839920050,20150414T000000,435000,3,2,1270,10713,1270,0
6624010010,20150506T000000,259500,4,1.5,1300,7200,1300,0
9406590010,20141029T000000,359950,4,3.25,2290,4785,2290,0
3575305362,20141215T000000,517000,3,1.75,1740,10000,1740,0
8835900010,20140804T000000,579000,3,1,1590,5400,1280,310
7199000290,20140905T000000,525000,4,2,2420,10735,2420,0
6669150280,20150414T000000,320000,4,2.5,2130,9653,1500,630
2619600010,20140513T000000,635000,4,1.75,1950,13320,1370,580
2314300420,20140916T000000,400000,4,2.5,2150,5397,2150,0
9512500380,20141010T000000,455000,3,1.75,1270,7700,1270,0
8653600050,20150225T000000,572000,3,1.75,1850,22767,1850,0
4045900020,20150413T000000,650000,2,1.5,1440,136778,1140,300
1311800130,20150123T000000,162500,3,1.5,1390,7417,1390,0
9542890010,20141113T000000,400000,2,2.5,1340,1240,1150,190
4027700795,20150318T000000,268300,3,1,1190,9000,1190,0
7013200280,20140702T000000,989000,6,4.5,3830,4800,3050,780
2460700430,20140627T000000,342000,3,1.75,1780,10409,1280,500
6147650280,20150325T000000,315000,4,2.5,3130,5999,3130,0
3574800010,20150428T000000,485000,4,2.75,1830,8384,1320,510
8731981640,20141204T000000,277500,4,2.5,2550,7500,1750,800
1525069134,20150312T000000,1.30E+06,4,3.5,3790,90169,3790,0
2824069180,20140806T000000,385000,4,1.75,1800,10890,1800,0
751000080,20141117T000000,426000,2,1,1630,7680,830,800
2044500213,20140617T000000,310000,4,2,1870,6000,1870,0
2044500213,20150126T000000,449000,4,2,1870,6000,1870,0
1703400470,20141219T000000,375000,2,1,980,3915,980,0
7363600185,20150330T000000,1.19E+06,3,2.25,2860,10625,1920,940
3904901300,20150414T000000,468000,3,2.25,1470,5597,1470,0
7548300425,20150403T000000,336000,1,1,1160,5000,1160,0
4123830480,20140610T000000,392000,4,2.75,1940,6555,1940,0
9477000280,20140807T000000,412500,4,2.25,1630,7969,1100,530
8567450080,20150325T000000,545000,4,2.5,2755,11612,2755,0
7129304540,20141220T000000,133000,5,2,1430,5600,1430,0
7129304540,20150514T000000,440000,5,2,1430,5600,1430,0
2250000010,20141205T000000,294450,4,2.25,1400,7341,1300,100
5162100660,20140826T000000,335000,4,2.5,2520,7205,2520,0
4140500050,20140908T000000,362000,3,1,1290,10125,1290,0
2129700525,20141028T000000,322000,3,1.75,1400,18002,1400,0
4337000275,20150317T000000,230500,2,1,740,8853,740,0
3942900010,20150305T000000,380000,4,2,1710,9996,1710,0
8699100321,20140611T000000,292000,4,2.75,2414,7693,2414,0
7686203180,20140812T000000,172500,3,1,1040,7500,1040,0
1193000480,20140724T000000,784000,4,2.75,3540,7091,1970,1570
1234000630,20141002T000000,525000,4,2.75,2530,11549,1700,830
8562750250,20140704T000000,600000,3,2.5,2320,7609,2320,0
5088500170,20141027T000000,435000,3,2.5,2530,16102,2530,0
1061500630,20150205T000000,359900,5,2.75,2790,7600,2790,0
8073000491,20141211T000000,700000,4,1.75,1950,7139,1150,800
3277801448,20150312T000000,280000,3,2,1020,889,720,300
1656600280,20141002T000000,655000,4,2.5,3110,24466,3110,0
4139420190,20150512T000000,2.48E+06,4,5,5310,16909,3090,2220
5360200052,20150224T000000,499950,3,2.5,2580,23925,2580,0
7234601025,20140805T000000,540000,3,2.5,1380,1021,1160,220
8001470480,20150306T000000,970000,4,2.75,3980,9209,3980,0
2597670470,20140813T000000,330000,4,2.5,2080,7000,1400,680
7199330130,20140703T000000,474000,3,1.75,1530,8000,1530,0
4039700080,20150317T000000,670000,4,1.75,1930,9310,1930,0
5317100780,20140512T000000,1.30E+06,4,3.25,2330,9687,2330,0
2597450250,20140730T000000,1.16E+06,4,2.5,3860,10361,2940,920
2472920680,20150112T000000,440000,4,2.5,2880,8061,2880,0
7436300170,20140728T000000,411000,2,2.5,1590,2088,1590,0
3964400470,20140725T000000,500000,3,1.5,2150,4000,1470,680
7351200050,20141218T000000,1.34E+06,4,1.75,2300,13342,2300,0
1377800277,20141215T000000,696000,6,3.25,2900,6400,2300,600
3862400050,20140506T000000,465000,3,2.25,1970,11088,1180,790
7199310170,20140616T000000,518000,4,2.5,1740,7500,1220,520
8039900086,20140509T000000,251000,3,1.75,1220,7250,1220,0
1137600190,20150430T000000,255000,3,2,1290,13282,1290,0
1566100130,20140820T000000,319000,2,1,780,8271,780,0
9547205610,20140929T000000,719000,4,2.75,2210,3400,1470,740
5608000190,20140714T000000,1.52E+06,5,3.5,5930,13288,3920,2010
3295450050,20150109T000000,322000,4,2.5,1950,4553,1950,0
3751602249,20150305T000000,205000,4,1,1340,7920,1340,0
7889600190,20150113T000000,229000,3,1,1590,6240,1060,530
217700050,20141030T000000,395000,3,2.25,1780,9672,1350,430
7943000020,20150326T000000,183000,2,1,760,7272,760,0
7199310290,20140905T000000,583500,3,1.75,1720,7800,1170,550
192700080,20150213T000000,312000,3,2.5,2070,25710,2070,0
23520380,20140909T000000,539000,3,1.75,1790,9860,1410,380
8961950050,20150320T000000,409000,4,2.75,3230,12651,3230,0
3300701365,20140528T000000,510250,3,1.75,1400,4000,870,530
871000170,20141202T000000,535000,2,2,1370,3827,1020,350
9407150250,20140924T000000,280000,3,2.5,1600,7936,1600,0
7789000235,20150409T000000,286000,3,1,950,8400,950,0
8587400050,20150325T000000,710000,3,2.75,2210,7660,1460,750
5100401315,20140709T000000,395000,2,1,930,6380,930,0
2634500005,20140908T000000,237500,2,1,810,8494,810,0
6332000050,20150121T000000,464000,3,2,1630,6550,850,780
2126049265,20141021T000000,495000,3,1.75,1770,10080,1770,0
7950304095,20150217T000000,257500,1,1,710,6060,710,0
587550010,20150116T000000,570000,4,3.5,3990,23544,2300,1690
1402630190,20141111T000000,362000,3,2.5,2310,7485,2310,0
2402100895,20140625T000000,640000,33,1.75,1620,6000,1040,580
3750604417,20140526T000000,172500,3,1,1140,8800,1140,0
9547202890,20150120T000000,596000,2,1,1040,4880,1040,0
2600110250,20150430T000000,840000,4,2.5,2170,9796,1650,520
7403200050,20141113T000000,1.60E+06,3,2.25,3370,23065,1920,1450
9528104360,20140912T000000,435000,2,1.5,901,1245,901,0
2634500050,20140910T000000,251000,2,1,840,7870,840,0
268500020,20141106T000000,282500,4,1,1650,9750,1650,0
1796361100,20141017T000000,265000,3,2.25,1380,7226,1140,240
8807300130,20141217T000000,330000,3,1,910,10240,910,0
7170200080,20140617T000000,435000,2,1,1230,3800,1230,0
1877500005,20141201T000000,827235,3,1.75,1740,8560,1500,240
7211400525,20140530T000000,249950,4,1,1290,5000,1290,0
2549000020,20150324T000000,400000,3,2.5,1950,18533,1950,0
4137040250,20141021T000000,300499,4,2.5,2150,7944,2150,0
5101400461,20150417T000000,449000,4,2,1560,5220,1560,0
2306400010,20141017T000000,500000,2,1,1120,3220,1120,0
8861000095,20140930T000000,865000,3,1.5,1790,7526,1790,0
3754500010,20140616T000000,899950,4,3.5,3290,5414,2360,930
4326000190,20140828T000000,370000,4,1,1540,9541,1540,0
1525069088,20150504T000000,442500,5,3.25,4240,226097,3410,830
9474700020,20140503T000000,310000,3,1,1010,9945,1010,0
4389200876,20140701T000000,1.57E+06,4,2.75,2970,12750,2130,840
6084600420,20140905T000000,245000,4,2.25,2190,9113,2190,0
6668900010,20141117T000000,254950,2,1,700,8100,700,0
125059178,20140722T000000,510000,6,4.5,3300,7480,3300,0
2131701410,20150427T000000,299950,3,2.25,1370,5000,1370,0
3158500130,20140821T000000,379950,4,2.5,2680,4500,2680,0
6300500275,20140807T000000,350000,3,1,1390,4820,910,480
3395040920,20140618T000000,300000,3,2.5,1700,3575,1700,0
1193000280,20140527T000000,994000,3,2.25,2510,6339,1810,700
8022900005,20141119T000000,315000,3,1.5,1700,8067,1250,450
1774000050,20140507T000000,480500,4,2.5,2180,11200,2180,0
1725800280,20140616T000000,373000,3,1,1770,5720,1140,630
8691390980,20140902T000000,728000,4,2.5,3290,5951,3290,0
1180008370,20140925T000000,415000,4,3.5,3040,7125,2240,800
9558020460,20140604T000000,427500,4,2.5,2460,5091,2460,0
3575302880,20141110T000000,339300,3,2,970,10000,970,0
6671900095,20140527T000000,313000,3,1.75,1320,6205,1320,0
5637500094,20140522T000000,431500,3,3.5,1900,1612,1430,470
4310701330,20150309T000000,415000,3,1.5,1220,835,1220,0
23520190,20150316T000000,490000,3,1.75,1470,9750,1470,0
98000130,20150324T000000,1.43E+06,4,5,4630,24054,4630,0
6829900080,20150330T000000,275000,3,1.5,1400,9750,1400,0
5370200170,20150217T000000,325000,2,1,1070,5080,1070,0
3885805896,20140610T000000,1.18E+06,5,3.75,3630,6000,2470,1160
9550200470,20141001T000000,690000,4,1.5,1970,4590,1970,0
6111400020,20150330T000000,410000,4,2,2010,9474,2010,0
5135000050,20140801T000000,960000,4,2.5,2820,5934,1770,1050
8029510010,20141030T000000,299250,3,2.5,2530,8669,2530,0
4438400050,20140714T000000,239000,2,1,710,14000,710,0
7831800460,20140502T000000,235000,2,1,1210,9400,1210,0
2425069069,20140527T000000,587000,3,2.25,2370,217800,2370,0
8029550020,20140701T000000,431000,4,2.5,2300,6087,2300,0
7533800170,20140707T000000,1.64E+06,3,2.5,3110,6765,2550,560
9460000010,20141203T000000,285000,3,1.75,1990,6500,1090,900
2600130020,20141106T000000,778000,3,3,2630,10156,2630,0
4037700285,20140731T000000,415000,3,1,1300,7975,1300,0
8682261190,20150112T000000,550285,2,1.75,1680,4500,1680,0
5453700020,20140825T000000,910000,3,2.25,2180,9865,1660,520
4139400630,20140529T000000,860000,3,2.5,2770,9136,2770,0
9550201495,20141003T000000,765000,3,1.75,2120,5000,1980,140
9808610190,20140509T000000,782000,4,2.5,2830,20345,1980,850
7443000514,20150310T000000,525000,3,3.5,1370,1764,1180,190
1823099056,20141222T000000,745000,3,2.5,2810,435600,2810,0
6055000010,20140725T000000,470000,3,3.5,3520,35512,2760,760
3878900225,20140602T000000,345000,3,1.75,1990,5650,1320,670
4222700130,20150304T000000,279000,3,2.25,2070,7800,1170,900
1124000010,20140711T000000,500000,3,1.5,1320,8100,1320,0
428000225,20140620T000000,237000,3,1,1300,8160,1300,0
8133300050,20140626T000000,200500,3,1.75,1260,9346,1260,0
2423039134,20150324T000000,387500,4,1.75,2400,9900,1250,1150
2726049150,20140717T000000,392500,4,2,1950,8040,1950,0
8074200080,20150213T000000,305000,3,2,1430,12430,1430,0
7856600170,20140924T000000,981000,4,2.5,2110,10100,2110,0
8649900440,20141209T000000,680000,4,2.5,2980,8770,2980,0
7696630170,20140605T000000,276000,4,2.5,2068,7242,2068,0
226039075,20140506T000000,655500,4,3.5,3380,8330,3380,0
3296000170,20141229T000000,555000,5,2.75,2810,13144,1440,1370
3223049073,20150413T000000,235000,2,1,930,10505,930,0
7300700050,20150219T000000,325000,3,1,1300,8879,920,380
9900000190,20141030T000000,268950,3,1,1320,8100,880,440
3751600635,20141110T000000,264500,3,1.5,1580,14040,1050,530
7575600430,20141110T000000,240000,3,2.5,1620,5250,1620,0
3223039109,20150220T000000,819000,3,2.5,2750,226512,2750,0
7151700190,20150331T000000,850000,2,1.5,2210,5000,1530,680
2076400050,20141022T000000,294950,4,2.25,1740,9600,1160,580
2162000190,20141215T000000,693000,3,2.25,2120,13644,1420,700
5226500250,20141015T000000,478000,4,2.5,2780,7290,2780,0
1787600294,20150205T000000,222000,2,1,830,6893,830,0
6388930170,20150408T000000,635000,4,2.5,2070,11286,2070,0
2767704332,20140930T000000,469000,3,3.25,1390,1278,1140,250
6699940250,20140725T000000,350000,4,2.5,2610,5866,2610,0
8151601190,20141203T000000,180000,5,1,1460,11726,1290,170
5561000420,20150408T000000,490000,4,2.25,3390,39356,1640,1750
3797001900,20140922T000000,360000,3,1.5,1360,6000,860,500
6641020050,20140618T000000,630000,4,2.5,2807,9430,2807,0
3232200095,20150414T000000,615000,4,1,1340,2006,1340,0
2310000440,20141027T000000,279950,3,2.25,1340,7202,1340,0
6414600321,20140611T000000,317000,3,1,1160,8813,1160,0
7199320190,20141016T000000,618000,4,2.25,2470,7350,1600,870
7922800190,20150311T000000,620000,5,1.75,2000,8713,1000,1000
9553200052,20140506T000000,345000,3,1,1110,6250,1110,0
4083802425,20141010T000000,608000,3,1.5,2240,3750,1220,1020
984000130,20141223T000000,325000,4,2.25,1920,11603,1920,0
2473002500,20141112T000000,475000,3,1.75,2270,13000,2270,0
3356403304,20141016T000000,154000,3,3,1530,9997,1020,510
8651200080,20140619T000000,1.19E+06,5,3,3330,19126,2610,720
1329300480,20141023T000000,376950,4,2.5,2643,5750,2643,0
1972201305,20140729T000000,500000,2,2,1250,3360,1250,0
425079001,20150423T000000,499950,3,2.5,3230,129578,2100,1130
9347900020,20150127T000000,230000,3,1,880,9035,880,0
1015000050,20150106T000000,652600,4,2.5,2220,5900,2220,0
9542802000,20141229T000000,185000,3,1.75,1130,7000,1130,0
8088600080,20140602T000000,274950,3,1,1450,8820,1050,400
5637500250,20150210T000000,447000,2,1,760,6035,760,0
87000213,20140613T000000,129000,2,1,1150,30184,1150,0
5104200470,20150325T000000,436000,5,3,2720,9856,2720,0
455000190,20141006T000000,825000,3,1.75,2080,5000,2080,0
3356403140,20141010T000000,225000,3,1,1080,16000,1080,0
4472000050,20150309T000000,265000,3,2.5,1890,6088,1890,0
5350200425,20150309T000000,765000,3,1.5,1500,5111,1500,0
3975400190,20141104T000000,509000,4,2,1960,2166,1260,700
9541600255,20150310T000000,762450,4,1.75,2570,8640,2570,0
5538300460,20141210T000000,465000,5,1.5,1830,9000,1030,800
7625700305,20140605T000000,564000,3,1.75,1980,6250,1090,890
2895600420,20150421T000000,384500,2,1,1130,5236,1130,0
2320069260,20141027T000000,415000,3,2,2010,33090,2010,0
7305300470,20141201T000000,345000,2,1.75,1820,8409,910,910
9477940440,20140617T000000,465950,4,2.5,2340,6896,2340,0
2561340020,20140804T000000,325000,3,1.75,1780,11096,1210,570
2561340020,20150217T000000,500000,3,1.75,1780,11096,1210,570
524069075,20141024T000000,450000,4,2.5,2450,20348,1410,1040
2296700050,20141010T000000,475000,4,3,2410,8284,1210,1200
4122900190,20140512T000000,1.35E+06,5,1.75,3380,20021,1690,1690
2754700095,20150316T000000,747000,3,1.5,1710,5120,1710,0
9265700005,20140822T000000,395000,3,1.75,1740,6220,1740,0
9826700726,20141006T000000,505000,3,2.5,1995,1483,1760,235
321049193,20141017T000000,215000,3,2,1760,9282,1100,660
1923099034,20150116T000000,775000,4,3.5,3970,210830,3970,0
4305600250,20141027T000000,540000,4,2.5,3000,5471,3000,0
6648100010,20141119T000000,392500,3,1.75,1540,8925,1540,0
5536100020,20141215T000000,987000,3,2,2160,15788,2160,0
5536100020,20150512T000000,1.19E+06,3,2,2160,15788,2160,0
5104450440,20141113T000000,252500,3,2,1810,10684,1810,0
7560000050,20150423T000000,730000,3,3.5,2440,3502,1970,470
7784400130,20140505T000000,497300,6,2.75,3200,9200,1600,1600
7298900010,20140924T000000,640000,4,2.5,2970,34981,2970,0
259601100,20140513T000000,580000,5,2,2290,7125,1190,1100
8041100010,20140818T000000,377000,3,1.75,1820,34800,1820,0
5318100840,20140606T000000,1.28E+06,4,3.5,3010,3600,2370,640
2771101964,20140812T000000,396500,3,1.5,1360,1488,1120,240
1560870470,20140731T000000,300000,4,2.5,2080,2999,2080,0
1232000950,20150312T000000,532000,3,1,1110,4800,1110,0
8682261440,20150113T000000,579000,2,1.75,1560,4500,1560,0
1370801440,20150325T000000,1.40E+06,4,2.5,3520,7815,3140,380
7680400050,20141022T000000,571000,5,1.75,2280,43560,1380,900
6928000440,20140718T000000,301950,3,1.75,1370,9288,1370,0
3797000290,20140612T000000,660000,3,3,2340,2970,2160,180
9264030470,20140611T000000,455000,4,2.5,3170,10688,3170,0
6300000396,20141216T000000,375000,3,1.75,1380,5060,1380,0
1786700080,20150115T000000,470000,4,2.5,2700,6769,2700,0
5116000170,20150331T000000,374990,3,2.5,1300,10484,1300,0
8682282210,20150417T000000,541500,2,2.5,1900,3690,1900,0
8651611640,20150424T000000,782500,3,2.5,3750,7821,3750,0
8946750020,20150507T000000,264000,3,2.25,1552,3677,1552,0
1939130420,20140715T000000,640000,4,2.5,2500,7417,2500,0
7640400190,20150213T000000,660000,3,2,1770,8141,1770,0
4139420430,20140611T000000,1.37E+06,5,3.5,4210,17258,4210,0
1509500080,20150317T000000,389950,3,2.5,2170,8140,2170,0
6341000020,20150304T000000,226000,2,1,1510,19874,1510,0
1022069071,20140808T000000,390000,3,1.75,1870,40250,1870,0
8078400020,20150223T000000,485000,3,2.25,1570,8111,1570,0
9113200250,20150413T000000,840000,4,2.5,2480,4602,2480,0
1592300010,20140926T000000,600000,5,3.5,3580,21343,2140,1440
9250900095,20140819T000000,331000,2,1,1480,6210,1080,400
8815400670,20141016T000000,780000,3,2,2610,6000,1310,1300
7212680080,20141015T000000,300000,3,1.75,1700,8481,1700,0
2968801315,20140917T000000,361810,3,1.75,1240,7620,1240,0
6141100255,20140515T000000,467000,3,1,1660,6582,1000,660
8068000440,20141226T000000,399000,3,1.75,1620,10000,1620,0
7883605900,20141015T000000,315450,3,1.75,1130,7500,1130,0
9521101315,20150501T000000,600000,3,1,1310,5000,1310,0
8651442910,20150325T000000,247500,4,2,1710,5200,910,800
8113101233,20150130T000000,330000,3,1,2140,5037,2140,0
7016200460,20140826T000000,500000,4,2.25,2350,7210,2350,0
4189800020,20140820T000000,367500,3,1,1570,10050,1570,0
5506500170,20140912T000000,560000,3,2.5,2780,32880,2780,0
5135000170,20140806T000000,655000,4,1.75,2540,7620,1320,1220
8155500020,20141018T000000,530000,5,2.75,2500,7140,1250,1250
2597501190,20150512T000000,270000,3,2.25,2080,26574,1380,700
5288200225,20141125T000000,437500,3,2,1760,2875,1290,470
6189200050,20150203T000000,575000,3,1.75,1760,10349,1760,0
6664900470,20141107T000000,278000,4,2.5,1940,6887,1940,0
7954300460,20140904T000000,568500,4,2.5,3010,6181,3010,0
8018600655,20150326T000000,280000,4,3,2460,9606,2460,0
2508000020,20140819T000000,250000,2,1,750,6350,750,0
1424059130,20150318T000000,247500,3,0.75,1300,72309,680,620
7856660130,20141204T000000,1.25E+06,5,2.75,3710,13874,2340,1370
5302400080,20141015T000000,535000,4,2.5,2360,15008,1920,440
3026059368,20140711T000000,814842,3,2.5,3190,6899,3190,0
3275910020,20150213T000000,340000,4,2.5,2181,5521,2181,0
2229900020,20140610T000000,359950,3,1.75,1890,9100,1890,0
7748000020,20140621T000000,750000,3,1.75,2610,5544,1680,930
7457000005,20140926T000000,1.22E+06,4,2,3090,8125,3090,0
9268200285,20140703T000000,370000,2,1,860,5040,860,0
1328330780,20150415T000000,329950,3,1,1000,9170,1000,0
7806450190,20150102T000000,500000,3,2.5,2760,35171,2760,0
626400020,20140918T000000,734000,4,2.5,3490,18521,3490,0
5416510920,20140616T000000,385000,4,2.5,2960,5054,2960,0
3330500345,20150420T000000,230000,2,1,1280,4635,840,440
3885801190,20140730T000000,1.39E+06,4,3.5,3230,7200,1640,1590
1035000007,20141218T000000,210000,3,2,1830,4992,1230,600
1471701470,20140731T000000,293000,3,1.75,1420,13187,1420,0
7519000225,20141030T000000,465000,3,1,1580,3774,1580,0
1433290010,20150112T000000,449000,3,2.25,1960,44634,1130,830
1223049150,20150414T000000,325000,2,1.75,1670,10725,1670,0
5198600010,20140819T000000,180000,3,2,1670,7056,1670,0
4310703070,20150413T000000,650000,6,3,2960,5000,1790,1170
6154900005,20140924T000000,665000,4,2.75,2420,7102,1670,750
3541700170,20141017T000000,324450,3,2,1420,16000,1420,0
952001495,20150306T000000,588000,4,1.75,2170,5750,1370,800
8122600020,20140521T000000,200000,4,1,1310,5200,1160,150
3579700080,20140905T000000,383000,4,1.75,1830,11090,1060,770
2769602140,20141215T000000,499950,3,2,1360,2500,730,630
5152920170,20150421T000000,549000,5,2.5,3440,12350,1760,1680
3226049530,20150122T000000,465000,5,3,2010,7264,1290,720
4017050020,20140814T000000,450000,3,2.5,2450,19744,2450,0
3982700250,20150423T000000,799900,4,2.5,3030,7800,1580,1450
2523069134,20150406T000000,495000,4,2.5,2480,91911,1470,1010
7281300010,20140822T000000,1.20E+06,3,3.5,4310,10842,3140,1170
3396800280,20150223T000000,637000,4,2.5,2120,15000,2120,0
7234600851,20141216T000000,589000,4,1,2210,4366,2210,0
7418000020,20140724T000000,305000,3,1.75,1400,10350,1400,0
7548300170,20150331T000000,600000,4,2.25,2760,5200,1790,970
1446300020,20140531T000000,587000,4,2.5,2550,6256,2550,0
4385700425,20140505T000000,1.43E+06,2,2.5,2220,4000,2220,0
16000545,20150312T000000,250000,4,1,1320,11212,1320,0
7996720050,20150424T000000,515000,3,3,2440,3202,1640,800
8691310840,20140509T000000,833000,4,2.75,3780,10308,3780,0
4309700130,20140604T000000,860000,3,3.25,4720,32467,3190,1530
5100401060,20140908T000000,550000,4,3,2360,6678,1760,600
1180002580,20150319T000000,180000,2,1,890,6000,890,0
3379100130,20140618T000000,507000,4,1.75,1770,9375,1170,600
8645900080,20140827T000000,427000,3,2,1720,128066,1720,0
7569500010,20141120T000000,616950,3,3.5,2490,2722,2020,470
8026200080,20140715T000000,372000,4,1.75,1890,10550,1010,880
5101404555,20141006T000000,290000,2,1,1020,6380,1020,0
9432900250,20150309T000000,329990,4,2.75,2420,8438,2420,0
3995700250,20141013T000000,393500,3,1.75,1600,8156,1600,0
2574900080,20140513T000000,1.55E+06,5,3.25,3370,17458,2000,1370
8731982630,20140522T000000,240000,4,2.25,1720,8300,1720,0
2968800660,20140513T000000,285000,3,1,1090,8640,1090,0
2872900010,20150414T000000,382500,3,1.5,1090,9862,1090,0
1118000080,20150331T000000,1.93E+06,4,3.75,3600,16101,3600,0
8923600185,20140829T000000,800000,3,2.5,2760,9471,1760,1000
1725059252,20150402T000000,550000,4,3.5,2770,24140,2770,0
3818700190,20141215T000000,387846,4,1.75,2520,15205,2040,480
5125400305,20140821T000000,367500,4,2,1960,16015,1960,0
4232400010,20140804T000000,780500,5,1,1760,4264,1760,0
5100402606,20150505T000000,680000,3,1.75,1090,6775,850,240
3876300080,20141224T000000,434400,5,1.75,1960,7875,1960,0
1246700050,20140612T000000,370000,2,1,1220,17172,1220,0
1837010010,20150313T000000,465000,3,1.75,1730,8073,1350,380
1328320280,20150327T000000,323000,3,2,1830,6925,1830,0
5468760050,20150105T000000,270000,4,2.5,1600,9921,1600,0
5556300114,20141219T000000,1.32E+06,3,1.75,2040,42693,2040,0
2316800020,20140627T000000,560000,4,2.5,2710,6583,2710,0
7133300675,20150428T000000,450000,3,1,1140,4500,840,300
751000020,20140626T000000,290000,2,1,930,7740,930,0
3578400670,20140924T000000,354000,3,2,1010,21340,1010,0
2767603890,20150304T000000,705000,5,3,2380,5000,2380,0
9477000190,20140808T000000,445000,3,2.25,1860,7200,1240,620
2268000500,20140721T000000,229900,3,1,1440,11925,1440,0
7202271060,20150310T000000,610000,4,2.5,2980,5896,2980,0
7852020080,20141210T000000,535000,3,3.25,2670,5108,2670,0
3298400470,20150204T000000,437400,3,1.75,2150,8925,2150,0
8854000010,20140812T000000,540000,5,2.75,3160,10059,1740,1420
1624059093,20140630T000000,570000,3,2,1890,29185,1470,420
8564950280,20141009T000000,533000,3,2.5,2810,4607,2810,0
7853230460,20150403T000000,555000,3,2.5,2690,4819,2690,0
1796350080,20140623T000000,239950,3,1.75,1230,9600,1230,0
9477200460,20150108T000000,350000,3,1,950,9451,950,0
7972601995,20140616T000000,245000,2,1,1200,4880,980,220
1454100440,20140605T000000,456000,4,1.75,1670,9886,1670,0
2558690130,20140813T000000,465000,4,2.25,2140,7701,1470,670
8682310470,20150107T000000,445000,2,1.75,1440,4660,1440,0
3876000440,20140728T000000,517850,5,2.75,3050,7500,1800,1250
4137070440,20140930T000000,329000,5,2.75,2570,7260,2570,0
2391602500,20140515T000000,512500,3,2.5,1840,2875,1840,0
8632100010,20140604T000000,365000,2,1,1250,8100,1250,0
3034200426,20150320T000000,450500,3,1,1410,9384,1410,0
5078400190,20141016T000000,915000,3,1,1560,8232,1560,0
1450100420,20140620T000000,205000,3,1,960,7314,960,0
1853500290,20140811T000000,314000,4,2.5,1870,8449,1870,0
8133700020,20140702T000000,496000,2,1,900,9260,900,0
723059073,20150416T000000,329950,4,1,2050,7590,1280,770
2374200005,20140616T000000,375000,4,2,2400,6000,2400,0
7420200050,20140620T000000,623000,3,2.5,1850,7777,1850,0
7211350130,20140619T000000,310000,4,1.5,1220,9600,1220,0
7802900500,20150304T000000,532500,3,3.25,3140,37120,1760,1380
8081900101,20140528T000000,960000,4,2.25,2410,4560,1800,610
9510300130,20140628T000000,598000,4,2.5,3130,40918,3130,0
8582010290,20140814T000000,683000,3,2.5,2300,9218,2300,0
4023500352,20150217T000000,425000,5,2.5,2840,9425,1590,1250
9482700440,20140506T000000,533000,5,2.75,1800,3780,1400,400
6117502455,20140513T000000,375000,3,1,1190,9486,1190,0
2791500020,20140604T000000,250500,3,2,1710,7225,1710,0
5643600351,20140806T000000,257000,4,1.75,1900,22896,1360,540
4059400585,20140624T000000,218000,3,1,880,18205,880,0
9285800585,20140611T000000,460000,3,2,2060,4437,1030,1030
5727500561,20150414T000000,255544,3,1,1360,6186,760,600
8682310430,20140914T000000,560000,2,2,1680,4647,1680,0
3782760170,20150211T000000,480000,4,2.5,2980,4074,2980,0
1925059073,20141010T000000,1.30E+06,5,1.75,2130,19180,1500,630
6891800500,20150426T000000,580000,3,2.75,2650,9752,2650,0
4319200605,20140628T000000,475000,3,2.5,1700,9100,1160,540
6117500460,20140630T000000,1.31E+06,4,2.5,2680,12215,1590,1090
522079022,20150327T000000,700000,3,2.5,2530,623779,2530,0
3066410080,20140917T000000,590000,3,2.5,2520,10223,2520,0
4137000280,20150222T000000,264500,3,2.5,1630,8346,1630,0
2767600920,20141027T000000,465000,2,1,730,2600,730,0
7972601680,20150323T000000,290000,3,1,910,7620,910,0
1725059136,20141121T000000,1.82E+06,4,4.5,4510,12873,4510,0
4037000080,20140615T000000,416000,3,1,1110,12150,1110,0
3580900290,20150128T000000,360000,4,2,1450,8940,1450,0
7527410080,20140602T000000,585083,5,2.75,2910,36250,1590,1320
2653000005,20140512T000000,840000,4,2.75,2600,2750,1620,980
3028200080,20150324T000000,81000,2,1,730,9975,730,0
4218400005,20150130T000000,1.29E+06,3,2.25,2440,9200,2440,0
4058802335,20141125T000000,326000,4,1.75,2290,7380,1390,900
2487200680,20150224T000000,447000,2,1,720,7500,720,0
1950900005,20141003T000000,185000,3,1,940,7125,940,0
6647400250,20140723T000000,439950,3,2.5,1540,7773,1540,0
9407000920,20141001T000000,234000,3,1.5,1140,10300,1140,0
8617000020,20141231T000000,485000,4,2.5,2100,8886,2100,0
1193000190,20140715T000000,750000,4,1.75,2670,6250,2020,650
7443000480,20150507T000000,865000,4,2,2750,5527,2130,620
2557000380,20140618T000000,287500,4,2.5,2570,9000,1590,980
4450700010,20140708T000000,375000,3,1.75,1660,9673,1130,530
1236300307,20140905T000000,565000,3,2.25,1700,8800,850,850
3422059249,20150219T000000,260000,4,3,1530,8306,1530,0
9476200290,20141017T000000,190000,3,1,1260,10900,1260,0
3812400898,20140909T000000,399950,5,2,2760,6420,1380,1380
5422420470,20150326T000000,275000,3,2.5,1830,7062,1830,0
2492200280,20141202T000000,528000,3,2.75,2160,4086,1380,780
4331000130,20141017T000000,315000,3,2,1770,9685,1770,0
6073500190,20140821T000000,614306,2,2.25,2210,5500,1410,800
9522300010,20150331T000000,1.49E+06,3,3.5,4560,14608,4560,0
3629910470,20140729T000000,590000,3,2.5,2110,3870,2110,0
1250200285,20150317T000000,261500,3,1,1130,3600,1130,0
1509700050,20140523T000000,300000,4,2.5,1960,9898,1960,0
2045800006,20140904T000000,439000,3,2.25,2230,4551,1450,780
2171400199,20140904T000000,277554,5,2.25,2350,13000,2350,0
2123049502,20140623T000000,215000,3,2,1340,8505,1340,0
284000095,20140922T000000,1.20E+06,2,2.25,2160,17861,2160,0
5652600427,20150224T000000,420000,4,2,1700,6375,850,850
7202330470,20150408T000000,485000,3,2.5,1650,3436,1650,0
6131600255,20141222T000000,202500,3,2,1540,8316,1540,0
7853301660,20150223T000000,710000,5,3.25,3920,8572,3920,0
9211010440,20150430T000000,535000,4,2.5,3250,6933,3250,0
1423900080,20141218T000000,260000,4,1.75,1360,7700,1360,0
2215901190,20140528T000000,254000,3,2,1480,7480,1480,0
251100020,20140521T000000,600000,4,2.5,2360,5226,2360,0
3395041206,20140925T000000,285000,3,2.5,1800,2516,1800,0
224069169,20141023T000000,800000,4,3.75,2540,20662,2540,0
3365901435,20140623T000000,165000,3,1,1200,13100,1200,0
7689600630,20141106T000000,216500,2,1,710,6960,710,0
3158500290,20140919T000000,387990,4,2.5,2640,5595,2640,0
7189800095,20141104T000000,500000,4,2.5,3010,5040,3010,0
7202270440,20141023T000000,650000,4,2.5,2770,5612,2770,0
3501600114,20140619T000000,646000,4,2.5,2310,4079,2310,0
8097000250,20150130T000000,323400,4,3,2060,9138,1430,630
9542830430,20140806T000000,300000,3,2.5,1880,4200,1880,0
6012500170,20141007T000000,712500,5,2,2280,5400,1340,940
7217400895,20140609T000000,550000,3,1.75,1380,3402,1380,0
2651100050,20150217T000000,400000,3,1,1180,7537,1180,0
2212200050,20141028T000000,255000,4,1.75,1650,7200,1100,550
7922900460,20141205T000000,660000,3,1.75,2030,9032,2030,0
8925100440,20150323T000000,925000,4,2.25,2110,6375,1600,510
259800680,20140805T000000,534000,4,2.25,2130,7210,1330,800
271200130,20141119T000000,215000,3,1,1690,7700,1690,0
3760500280,20141014T000000,1.95E+06,3,2.5,2510,12779,2510,0
5315100277,20140513T000000,1.40E+06,5,4.25,3530,7924,3530,0
9265410010,20150203T000000,212000,3,1.75,1470,8350,1470,0
8731800840,20140619T000000,265000,3,1.75,1840,7300,1840,0
7579200715,20141205T000000,400000,3,1.75,1860,5750,1300,560
9485300010,20150213T000000,311500,4,2.5,1940,10133,1940,0
1652500010,20150326T000000,2.33E+06,4,3.5,4420,20759,4420,0
4059400190,20141017T000000,225000,2,1,800,6050,800,0
8965510190,20140610T000000,1.25E+06,4,2.5,3700,21755,2620,1080
7100000250,20150211T000000,380000,3,1,1400,8710,1400,0
2541100010,20140708T000000,600000,4,2.5,2250,11370,2250,0
7732410130,20140521T000000,600000,3,2.25,2230,9053,2230,0
7889600285,20141218T000000,315000,3,2.5,1950,3000,1950,0
1556200005,20140603T000000,847000,5,1,2550,4623,2550,0
8691310980,20150409T000000,730000,4,2.5,2750,10351,2750,0
1561600095,20140514T000000,1.06E+06,4,2,2290,11137,2290,0
3025300250,20150513T000000,1.62E+06,4,2.25,2350,17709,2350,0
5297200089,20150415T000000,664000,2,1.75,1720,5785,860,860
3303860630,20150427T000000,454450,4,3,2810,6000,2810,0
6430500086,20150116T000000,341000,3,1,940,4200,940,0
4025300285,20141029T000000,276693,4,1,1190,8875,1190,0
923049400,20141119T000000,185000,2,1,1390,11340,1390,0
5466300130,20140917T000000,160000,2,2.5,1660,2258,1660,0
4136900250,20140602T000000,270000,4,2.5,1920,8497,1920,0
7635800313,20140718T000000,300000,4,1.5,1460,8760,1460,0
2938100005,20140829T000000,264950,3,1.5,1370,10115,1370,0
796000235,20150401T000000,209950,2,1,1050,6250,840,210
8682280170,20150330T000000,850000,3,2.5,3360,8708,3360,0
7504110780,20140516T000000,645000,4,2.5,3160,11380,3160,0
1445500010,20150113T000000,855000,4,2.25,2480,36974,2480,0
7574910420,20141201T000000,632500,4,1.5,2720,37258,2720,0
2115720130,20140821T000000,289950,3,2.5,2070,5013,2070,0
3586500630,20140924T000000,850000,2,1.75,2170,25732,2170,0
9475960050,20140620T000000,565000,4,2.75,3260,4900,3260,0
7527000020,20150425T000000,792000,3,2.5,2250,19270,2250,0
3668000500,20141222T000000,260000,3,2.25,1950,9600,1200,750
1549500585,20150427T000000,585000,3,2,2220,209523,2220,0
8898700680,20140730T000000,295500,3,1.75,1330,10523,1000,330
6163901061,20141211T000000,329000,4,2,1190,7877,1190,0
7855600080,20150330T000000,750000,3,1.75,2770,15232,1570,1200
4024100807,20150225T000000,495000,4,2.5,2310,7555,2310,0
5037300130,20150504T000000,672500,3,1.75,1580,5750,1330,250
3528900086,20140508T000000,1.31E+06,5,3.25,2800,3200,1910,890
1552520010,20140801T000000,405000,3,2.5,1500,9636,1500,0
5113400168,20150116T000000,620000,3,1.75,2140,5808,1070,1070
9346900170,20140922T000000,615000,4,2.25,2330,7020,1450,880
3999300080,20140904T000000,887000,6,2.25,3830,11180,2440,1390
472000895,20140922T000000,1.06E+06,4,2.75,4510,5000,3270,1240
687600010,20140805T000000,753000,4,1.75,2160,39430,1660,500
1130000005,20140715T000000,1.60E+06,3,2.25,3170,5000,2230,940
7397300170,20140530T000000,3.71E+06,4,3.5,5550,28078,3350,2200
1077100020,20141231T000000,365000,3,1.5,1520,8519,1520,0
7856570190,20140822T000000,870000,4,2.75,3410,23000,3410,0
5104510010,20140701T000000,321000,4,2.5,1830,9601,1830,0
2895550050,20150507T000000,280000,3,2.5,1550,4486,1550,0
4142450480,20140703T000000,288000,3,2.5,1520,3593,1520,0
5559200020,20150227T000000,248500,3,2,1240,12285,620,620
5381000352,20140622T000000,330000,4,2.5,2380,13550,2380,0
2474300050,20140722T000000,740000,5,3.5,2720,11454,1830,890
7787110680,20140923T000000,445000,3,2.5,2210,8010,2210,0
1788700185,20150306T000000,198500,2,1,1050,9600,1050,0
2887950020,20140625T000000,280000,7,2.5,1940,5458,1940,0
8835210480,20140710T000000,336500,3,2.25,1420,3433,1420,0
844000225,20150211T000000,267000,3,2.5,1690,10336,1690,0
1771000430,20140502T000000,315000,3,1,1160,9180,1160,0
8078430480,20140806T000000,545000,4,2.5,2040,7412,2040,0
8001450170,20140804T000000,274950,3,1.75,1840,16679,1840,0
8924100430,20141224T000000,500000,2,1,1440,7130,1210,230
7418700050,20140528T000000,299000,3,1,1390,9624,1390,0
3630020430,20150505T000000,420000,3,2.5,1470,1445,1160,310
1972200725,20150407T000000,620000,3,2.5,1776,1248,1604,172
267000170,20141210T000000,575950,3,2.25,1640,12000,1180,460
8961980290,20140904T000000,666500,4,2.5,2860,6600,2860,0
1551500130,20140522T000000,180000,4,1.5,1740,7292,1020,720
5557800010,20140623T000000,261350,3,1.75,1390,18200,1390,0
3776300010,20150224T000000,1.03E+06,4,3.5,2730,5607,1660,1070
2473000680,20150429T000000,390000,3,1.75,1435,8960,1435,0
7984400005,20140626T000000,253500,3,1,1640,12384,1090,550
9238430680,20140521T000000,625000,4,2.5,2630,48706,2630,0
3211000170,20140922T000000,255000,4,2.5,1580,7800,1580,0
7338220280,20141010T000000,257000,3,2.5,1740,3721,1740,0
8073000480,20140722T000000,869000,2,1.75,1900,13122,1100,800
7525530670,20141112T000000,745000,4,2.5,3130,10860,3130,0
191100275,20140926T000000,1.35E+06,4,3.5,3500,9525,3500,0
1214000050,20141020T000000,350000,3,1.75,2130,7500,1090,1040
6852700279,20140619T000000,475000,3,2.5,950,1110,950,0
5423600080,20140918T000000,540000,3,2.5,1720,11656,1720,0
6661200050,20140528T000000,175000,2,1,830,2699,830,0
6146600170,20140703T000000,100000,2,0.75,660,5240,660,0
366000095,20141009T000000,890000,5,1,2590,4652,2310,280
2895550280,20140507T000000,280000,3,2.5,1600,4271,1600,0
293760050,20140627T000000,1.05E+06,4,4.25,4390,13833,3320,1070
7298040500,20140709T000000,486000,4,2.5,3560,12047,3560,0
7802900224,20140707T000000,670000,5,2.5,2860,68519,2860,0
3904910010,20140723T000000,480000,3,2.5,1640,7847,1640,0
8121100255,20140507T000000,440000,3,1.75,1500,6180,1060,440
5700004040,20140905T000000,1.50E+06,3,3.25,3990,8505,2870,1120
3528000290,20140609T000000,743700,4,2.5,2610,33206,2610,0
9268200050,20140814T000000,449950,3,1.75,1470,7590,1470,0
6132600221,20140519T000000,367000,2,1,700,2334,700,0
3303980470,20141201T000000,1.19E+06,4,3.25,3960,12895,3960,0
1450000050,20150501T000000,201000,3,1,900,7576,900,0
6788200605,20141223T000000,575000,3,1.75,2010,3800,2010,0
2214800170,20150415T000000,295000,3,2.5,1940,10350,1420,520
7116000225,20150220T000000,190000,3,1,1510,8760,1510,0
2767600635,20150507T000000,742500,2,3,2020,5000,1350,670
1644500050,20150312T000000,875000,6,3.5,4430,11453,3000,1430
2579500101,20150421T000000,1.39E+06,4,3.5,4010,10880,3150,860
3876311650,20140619T000000,600000,4,2.25,3070,8400,3070,0
7984400050,20140922T000000,207000,3,1.5,1460,11100,1460,0
7852170130,20150421T000000,650000,4,2.75,3260,5335,3260,0
9358000780,20150512T000000,275000,2,1,830,5610,830,0
2663000345,20150408T000000,1.20E+06,4,2.5,2390,4200,2150,240
4338800500,20141014T000000,262500,3,2,1130,7200,1130,0
5101407350,20140925T000000,399000,2,1,1120,8661,1120,0
3512100050,20150224T000000,139000,4,1.5,1410,10648,1410,0
6633900050,20140826T000000,575000,3,2.5,1750,4797,1750,0
4083301950,20141120T000000,580000,2,1,1040,3200,1040,0
7202350010,20140725T000000,468000,3,2.25,1630,2490,1630,0
4168100130,20150310T000000,230000,3,1,1380,10112,940,440
8155850010,20140507T000000,675000,4,4,3680,18804,3680,0
7955030010,20141010T000000,318000,3,1,1250,20040,1250,0
4136870020,20141008T000000,332100,5,3.5,2660,6978,1980,680
1446401190,20150317T000000,175000,2,1,620,6600,620,0
9323600380,20140805T000000,817000,4,2.25,2600,10660,2600,0
3262300920,20150408T000000,1.20E+06,4,3,2150,8119,2150,0
6332000130,20150420T000000,525000,3,1.75,1470,6550,1070,400
9150100020,20150211T000000,189000,3,1,1380,7282,1380,0
2770604081,20150305T000000,629950,3,2.5,1680,1683,1120,560
6329000050,20150310T000000,641500,1,1,1000,9084,1000,0
2125400010,20140912T000000,490000,3,2.25,1630,7573,1230,400
3876313260,20150218T000000,415000,3,1.75,1790,15142,1360,430
5101400561,20141015T000000,250000,2,1,890,6380,890,0
9533100080,20140820T000000,781000,3,1.5,1290,8175,820,470
9561100080,20140620T000000,400000,4,2.25,2420,7927,1400,1020
5101402618,20140820T000000,935000,4,3,3680,7105,2890,790
4027700009,20140515T000000,575000,4,2.5,3020,17810,1600,1420
9544200277,20141015T000000,1.66E+06,4,3.25,4240,11189,4240,0
8731960050,20141229T000000,302300,5,2.75,3130,9450,1580,1550
1393800005,20150507T000000,355000,2,1,900,6656,900,0
3896100130,20140617T000000,1.54E+06,3,2.25,2880,7599,1710,1170
7785000130,20150330T000000,926250,4,1.75,2390,17717,2390,0
2968800825,20150323T000000,300000,3,1.75,1450,7620,1050,400
7199330480,20140721T000000,361500,3,1.75,1070,9000,1070,0
5458800415,20141105T000000,616000,3,1.5,1740,9840,1740,0
8929000250,20150413T000000,395000,2,1.75,1210,1161,1210,0
7893206305,20141006T000000,245000,3,1.5,2100,10000,2100,0
7956300020,20140603T000000,206000,3,1,1060,9600,1060,0
240000130,20141013T000000,706000,4,2.5,3280,16575,2190,1090
1370803730,20150126T000000,578000,3,1.5,1660,6000,1660,0
4299000130,20140728T000000,341950,5,3,3070,5252,3070,0
1233100351,20141211T000000,305000,3,1,1150,9048,1150,0
2652500225,20141010T000000,575000,3,2.75,1710,3600,1590,120
3224069026,20140520T000000,330000,3,1,1180,43124,1180,0
2592400250,20150107T000000,445000,4,2.25,2130,7200,2130,0
4364700595,20140818T000000,333000,3,1,1050,7560,1050,0
8562750660,20140807T000000,598500,4,2.5,2520,3980,2520,0
7231600098,20141014T000000,225000,2,1,700,6000,700,0
8635750980,20140714T000000,570000,4,2.5,2640,4200,2640,0
5652600605,20140807T000000,630000,5,2,2330,6783,1310,1020
2141310020,20150416T000000,779000,5,2.25,2830,7738,2830,0
7852160080,20150121T000000,760000,4,3.5,3720,13591,3720,0
3649100346,20150109T000000,322968,5,1.75,1890,9600,1890,0
7852010840,20140729T000000,595000,4,2.5,2910,7287,2910,0
823059145,20141013T000000,321000,4,1,1300,18836,1300,0
9238430660,20150326T000000,653000,3,2.25,2770,57745,2770,0
6329000190,20140729T000000,750000,4,1.75,2520,21834,1420,1100
8818900250,20140507T000000,530000,3,1,1340,4284,1080,260
1250200415,20140609T000000,352750,2,1.75,1060,1241,960,100
3303951150,20150204T000000,424950,4,2.5,2480,8563,2480,0
3083000048,20140530T000000,427000,5,2.75,2220,4000,1230,990
1102000095,20140805T000000,558000,4,2.5,3220,5120,2420,800
3426049153,20141110T000000,438200,2,2,1600,5643,1600,0
7625700020,20140929T000000,340000,1,1,640,4800,640,0
586000020,20140828T000000,830005,4,3.75,3610,7904,3290,320
8724300010,20140909T000000,548000,4,3.25,3420,5012,2330,1090
2741100741,20140604T000000,411715,3,1.75,1840,5101,1040,800
3425059173,20141028T000000,865000,4,4,2790,16117,2790,0
715010130,20150202T000000,1.75E+06,6,4.25,5860,13928,4150,1710
7504100920,20140618T000000,688000,3,3,3450,16200,3450,0
5104520460,20150317T000000,399950,4,2.5,2350,5100,2350,0
1257200020,20150327T000000,555000,3,1,1250,4590,970,280
4452300130,20140522T000000,677000,3,2,2000,3207,1100,900
8651520420,20140606T000000,539000,3,2,2260,9568,1780,480
6401700010,20140819T000000,410000,3,1.75,1510,6597,950,560
8857320130,20150310T000000,472000,2,2.25,1800,2748,1800,0
1102000759,20141026T000000,755000,3,2.5,2420,8856,1620,800
6457000080,20140805T000000,269900,5,1.75,1750,8325,1750,0
1126059022,20140722T000000,667400,4,2.5,2660,40312,2660,0
4340000010,20141030T000000,1.22E+06,3,2.25,2640,7544,2640,0
3052700460,20140630T000000,544000,3,2.5,1460,1613,1180,280
567000020,20150428T000000,800000,2,1,1570,5000,1570,0
3575304017,20140822T000000,315000,3,1,1010,7500,1010,0
7812801700,20140610T000000,227000,4,1,1200,7200,1200,0
5103300020,20141020T000000,765000,4,2.5,4040,25752,4040,0
9578080130,20140702T000000,625000,3,3,1820,1641,1540,280
3885803044,20140902T000000,1.88E+06,4,5,5810,7440,3790,2020
9323600280,20150211T000000,822600,4,2.5,3010,9600,1510,1500
7016100380,20150423T000000,515000,4,2.5,1910,8947,1160,750
3438500114,20150512T000000,377000,4,2,1640,5014,930,710
2597800010,20150304T000000,600000,3,1,1480,17360,1480,0
8018000020,20141114T000000,525300,4,1.75,2520,7770,1680,840
4055700167,20140814T000000,760000,4,3,2840,13554,1990,850
1863900190,20141229T000000,202000,2,1,840,7200,840,0
522079027,20140619T000000,470000,3,2,1730,38884,1730,0
7525530470,20140725T000000,810000,3,2.5,3140,10983,3140,0
8858100020,20150316T000000,175000,3,1,1480,8415,1080,400
6414100231,20141015T000000,440000,4,1.75,1920,7986,960,960
6303400460,20150330T000000,197000,2,1,770,8636,770,0
9476200020,20150306T000000,254000,3,1,1010,7384,1010,0
3575302938,20140620T000000,405000,3,1,1460,10000,1460,0
2695600190,20150327T000000,416000,2,1,940,4264,940,0
9433000470,20140919T000000,779950,4,2.75,2840,4864,2840,0
7140200250,20150112T000000,200000,4,2.75,1910,7210,1430,480
3905090130,20140717T000000,658100,4,2.5,2430,8509,2430,0
3335000050,20140714T000000,397000,2,1.75,1610,4104,950,660
4397650080,20141015T000000,815000,3,3.75,2780,5002,2780,0
1568100380,20141016T000000,345000,2,1,1160,8504,1160,0
8078570460,20140924T000000,305500,4,2.5,1850,7199,1850,0
6382000080,20140708T000000,340000,3,2.25,2120,13090,2120,0
7905380080,20150226T000000,330000,5,2.5,2620,12763,1400,1220
6600490250,20150421T000000,269000,4,2.5,2060,3608,2060,0
7200001756,20140612T000000,349950,3,1,1060,9525,1060,0
4427100130,20150304T000000,431000,3,1,1500,6240,1500,0
5606000255,20141017T000000,735000,4,1.75,2380,5700,1820,560
1402700170,20140717T000000,414000,5,3,3045,5030,3045,0
5366200460,20140520T000000,619500,3,2.5,1700,4105,1700,0
1245500725,20141030T000000,675000,3,1.75,1240,13869,1240,0
9477201060,20150423T000000,380500,3,1,1410,7854,1410,0
4060000290,20140617T000000,253000,3,1.5,880,6600,880,0
522059327,20140528T000000,157500,2,1,740,9003,740,0
686530020,20140609T000000,627000,4,2,2030,9300,2030,0
5145100460,20140924T000000,469500,4,2.5,2090,7241,1140,950
6329000380,20140619T000000,319950,2,1,920,8341,920,0
8960200280,20150218T000000,249500,3,1,1180,7200,1180,0
2867100007,20150223T000000,485000,3,1,1260,3230,1260,0
9542100005,20141024T000000,1.13E+06,5,3,3690,10260,2070,1620
1545807280,20140628T000000,314500,3,1.75,1700,17355,1200,500
3996900460,20150403T000000,220000,2,1,770,8149,770,0
217500005,20141124T000000,444950,3,2.5,2020,7800,1330,690
1513800080,20140825T000000,598000,4,2.5,2030,9825,1330,700
8691390460,20140616T000000,699850,4,3.5,2690,6164,2690,0
6633900170,20140508T000000,595000,3,2.5,1750,3354,1750,0
205000050,20141218T000000,735000,4,2.5,3270,45537,3270,0
8838900167,20140509T000000,542500,4,2.5,2330,14289,2330,0
7199330170,20150512T000000,450000,3,1.75,1720,6960,1140,580
236500050,20140728T000000,298500,3,2,2420,8800,1420,1000
2025049028,20140609T000000,403950,2,1,710,1136,710,0
3298700305,20141229T000000,271000,2,1,710,4240,710,0
6145600780,20140911T000000,335000,2,1,1510,3844,1510,0
1332700010,20141216T000000,305000,2,2.25,1610,1968,1610,0
2768300655,20150317T000000,630000,3,3,1880,2200,1520,360
7224500010,20140603T000000,253000,2,1.75,1220,5000,860,360
4037000185,20140919T000000,395000,4,1.75,2060,7900,1070,990
7614100020,20141017T000000,265000,3,2.5,1340,10290,1140,200
1423400225,20140721T000000,225000,2,1,1030,9192,1030,0
5419000050,20140917T000000,338500,4,2.5,2717,4513,2717,0
5151200290,20140512T000000,300000,2,1.75,1360,8100,860,500
4060000170,20140820T000000,255000,2,1,1260,7810,1260,0
1568100290,20140620T000000,337000,4,3,2240,8504,2240,0
4137010010,20150416T000000,324900,3,2.25,2080,9740,2080,0
2581900284,20140707T000000,821000,3,2.75,2760,8476,1690,1070
1222069136,20141212T000000,500000,4,2.75,3000,213008,3000,0
7625701795,20150302T000000,885000,4,3.5,3310,6000,2200,1110
1771100440,20140610T000000,360000,4,2,1630,10375,1630,0
3211200290,20140527T000000,304000,3,1,900,7500,900,0
4154302045,20150316T000000,376000,2,1,880,2400,760,120
4036801315,20141104T000000,425000,4,1.5,1620,7875,1620,0
9185700414,20140522T000000,1.18E+06,3,1.75,1610,7200,1090,520
1221000562,20140722T000000,187000,3,2.5,1730,1803,1730,0
1890000250,20140627T000000,710000,2,1.5,1640,4080,1540,100
7436400020,20150325T000000,585000,3,1.75,1840,7350,1370,470
3303850290,20150409T000000,1.40E+06,5,4,4700,22326,4700,0
2025059026,20150225T000000,1.98E+06,4,3.5,4500,44384,3340,1160
3751600430,20141226T000000,250000,3,1.75,1780,35233,1420,360
7856640460,20141218T000000,950000,4,2.75,3800,12200,3800,0
9510920050,20140902T000000,725000,3,2.5,2980,16996,2980,0
8651720020,20140512T000000,505000,4,2.5,2780,6369,1590,1190
2114700500,20150418T000000,90000,1,1,560,4120,560,0
7950303530,20150409T000000,400000,4,2,2060,3060,2060,0
8910500471,20150217T000000,407000,3,1,1140,7785,1140,0
9550204450,20141219T000000,651000,3,1.5,1890,4400,1890,0
4024101990,20150205T000000,485000,3,2.25,2090,7450,1350,740
5595900345,20150113T000000,460000,4,2.75,3460,13168,3460,0
1782500095,20150309T000000,369000,2,1,1320,6135,880,440
8887001192,20140620T000000,355000,2,1,1240,27042,1000,240
4006000307,20140916T000000,155000,2,1,810,4755,810,0
5605000440,20141215T000000,1.00E+06,3,1,1880,5450,1880,0
2591840050,20150211T000000,419625,4,2.5,2680,11590,2680,0
1442300005,20150218T000000,435000,3,2,2040,6880,2040,0
3343901440,20150511T000000,379000,4,1.75,2180,7876,1290,890
9406590250,20150224T000000,293000,4,2.25,1870,5371,1870,0
2212250080,20140806T000000,592100,4,2.75,2310,7851,1790,520
3578700073,20141110T000000,362000,3,1.75,1120,9730,1120,0
1123049126,20141203T000000,227000,3,1,1340,10035,1340,0
526059259,20140819T000000,335500,3,1.75,1260,8487,1260,0
3222079136,20140818T000000,213000,3,1.75,1200,55321,1200,0
7237300290,20150326T000000,338000,5,2.5,2400,4496,2400,0
7468900235,20141022T000000,163500,3,1,940,7200,940,0
3352401476,20141124T000000,199988,2,1,860,5000,860,0
4217402162,20140725T000000,1.19E+06,3,2.25,2390,7875,1980,410
6147650430,20150407T000000,320000,4,2.5,3130,5200,3130,0
1133000235,20140616T000000,450000,6,2.25,3550,11780,2960,590
2781270080,20141030T000000,249900,2,2,1470,2541,1470,0
1423200170,20140612T000000,223000,2,1,910,9869,910,0
3023059071,20150210T000000,631000,4,4,2630,59586,1470,1160
511700170,20150505T000000,350000,4,2.25,1780,10416,1060,720
2124089028,20140714T000000,279000,3,1.75,1430,39160,900,530
1431700280,20150409T000000,310000,5,2,2730,7344,1510,1220
7686202635,20140812T000000,185000,2,1,900,8000,900,0
3874400380,20150316T000000,445000,3,2.5,1740,22089,1130,610
642500080,20141212T000000,365000,4,2.5,2905,4874,2905,0
1591600527,20150423T000000,333500,3,1.5,2230,9120,1390,840
5587000010,20141120T000000,385000,3,2.25,1680,8450,1340,340
2201500440,20140520T000000,345000,3,1.5,1240,11200,1240,0
7603100095,20141110T000000,1.26E+06,3,3,3230,8625,2220,1010
9412200080,20140523T000000,440000,4,2.5,2560,10400,1280,1280
7852130080,20140925T000000,444500,3,2.5,2600,4724,2600,0
2923039243,20141113T000000,340000,4,1,1200,11834,1200,0
6908200250,20150312T000000,680000,4,1,1660,6075,1660,0
3039000010,20140909T000000,420000,3,1.75,1140,8558,1140,0
1657300280,20141229T000000,438500,3,2.25,3050,10689,3050,0
9200000050,20140918T000000,109500,2,1,800,10625,800,0
7508200080,20150410T000000,461000,4,2.75,1700,7495,1200,500
5454200080,20140811T000000,968000,4,1.75,2630,9645,2630,0
7972601100,20140923T000000,355000,3,1.75,1960,7705,980,980
5112800190,20150327T000000,249000,3,1.5,1180,11579,1180,0
984210170,20150326T000000,256500,5,2.5,1960,7350,1360,600
8081500050,20150302T000000,1.81E+06,5,2.5,4250,20441,2490,1760
8731801190,20141223T000000,269000,3,2.25,1950,8661,1950,0
9103000715,20141112T000000,1.35E+06,4,3.5,3600,5217,2720,880
8732300430,20140620T000000,885000,3,2.25,2060,9552,1610,450
3754700170,20150423T000000,455000,3,2,1640,9825,1090,550
2652500795,20140609T000000,980000,4,2.5,2730,4800,2230,500
7454000470,20140801T000000,412500,3,1.75,1530,6300,1530,0
3630121060,20141217T000000,740000,4,3.5,3060,4777,3060,0
1370800825,20140823T000000,1.30E+06,4,2.25,2860,5658,2130,730
4310702759,20150312T000000,326000,2,1.5,1030,798,1030,0
8635750950,20140607T000000,568500,4,2.5,2460,4200,2460,0
3448900420,20140922T000000,620000,4,2.5,2500,8282,2500,0
2113700005,20150417T000000,283000,3,1.75,1830,7600,1490,340
8615800500,20140814T000000,875000,6,3.25,2820,4536,1930,890
9106000005,20150527T000000,1.31E+06,4,2.25,3750,5000,2440,1310
806800420,20141023T000000,289950,3,2.5,2070,6145,2070,0
2787311190,20141114T000000,252500,3,2.5,1780,7192,1250,530
3342102385,20141029T000000,376000,4,2.25,2200,6750,1480,720
7504000290,20140522T000000,635700,4,2.5,3240,13978,1860,1380
8691300500,20141028T000000,710000,4,2.5,2880,12349,2880,0
930000425,20150301T000000,440000,3,1.75,1570,5120,980,590
3291800670,20140630T000000,439000,3,2.5,3180,7904,1810,1370
1425059145,20140616T000000,455000,2,1.5,1310,12196,1310,0
4406000050,20140519T000000,225000,2,1,910,9612,910,0
1432700420,20140728T000000,250000,3,1,1460,10914,1460,0
5561400470,20150407T000000,585000,4,3.25,3410,34939,2470,940
8827901350,20150407T000000,685000,3,1.75,2720,4720,1580,1140
6190700284,20140620T000000,420000,5,2.75,2280,10319,1300,980
3644100073,20141122T000000,245000,2,1,670,1675,670,0
3223059173,20141104T000000,275000,4,2,1480,15000,1480,0
109210460,20141029T000000,270000,3,2,2330,8000,1390,940
9106000050,20141021T000000,767250,4,3,2170,2500,1710,460
4337600280,20140904T000000,229000,3,2,1760,9900,1760,0
3438501100,20150427T000000,400000,3,1,1240,4000,1240,0
7935000280,20140812T000000,2.20E+06,5,3.25,5210,35765,4940,270
7419700010,20140707T000000,665000,5,2,2800,17788,1400,1400
1626069102,20150323T000000,500000,4,2.25,2060,44431,2060,0
7574000080,20150401T000000,355500,5,2,2360,19899,2360,0
3830700010,20141205T000000,369000,4,2.5,2370,6557,2370,0
1454100010,20150202T000000,338500,2,1,720,6050,720,0
603001045,20150429T000000,256000,3,1,950,4000,780,170
2607720440,20150304T000000,470000,3,2.5,1980,9725,1980,0
930000470,20140527T000000,675000,3,2.5,2540,7680,2540,0
2621750280,20141110T000000,369950,4,2.75,2760,7533,1400,1360
7853220470,20140915T000000,615000,5,3.5,2950,7980,2350,600
4139660430,20150505T000000,1.20E+06,5,3,3640,28531,3640,0
1338800430,20140728T000000,950000,3,1.75,2150,3503,1870,280
1338800491,20141021T000000,799500,4,2.5,2760,5750,2760,0
792000006,20140709T000000,187000,2,1,840,11600,840,0
7504020670,20140520T000000,598000,5,2.25,2890,12478,2890,0
4017600010,20150417T000000,429950,3,2.25,2060,10160,1340,720
1471701410,20150331T000000,347950,5,2.25,1700,13500,1700,0
3528000470,20140509T000000,851000,3,2.5,3560,107290,3560,0
3192000080,20141029T000000,205000,3,1,1210,10185,1210,0
1565100010,20150327T000000,225000,3,2.25,1590,9200,1110,480
9201000460,20141006T000000,705000,4,2.25,2620,10536,1520,1100
323059316,20150505T000000,535000,5,2.5,3190,6178,3190,0
6802200190,20150121T000000,222500,3,2,1450,9044,1450,0
1773100430,20150424T000000,313500,2,1.5,1270,1282,1000,270
6137610190,20150317T000000,632000,3,2.25,2730,7521,2730,0
1568100387,20150322T000000,467000,3,2,1840,3432,1840,0
3826500290,20150424T000000,339000,3,2.25,1970,7210,1380,590
629410190,20140619T000000,712000,3,2.75,3200,6699,3200,0
4189800050,20140520T000000,335000,3,1,1060,10050,1060,0
6126600950,20140717T000000,470000,3,3.25,1740,1693,1360,380
5411800250,20140724T000000,367000,3,1,810,7000,810,0
7853302140,20140524T000000,440500,3,2.5,2460,4399,2460,0
1423910670,20140527T000000,305000,4,1,2100,9288,1050,1050
2301400470,20140908T000000,635000,3,1.75,1530,5000,1020,510
1860600290,20140627T000000,1.02E+06,3,2.25,1670,4800,1670,0
9267200345,20140602T000000,342000,2,2.5,1175,1366,740,435
3826500170,20141111T000000,283000,3,2.25,2130,8800,1270,860
9804500420,20150424T000000,430000,4,2.75,2470,50123,1280,1190
2895550190,20140808T000000,245000,4,2.5,1700,4268,1700,0
6699930440,20140605T000000,355500,3,2.5,2600,5540,2600,0
3543900380,20150409T000000,395000,3,1,1460,5000,1460,0
59500050,20141216T000000,324900,4,2.25,2010,7280,2010,0
9274202885,20140508T000000,660000,3,1.75,1320,5750,1320,0
7701930050,20140811T000000,570000,3,2.5,3150,20189,3150,0
200800480,20141106T000000,552321,3,2.5,1960,8469,1960,0
3835500005,20140528T000000,1.10E+06,2,1.75,2050,11900,2050,0
9543000896,20140825T000000,237000,3,1.5,1800,9216,1800,0
1090000005,20150504T000000,402000,2,1,1210,5600,1210,0
5561000430,20141016T000000,470000,3,2.25,1830,39165,1830,0
1568100670,20150320T000000,395900,3,1.75,1880,8706,940,940
6813600440,20141022T000000,442000,2,1.75,860,5535,860,0
7701990380,20141015T000000,795000,4,2.75,2890,16397,2890,0
7153400010,20140812T000000,190500,3,2,1390,10155,1130,260
5608010420,20141120T000000,808000,4,2.75,3340,7230,3340,0
9141100073,20140826T000000,500000,4,2.5,2040,6685,2040,0
629400480,20140619T000000,775000,4,2.75,3010,15992,3010,0
9250900104,20141110T000000,300000,5,1.75,2110,8500,1100,1010
9250900104,20150410T000000,496000,5,1.75,2110,8500,1100,1010
5104531700,20140620T000000,448000,4,2.5,2510,6853,2510,0
623039026,20141125T000000,645000,2,2.25,2770,11884,1570,1200
7626200235,20140523T000000,464600,3,1.75,1120,5500,1120,0
7228500425,20140728T000000,590000,3,1,1530,2370,1530,0
3332500095,20141007T000000,399000,3,2.5,1800,3300,1690,110
7950300440,20141015T000000,305000,2,1,1030,6000,1030,0
8143000280,20141121T000000,478000,3,1.75,1210,6175,1210,0
4045500715,20141217T000000,598800,1,1,1090,32010,1090,0
1155620190,20140603T000000,430000,4,2.25,1790,7203,1110,680
3332000715,20140701T000000,433000,4,1.5,1550,5053,1180,370
5113000420,20150320T000000,420000,4,2.75,2400,20000,1170,1230
3223039181,20140609T000000,585000,4,1.75,2470,131790,2470,0
7399300420,20140818T000000,255000,3,1,1170,7395,1170,0
1088400190,20150422T000000,305000,3,1,1120,10125,1120,0
1588600177,20150225T000000,396000,4,1,1040,4420,1040,0
9264950420,20140508T000000,347500,4,2.5,2460,7350,2460,0
5418650080,20140814T000000,900000,4,2.5,3690,11468,3690,0
9492800020,20140930T000000,425000,3,1.75,1960,43332,1400,560
323089173,20140519T000000,429000,3,2.5,1920,15124,1920,0
6821102358,20150224T000000,540000,3,2.25,1670,3135,1220,450
943100689,20150127T000000,324950,3,2,1340,9750,890,450
8722100825,20150429T000000,1.05E+06,3,2.25,2610,3357,1980,630
4223000280,20141029T000000,221000,4,1.75,1540,7200,1260,280
1454100122,20140611T000000,405000,3,2,1640,7201,1640,0
3323500010,20150107T000000,1.15E+06,3,2.5,2100,15120,2100,0
9557300080,20140822T000000,588000,4,1.75,1930,7245,1510,420
6306100080,20140909T000000,234950,3,2,1430,10850,1430,0
5700001100,20141007T000000,580000,4,1.5,2430,4995,1730,700
6187500080,20140716T000000,637000,5,3,2460,7240,1840,620
7369600080,20141030T000000,704000,4,2.25,2490,6973,1490,1000
1623049145,20140925T000000,210000,2,1,880,9750,880,0
2877102330,20140516T000000,772000,4,2.5,2110,3750,2110,0
546001060,20150427T000000,763000,4,1.75,1850,4388,1850,0
2822059091,20150218T000000,213500,2,1.5,2060,7713,2060,0
3971701300,20141220T000000,255000,2,1,1360,9367,680,680
1732600050,20141017T000000,423500,3,2,2000,10490,1430,570
3585900430,20141222T000000,520000,3,1.5,1810,18483,1810,0
6791000050,20140908T000000,550000,3,2.75,2230,14400,1460,770
1818800289,20150121T000000,795000,3,2.75,1820,7517,1820,0
2738600080,20140815T000000,495000,4,3,2740,2811,2240,500
1310440950,20150302T000000,455000,4,2.5,2710,6558,2710,0
1322049150,20150305T000000,85000,2,1,910,9753,910,0
7200080,20141104T000000,239000,4,2,1980,10585,1980,0
1788800080,20140730T000000,184900,3,1,1040,10080,1040,0
1328320920,20150421T000000,386000,4,2.25,2810,8560,1610,1200
7283900185,20140604T000000,415000,4,2.5,2000,5962,2000,0
8685500020,20150512T000000,387000,3,1,1530,6372,1210,320
1338800425,20150304T000000,2.14E+06,6,4,5110,7128,5110,0
282500010,20150107T000000,685000,4,2.25,3133,16197,2533,600
798000630,20141031T000000,340000,4,2.5,2020,32710,1070,950
5583200345,20150511T000000,422000,2,1,750,4000,750,0
1036100130,20140808T000000,442000,3,2.5,1980,39932,1980,0
795002375,20140527T000000,280000,3,1,1200,6250,920,280
1245000461,20140703T000000,1.15E+06,5,2.5,3580,8921,3580,0
6802200280,20141110T000000,279000,3,2.5,2010,11618,2010,0
9521100795,20140623T000000,569000,4,2,1730,3884,1060,670
4039800080,20140529T000000,1.36E+06,5,3.5,5960,13703,4770,1190
6146600595,20150410T000000,209950,2,1,860,5080,860,0
6380500151,20150317T000000,468000,3,1.5,1370,7697,1370,0
8643000185,20150430T000000,237100,3,1.75,1360,9603,1360,0
7212650950,20140708T000000,336000,4,2.5,2530,8169,2530,0
357000005,20141222T000000,500000,4,2,1680,3813,1680,0
5648600010,20150426T000000,290000,3,2.5,1580,6860,1580,0
2818600010,20150314T000000,1.19E+06,7,3.5,3890,8342,2840,1050
9842300095,20140725T000000,365000,5,2,1600,4168,1600,0
3977630130,20150325T000000,146300,3,1,1200,9668,1200,0
5160300020,20140609T000000,554000,3,1.75,1760,10780,1760,0
3754700050,20140618T000000,424000,3,2,1670,7700,1170,500
629860010,20150429T000000,1.35E+06,4,3.5,4640,9827,3210,1430
446000010,20141119T000000,508500,4,1.5,1800,6750,1800,0
8562000010,20150501T000000,244500,3,1.75,1210,8864,1210,0
646910480,20141120T000000,206000,2,2.5,1280,1566,1280,0
868000415,20140905T000000,643500,3,2,1650,7104,1650,0
1826049430,20140520T000000,372500,4,1.75,1590,10523,1590,0
2769600190,20140715T000000,630000,5,2,1900,5000,1720,180
3630070280,20140710T000000,418000,2,2.5,1500,3608,1500,0
8944460190,20150225T000000,425000,4,2.5,2689,6688,2689,0
3630180470,20150205T000000,800000,4,2.75,3250,5500,3250,0
6099400293,20141208T000000,208000,2,1,960,13438,960,0
6791000280,20140714T000000,476000,3,1.75,1650,9600,1650,0
7796450190,20150202T000000,277500,3,2.5,1690,5171,1690,0
2294900010,20140813T000000,478000,3,1.75,2790,36585,1410,1380
1186000095,20140708T000000,890000,4,2.75,2310,4020,2310,0
2770601763,20150323T000000,450000,3,3.5,1790,1288,1390,400
3392100050,20140625T000000,205000,3,1,1230,8750,1230,0
2878600655,20140718T000000,665000,3,2,1620,2640,1620,0
3299200080,20141003T000000,518000,4,2.75,2440,12051,1440,1000
2564900020,20140924T000000,465000,4,2.25,2100,7350,2100,0
2111010080,20140617T000000,330000,3,2.5,3040,7232,3040,0
6669080020,20141226T000000,449400,4,3,2490,5064,2490,0
8682300010,20150206T000000,829000,3,2.75,2690,10443,2690,0
1974200020,20150220T000000,450000,4,1.75,2190,9752,2190,0
3211000190,20141001T000000,310000,3,1.75,1490,9120,1490,0
6354000050,20140908T000000,615000,3,2.25,2530,45234,2530,0
625049153,20140603T000000,605000,3,2,2060,4040,1120,940
5561000190,20140502T000000,437500,3,2.25,1970,35100,1970,0
4449800595,20140922T000000,545000,3,1.75,1400,4000,1400,0
1115750190,20140717T000000,770000,3,2.5,3680,35617,2390,1290
8644300170,20140703T000000,600000,5,2.25,3000,13899,3000,0
9523102660,20140513T000000,560000,3,1,1440,5000,1440,0
1630700380,20150130T000000,1.92E+06,5,5.75,7730,230868,6660,1070
7588700007,20141124T000000,457000,3,1,1170,3348,1170,0
3501600235,20140505T000000,585000,2,1,1770,8640,1520,250
9545230280,20140507T000000,560000,3,2,1860,13374,1860,0
7905200130,20150405T000000,345000,2,1,770,3008,770,0
2742100250,20140720T000000,550000,4,3.5,3820,17745,2440,1380
5104540500,20140624T000000,589950,4,2.5,3190,8195,3190,0
638100073,20140602T000000,327000,3,1.5,1320,13200,1320,0
3022039071,20140530T000000,800000,2,2.25,1730,31491,1730,0
3426079024,20140521T000000,150000,3,1,1010,25000,1010,0
2767604254,20140603T000000,425000,2,2.5,1140,1182,1140,0
1138010170,20140801T000000,350000,3,1,860,7030,860,0
9407100500,20150311T000000,273000,3,1.75,1540,10545,1540,0
191100250,20150320T000000,750000,4,2.25,2160,9525,1080,1080
1557000190,20141009T000000,240000,3,1.5,1450,9477,1450,0
8732020670,20150320T000000,400000,3,1.75,1830,9620,1830,0
5029450290,20141003T000000,230000,3,1.5,1630,6625,980,650
8035600290,20150413T000000,372000,4,2.5,2500,8215,2500,0
6450301835,20140705T000000,459500,3,1.75,1470,4950,1030,440
6388930420,20140805T000000,582000,3,2.5,2380,19860,2380,0
2296700470,20141106T000000,465000,4,2.5,2170,7700,1420,750
1473120190,20140530T000000,386000,3,2,2120,7560,2120,0
11200290,20140609T000000,546000,3,2.5,1530,3464,1530,0
5530000050,20141027T000000,278000,3,1.75,2710,9088,2060,650
7853220670,20140918T000000,540000,3,2.5,2860,8935,2860,0
3124089049,20141208T000000,529000,4,1.75,2800,90169,2800,0
868000305,20140617T000000,554000,4,1,1120,7104,1120,0
1311200380,20140827T000000,210000,3,1,1730,7210,1430,300
9197100101,20150504T000000,225000,2,1,1010,5408,1010,0
6646200280,20140715T000000,561600,4,2.5,2350,6624,2350,0
7116500920,20140520T000000,300000,6,5.25,2860,5682,2860,0
1068000255,20140827T000000,1.65E+06,4,3.5,4285,9567,3485,800
1240700170,20140609T000000,1.02E+06,4,3.75,4060,19290,4060,0
4031000250,20140626T000000,150000,3,1,1310,9612,960,350
7625703260,20140924T000000,400950,2,1.75,2320,6250,1400,920
8651580660,20150121T000000,620000,4,2.25,2210,8101,2210,0
6117500980,20140818T000000,449000,4,2.75,2090,14141,1680,410
9547205380,20140728T000000,630000,4,2.5,2240,4025,1250,990
414100280,20150414T000000,336000,2,1,1180,7200,1180,0
321059091,20140605T000000,299950,4,1.75,1560,31299,1560,0
7772000010,20150309T000000,352500,4,2,1970,7451,1350,620
7200179,20141016T000000,150000,2,1,840,12750,840,0
7200179,20150424T000000,175000,2,1,840,12750,840,0
8029500380,20140731T000000,305000,3,2,1830,10873,1830,0
825059178,20140923T000000,2.57E+06,4,3.75,4475,20424,2659,1816
6021502750,20140715T000000,607500,3,1.5,1800,4700,1200,600
9268200380,20141118T000000,505000,2,1,1250,5040,950,300
2008000420,20141027T000000,280500,3,1.75,2440,10179,1220,1220
8914100170,20140731T000000,610000,3,2.5,2910,12283,2910,0
6654700250,20140812T000000,381000,5,2.75,3060,6895,3060,0
6139800430,20140522T000000,482000,5,2.25,2230,9600,1320,910
9477201470,20141022T000000,379950,3,1,1270,6900,1270,0
3025300095,20141009T000000,2.50E+06,4,4.5,4300,19844,4300,0
3211290050,20140623T000000,425000,3,2.25,1580,39189,1180,400
7511200190,20140910T000000,580000,4,2.25,2570,36465,2570,0
5739601300,20150330T000000,605000,2,1,860,6510,860,0
3278602660,20140520T000000,194000,1,1,820,1060,760,60
8078410250,20150401T000000,546200,4,2.25,2090,8579,2090,0
2798000020,20140815T000000,1.40E+06,4,3.5,3560,16782,2560,1000
2739200050,20150403T000000,315000,3,1.75,1860,9629,1240,620
9278200095,20141217T000000,465000,3,1.5,900,8690,900,0
3222079120,20141001T000000,330000,2,1,1160,32251,580,580
4401200010,20140808T000000,795000,4,2.75,3100,7501,3100,0
2473250280,20140826T000000,265000,4,2.25,2300,9100,1280,1020
4441300170,20150112T000000,1.30E+06,4,2.5,3110,11857,2040,1070
723049530,20150505T000000,126500,3,1,1130,12212,1130,0
6752510010,20140805T000000,760000,4,2.5,2920,7901,2920,0
955000430,20140903T000000,540000,2,1.25,1230,1569,1050,180
8663100050,20140519T000000,446000,5,2.75,2190,12687,1370,820
226109056,20150326T000000,170000,1,0.75,850,5600,850,0
2558600130,20141023T000000,379000,3,2.5,1500,7420,1000,500
8823900290,20150317T000000,1.40E+06,9,4,4620,5508,3870,750
8691400080,20140620T000000,800000,4,2.75,3150,7035,3150,0
621069102,20150316T000000,260000,3,1,1300,10139,1300,0
5456000280,20150310T000000,820000,5,2.5,3160,8000,1580,1580
2891400380,20150414T000000,449950,3,1.75,2070,96703,2070,0
2297400020,20140902T000000,392000,3,2.25,1790,7125,1220,570
7215721350,20150422T000000,465000,3,2.5,1650,4636,1650,0
5490210670,20140822T000000,449950,4,2.5,2070,7312,1230,840
6431500122,20150428T000000,520000,3,1.5,1580,8841,1180,400
3376600170,20140828T000000,546800,4,2.25,2170,10000,1420,750
8861000235,20150324T000000,825000,4,2.75,2220,11925,1560,660
2881700231,20150422T000000,337000,3,1.75,1440,11364,1440,0
534000080,20140611T000000,333000,2,1,720,6686,720,0
6371000020,20141111T000000,380000,2,2,1120,780,760,360
7212651440,20150428T000000,280000,3,2.5,1970,8426,1970,0
7575500080,20141120T000000,202000,3,1.5,1420,9081,1420,0
7197800020,20150427T000000,585000,4,2.5,2250,4119,2250,0
5592900285,20141104T000000,435000,4,2,2630,9663,1330,1300
525069127,20140523T000000,1.20E+06,4,3.5,4740,172497,4740,0
2460900010,20140924T000000,364000,2,2.25,1280,2574,1280,0
1566100595,20140514T000000,300000,3,1,1260,8280,1260,0
8682291680,20150317T000000,558000,2,1.75,1930,4601,1930,0
7841300285,20140811T000000,199950,1,1.5,1048,4800,1048,0
6071700020,20140827T000000,515000,3,2.25,1640,8400,1640,0
4315700275,20141107T000000,590000,4,2.5,2380,4950,2380,0
2330000130,20140723T000000,813500,4,2,2530,15520,2220,310
1246700103,20150423T000000,725000,4,2.5,2700,25870,2700,0
7504200250,20150428T000000,490000,3,2.25,2330,3600,2330,0
3797310010,20140827T000000,277000,3,2.25,2160,9612,2160,0
4058000010,20140509T000000,325000,4,1.5,1470,70800,1470,0
3888100022,20140925T000000,649800,4,2.5,2280,9827,2280,0
1934800022,20140723T000000,425000,3,1,1280,3200,1280,0
3501100280,20150329T000000,460000,2,1,850,4650,850,0
2725069108,20140805T000000,750000,3,3.25,4610,81935,4610,0
126039413,20140710T000000,469000,5,2.5,2690,11745,1790,900
461001435,20140610T000000,566000,4,1.75,2440,5000,1340,1100
6403500290,20140502T000000,407500,3,2.5,1930,10460,1930,0
2826049108,20141028T000000,353500,2,1,800,8775,800,0
1823069102,20140508T000000,524000,3,2.25,2430,73151,2430,0
4233400280,20140822T000000,264950,4,2.5,1990,9656,1990,0
1088800470,20141028T000000,547500,3,2.5,2550,10355,2550,0
2025701060,20141117T000000,264500,3,2.25,1370,7087,1370,0
7922900250,20140520T000000,507500,3,2,2020,8118,1020,1000
6372000280,20141008T000000,560000,3,3.5,1560,2198,1180,380
1424130050,20141216T000000,995000,5,4,5610,22529,4090,1520
7942601435,20150324T000000,835000,6,2,3560,5120,3560,0
3959401284,20140626T000000,440000,3,1.5,2120,6290,1220,900
1370802335,20140728T000000,1.02E+06,3,2.5,2920,5629,1460,1460
4058801680,20140523T000000,300000,2,1,1340,7788,1340,0
3501100050,20141210T000000,125000,3,1,1230,4800,1230,0
1231000895,20141105T000000,986000,4,3.5,2840,5900,1920,920
7129300500,20140812T000000,315000,4,2.5,2080,5650,1680,400
6752600050,20140812T000000,320000,4,2.5,2070,7007,2070,0
3303990380,20141204T000000,972000,4,3.25,4010,13797,4010,0
2579500006,20140909T000000,760000,3,2.5,2190,10000,1540,650
3365900462,20140903T000000,265000,4,3,1730,7264,1730,0
2695600130,20141118T000000,355000,2,1,1250,4558,1250,0
3438501700,20140827T000000,300000,3,1,1300,20812,1300,0
3876311350,20140826T000000,474950,5,2.5,2080,8347,1460,620
4046710050,20140827T000000,470000,4,2,2180,17180,2180,0
1725059259,20141125T000000,437500,3,1,1630,16393,1630,0
7518503220,20141028T000000,520000,2,1.5,1840,3825,1040,800
3445000005,20141117T000000,237600,2,1,1370,11584,1370,0
3530420020,20140711T000000,162950,2,1,950,2784,950,0
6893300290,20141111T000000,457000,3,1.75,1690,6375,1690,0
7856560480,20140808T000000,635000,3,2.5,1780,11000,1210,570
8121100415,20140530T000000,735000,4,3,2840,4120,2060,780
3754501060,20140918T000000,910000,2,2.5,2000,5150,2000,0
3278602040,20141021T000000,346500,3,3.25,1570,2048,1290,280
1592000050,20140905T000000,655000,4,2.5,2370,9517,1630,740
1324079007,20141110T000000,425000,3,1.75,1610,144619,1610,0
7140600225,20150217T000000,137000,3,1,1300,10125,1300,0
200500680,20140715T000000,557500,3,2.5,2620,11056,2620,0
421079142,20140509T000000,415000,4,2.25,3060,48787,3060,0
9346700280,20140620T000000,830000,5,2.25,2780,10192,2780,0
293800680,20150415T000000,949000,4,3,4270,85643,4270,0
339600190,20141014T000000,420000,3,1,1310,3963,1310,0
1787600190,20150403T000000,353000,2,1,1100,7500,1100,0
2026079016,20140904T000000,560000,3,1.75,1480,383328,1480,0
8673400086,20140502T000000,445700,3,2.5,1270,1180,1270,0
2760200050,20140717T000000,226000,4,1,1270,6459,1270,0
3205000050,20141205T000000,358000,3,1,890,9870,890,0
2201500680,20150305T000000,501000,3,1.75,1480,8667,740,740
4022902555,20150321T000000,609000,4,2.5,3240,23870,1840,1400
3410600080,20140709T000000,734950,4,3.25,4280,47179,3050,1230
7385300020,20140613T000000,725000,5,2.5,3210,12000,1830,1380
3876312570,20140811T000000,350500,3,2.25,1870,7200,1390,480
5016002275,20140602T000000,610000,5,2.5,3990,3839,1990,2000
3213200250,20141106T000000,605125,2,1,1160,5029,910,250
6448000010,20150428T000000,1.39E+06,4,2.25,2940,20384,2940,0
1330900050,20150421T000000,550000,3,2.25,1850,37264,1850,0
2810600022,20141007T000000,335000,2,1.75,1060,1202,760,300
1761600050,20141231T000000,397000,3,2,1100,9165,1100,0
4233400480,20141124T000000,240000,3,2,1190,10299,1190,0
4222310680,20140926T000000,240000,3,2,1030,11118,1030,0
5630500005,20141120T000000,262500,2,1.5,1140,14373,1140,0
9523102040,20140922T000000,440000,3,1.5,2260,5300,1200,1060
2626119028,20150323T000000,160000,3,1,1140,3240,1140,0
5015001680,20140611T000000,427000,4,1,1860,4736,1860,0
7202360430,20140701T000000,920000,4,3.5,4080,10666,4080,0
3880900170,20140805T000000,2.30E+06,4,2.5,3280,7100,2180,1100
926069142,20141124T000000,480000,4,2.5,2870,35757,2870,0
2790410250,20140505T000000,615000,4,1.75,2300,11700,1960,340
6681500080,20140822T000000,736500,3,2,2230,4800,1290,940
9274201809,20141119T000000,542500,3,2.5,1920,1649,1600,320
418000415,20150319T000000,191000,2,1,700,5000,700,0
8078460050,20140718T000000,730000,4,2.5,2740,11975,2740,0
7151700585,20141125T000000,1.23E+06,5,2.25,3440,5000,3440,0
2722059292,20140604T000000,129000,1,1,650,15364,650,0
2223059099,20140709T000000,284000,3,1.5,1500,10018,1500,0
1703050500,20150321T000000,645000,3,2.5,2490,5978,2490,0
6386600130,20140624T000000,218000,3,1.5,1330,7600,1330,0
9194102188,20141009T000000,675000,4,3.5,3190,6875,2120,1070
2464400285,20141229T000000,575000,3,2.5,1590,2910,1110,480
6450301310,20141030T000000,225000,2,1,830,5720,830,0
7427800080,20150408T000000,626000,3,2.25,1810,5107,1810,0
40000669,20150319T000000,499950,4,2.5,2910,20067,2910,0
5538300225,20140513T000000,405000,4,1.75,2180,13529,1090,1090
4239400840,20141029T000000,152500,3,1,1090,3523,1090,0
8035650500,20140716T000000,325000,4,2.5,2160,6825,2160,0
3888100029,20140529T000000,475300,3,1,2110,10005,1110,1000
4364700585,20150408T000000,485000,3,1.75,2180,7318,1210,970
9839300285,20150412T000000,720000,3,2.5,2100,2200,1500,600
6141100380,20140515T000000,465000,3,1.75,1410,6886,1410,0
5652601330,20140604T000000,489000,3,1.5,1020,9072,920,100
3025059093,20140729T000000,3.10E+06,5,5.25,5090,23669,5090,0
5466700290,20150108T000000,288000,3,2.25,2090,7500,1280,810
5437800020,20140808T000000,225000,3,1.75,1350,9793,1350,0
7784400185,20150421T000000,499000,3,1.75,2650,11774,2240,410
5561301150,20141111T000000,632000,5,3,3520,36558,2100,1420
1523550480,20140613T000000,580000,3,2.5,2040,4627,2040,0
8083400066,20150423T000000,730000,4,1.5,2340,5000,2100,240
3797710020,20150327T000000,325000,4,2.25,1770,7799,1770,0
3205200480,20150415T000000,421000,3,1.75,1100,8662,1100,0
869700050,20150120T000000,316000,3,2.5,1490,4078,1490,0
2877101310,20140804T000000,415000,2,1,1460,4200,880,580
7202330280,20140922T000000,401000,3,2.25,1350,2839,1350,0
6146600420,20150224T000000,229950,3,0.75,1030,12700,1030,0
8563030500,20150330T000000,539950,3,1.75,1820,9875,1820,0
3624039150,20140605T000000,335000,3,2,1170,5360,1170,0
7853210050,20140707T000000,339000,3,2.5,1450,3748,1450,0
3293700480,20141020T000000,414950,4,1.75,2200,8545,1100,1100
3210700170,20141202T000000,650000,4,2,1610,8976,1610,0
8161020050,20141203T000000,445000,3,2.5,2690,21883,2690,0
8731983340,20150320T000000,295000,3,2.25,1850,7800,1850,0
7871500280,20150413T000000,975000,4,2.25,2250,3600,2010,240
3276200280,20141219T000000,296500,3,1.5,1580,10100,1580,0
826069180,20141021T000000,440000,4,2.75,2030,56192,1550,480
3955800080,20141229T000000,420000,5,1.5,1890,10880,1890,0
1657310170,20140723T000000,302000,3,2.5,2140,9492,2140,0
2597690050,20150409T000000,350000,4,1.75,1770,7336,1770,0
720079001,20140626T000000,667000,3,1.75,3320,478288,2260,1060
3975400185,20150513T000000,645000,3,2,1640,4218,910,730
3342101795,20141111T000000,430000,4,2.75,1820,5400,1220,600
9297301190,20140513T000000,413000,4,1,1410,6000,810,600
7424100050,20141201T000000,420000,3,1,1240,7300,1240,0
7199340480,20141029T000000,495000,3,2.25,1780,8050,1230,550
2525049259,20140812T000000,2.19E+06,4,4.5,4240,13162,4240,0
8835700250,20150426T000000,965000,4,2.5,3570,17411,3570,0
6150700005,20141201T000000,500000,4,2.5,1900,5001,1200,700
6819100080,20141001T000000,636100,3,1,1010,6000,1010,0
3904902630,20140603T000000,720000,4,2.5,2870,12648,2870,0
5152200020,20150504T000000,298000,3,1.75,1620,12825,1340,280
3300701440,20140729T000000,409000,2,1.75,1480,4000,740,740
1152700020,20141226T000000,370000,4,2.5,2650,5706,2650,0
8944300010,20140725T000000,230000,5,1,1410,9000,1410,0
8680300010,20150324T000000,290000,3,2,1360,6685,1360,0
8731950080,20150219T000000,420000,4,2.25,2930,9840,1560,1370
5608000080,20140722T000000,917000,4,2.5,3500,10891,3500,0
2225039130,20140625T000000,957000,5,3.25,3160,5000,2180,980
7504180130,20140701T000000,482000,3,2.25,1710,21485,1710,0
3956100190,20141121T000000,488000,3,1.75,2180,14734,2180,0
2346200050,20141017T000000,760369,5,2.5,2870,4712,2870,0
40000471,20140604T000000,170000,2,1,1500,18540,1500,0
9346950050,20150429T000000,625000,3,2.5,2120,10021,1230,890
9477201150,20141202T000000,357000,3,1.5,1590,6750,1080,510
8078430130,20150407T000000,583000,3,2.25,1830,8276,1350,480
6404600006,20140820T000000,173250,3,2,1210,9097,1210,0
6415100122,20140716T000000,414050,4,2,1590,10331,1590,0
5505700020,20140618T000000,400000,3,1.75,1050,6150,950,100
1117300050,20150327T000000,537000,3,2,1550,27003,1550,0
8651710430,20140606T000000,465000,4,2.25,2070,7500,2070,0
9292000380,20140818T000000,425000,3,2.25,1740,9682,1740,0
2525059127,20141118T000000,445000,4,2,1700,21780,1080,620
1788300010,20141211T000000,179950,2,1,1200,9000,1200,0
1150700130,20150421T000000,275000,3,2.5,1710,7230,1710,0
3354400545,20140715T000000,190000,4,2.5,1840,13493,1840,0
2742100009,20140506T000000,385000,3,1.75,1900,5520,1280,620
2475900170,20150429T000000,303000,4,1,2300,9583,1220,1080
9189700255,20150105T000000,165000,3,1,970,7503,970,0
2769600480,20150430T000000,600000,2,2,1270,5000,1270,0
2260800170,20140718T000000,710000,3,2.25,3130,65775,3130,0
1118500010,20150327T000000,875000,5,3.25,4230,21455,2720,1510
5636010280,20140902T000000,269950,3,2.5,1480,9743,1480,0
2326059099,20140502T000000,838000,4,2.5,3310,42998,3310,0
4423100095,20140523T000000,670500,4,2,1590,6750,1590,0
8142000080,20150212T000000,420000,4,1.5,1690,9391,1290,400
3222059007,20140913T000000,370000,3,1.5,1690,161913,1430,260
6648000050,20140624T000000,360000,3,1.75,1500,7200,1500,0
3574900170,20141003T000000,562500,4,2.5,2320,8721,2320,0
2008000130,20140818T000000,360500,3,2.5,3300,11525,1650,1650
291300010,20140521T000000,389999,3,2.25,1445,1471,1300,145
9412200280,20140827T000000,450000,4,3,1890,13140,1270,620
9315000010,20150303T000000,247500,4,2,1760,8400,1060,700
7889600080,20150219T000000,208000,3,1,1050,6240,1050,0
8663310010,20141226T000000,455000,3,2.5,1980,7309,1980,0
930000305,20141110T000000,379400,4,1.75,2120,7680,1060,1060
7606200275,20141230T000000,190000,3,1.5,760,40039,760,0
203900380,20140821T000000,326188,3,1,1300,8800,1300,0
880000005,20140522T000000,168000,2,2.5,1160,2174,1160,0
9406570290,20140516T000000,314000,4,2.5,2340,8990,2340,0
5561000920,20140502T000000,630000,4,2.75,2710,37277,2710,0
4037000470,20150316T000000,550000,3,1.75,1440,8957,1440,0
8651511060,20140630T000000,530000,4,2.25,1980,15086,1980,0
9413600010,20150206T000000,637500,3,1.75,1680,10685,1680,0
9358001732,20150428T000000,400000,3,2.5,1390,2815,1390,0
8820900029,20140610T000000,700000,5,2.75,3100,9825,3100,0
6802200670,20141114T000000,272000,3,2.5,1680,8512,1680,0
7852190630,20150417T000000,600000,4,2.5,2710,6474,2710,0
2815600235,20150402T000000,450600,2,1,840,7020,840,0
3013300660,20141028T000000,550000,3,2.25,2090,8095,2090,0
8091600080,20150123T000000,225000,3,1,1120,8407,1120,0
8651402750,20150218T000000,132825,3,1.5,1210,5200,1210,0
8651402750,20150430T000000,219950,3,1.5,1210,5200,1210,0
2215500080,20140528T000000,580000,5,2,1940,6000,970,970
225069016,20140722T000000,568000,3,1.75,1930,213008,1300,630
766900250,20150402T000000,406000,3,1.75,1270,6017,1030,240
2922703260,20140716T000000,469000,3,1.75,1680,2400,1170,510
8011100095,20140610T000000,415000,3,2.5,2090,6045,2090,0
2206700280,20141208T000000,390000,3,1.5,1000,13991,1000,0
7985000010,20150415T000000,251000,3,1.75,1350,10125,1350,0
1504800050,20150312T000000,750000,3,2.5,3280,6750,2440,840
5351200280,20150407T000000,845000,4,2.5,2390,5071,1760,630
7229900005,20141010T000000,350000,3,1.5,1860,17640,1860,0
3126049217,20150225T000000,322000,3,1,1380,5864,790,590
7446500010,20150507T000000,664500,4,2.25,3070,9210,2740,330
2721600010,20150107T000000,988000,3,1.75,2190,3800,2190,0
3392900080,20140706T000000,625000,2,1.75,1990,4000,1090,900
1524059027,20140506T000000,675000,2,1,930,36478,930,0
9414500480,20150407T000000,503000,3,1.75,2070,9827,1420,650
8576400050,20140509T000000,431000,4,2.25,2170,10500,1270,900
5252000170,20141126T000000,250000,3,1.75,1910,10230,1290,620
2676500080,20140605T000000,268500,4,2.5,2100,4237,2100,0
3585900080,20150326T000000,1.07E+06,6,3.25,3560,21400,3560,0
5126900321,20140529T000000,295000,4,2.5,2290,4539,2290,0
8563500020,20140725T000000,780000,3,2.25,2130,11782,1590,540
6624030050,20150428T000000,354000,3,2.5,2160,15817,2160,0
4343800080,20140818T000000,305000,2,1,860,7250,860,0
1873100050,20150401T000000,733000,5,2.75,2880,4425,2880,0
3210700380,20140916T000000,640000,4,2.75,2100,11894,1720,380
4099500605,20150417T000000,840000,4,2.5,2360,9600,1630,730
4217401365,20141210T000000,1.48E+06,5,3.25,3680,10300,3680,0
923000095,20150326T000000,525000,3,1,1560,8100,1140,420
1828000050,20140514T000000,625000,4,2.75,1680,11180,1680,0
9126100346,20140617T000000,350000,3,2,1380,3600,1380,0
2919201365,20140616T000000,650000,4,2.75,2610,4160,1910,700
9297300500,20141023T000000,435000,2,1,870,4000,870,0
6073200010,20140626T000000,660000,3,1,1210,9622,1210,0
8807810660,20150302T000000,350000,3,1,1150,12877,1150,0
2112700185,20150325T000000,435000,3,2.5,3110,6000,1560,1550
1789800020,20140603T000000,375900,6,1.5,2550,33740,1750,800
3275300050,20141124T000000,272000,3,3,2430,10500,2150,280
3279000420,20150115T000000,233000,3,1.75,1460,7800,1040,420
952001660,20140916T000000,500000,4,1.5,1330,5750,1330,0
4023500362,20150402T000000,540000,4,1.75,2040,9322,1440,600
9510910050,20140701T000000,712000,3,2.5,2375,4094,2375,0
1137400050,20140925T000000,425000,4,2.5,2480,4504,2480,0
8864000425,20140805T000000,242000,3,1.75,1580,6099,790,790
5518800010,20140703T000000,515000,5,3.25,2740,9629,1390,1350
3204800430,20140708T000000,415000,4,1.75,1920,7700,1920,0
5152960080,20141210T000000,375000,3,2.75,2200,9600,1570,630
7696500280,20141027T000000,182500,3,1,910,7194,910,0
8643000190,20150323T000000,310000,3,1.5,1860,10379,1240,620
7625701045,20141027T000000,360000,3,1.75,1510,6000,1060,450
7202360670,20150408T000000,889000,4,3.5,3920,9555,3920,0
4305700086,20150410T000000,450500,2,1,1330,3698,1330,0
731500170,20150422T000000,342000,4,2.25,1964,3541,1964,0
5096300130,20140714T000000,413000,3,2,1520,3451,1520,0
1441600020,20140527T000000,960000,5,4,3720,15200,3720,0
6163900073,20140905T000000,180000,2,1,770,9370,770,0
5581400080,20140618T000000,770000,4,2.5,3210,14910,3210,0
8100000080,20140813T000000,224400,3,1.75,1070,7200,1070,0
5379806590,20150430T000000,280000,3,1.5,1430,8861,1430,0
9286100250,20150319T000000,500000,3,2.5,1670,2575,1670,0
4337600005,20150203T000000,153000,2,1,710,9000,710,0
3645100280,20140613T000000,385000,3,2.25,1920,4833,1060,860
6170900190,20140819T000000,325000,2,1,750,5534,750,0
8581400345,20150409T000000,315000,4,3,2210,4191,2210,0
4345300050,20140617T000000,294999,4,2.5,1660,9760,1660,0
6143000020,20141027T000000,175000,3,1.75,1910,17003,1910,0
6143000020,20150406T000000,299000,3,1.75,1910,17003,1910,0
111000190,20150209T000000,146000,2,1,780,9750,780,0
5306100255,20141105T000000,290000,3,2.25,1650,10336,1500,150
1370803180,20140808T000000,1.78E+06,3,3.25,3230,7800,3230,0
5249803745,20140529T000000,367500,2,1,810,4800,810,0
2787250080,20150327T000000,535000,4,2.5,2750,15099,2750,0
8656300345,20140805T000000,334999,3,2.5,1650,13816,1650,0
582000185,20140821T000000,655000,3,1.75,1960,5520,1080,880
191100235,20140603T000000,1.30E+06,4,3.5,2790,10125,2790,0
6662410250,20150321T000000,480000,4,2.25,2230,11200,1300,930
1053000010,20150421T000000,465000,3,1.5,1280,4720,850,430
2473100635,20140508T000000,297950,3,2,1240,10800,1240,0
7960100050,20150415T000000,590000,3,2,1860,3600,1110,750
1177000130,20140522T000000,805000,4,2.75,2410,6000,1410,1000
8732160250,20150120T000000,204250,3,2.25,1960,7708,1490,470
3905100630,20140716T000000,500000,3,2.25,1710,4561,1710,0
5469501410,20140917T000000,490000,4,2.5,3480,12696,1980,1500
4107100190,20150324T000000,2.50E+06,4,3.75,3480,14850,1870,1610
5215200050,20140729T000000,750000,3,2.5,2960,69351,2960,0
4027700006,20150409T000000,405000,4,2.5,2670,20894,2330,340
421000500,20140721T000000,209995,2,1,700,7303,700,0
305010190,20141016T000000,680000,4,2.5,2830,8399,2830,0
751000190,20141002T000000,355000,3,1.75,1120,7740,860,260
1446400715,20150422T000000,280000,2,1,1310,6600,1310,0
4027701284,20140605T000000,385000,3,2.25,1710,11500,1210,500
6072000380,20140701T000000,505000,4,2.75,2200,9778,1100,1100
7212651100,20140822T000000,429900,4,3.25,3310,8897,2380,930
6977000080,20140721T000000,560000,4,2.5,2280,9874,2280,0
8651440780,20140929T000000,231000,3,2,1640,4875,1040,600
3298701025,20150427T000000,135000,2,1,750,5217,750,0
475000605,20140623T000000,800000,4,3,3520,4895,1980,1540
1023059430,20141220T000000,420000,3,2.5,2720,8622,2720,0
3760000020,20141022T000000,360000,3,1,1660,9600,1660,0
3905090080,20140530T000000,642000,4,2.5,2560,8780,2560,0
339600290,20150406T000000,379950,3,2,1080,5077,1080,0
9542400010,20140711T000000,745000,3,1.75,2050,11041,2050,0
1498303895,20140729T000000,630000,4,2,2670,3240,1780,890
739820050,20150505T000000,250000,3,2.5,1730,7200,1730,0
9238450430,20140624T000000,275000,3,1,990,9798,990,0
3336000050,20150501T000000,435000,6,3,3560,4290,1780,1780
5269200050,20150305T000000,175000,2,1,700,8174,700,0
1982200430,20140612T000000,560000,4,1.75,1880,3880,1090,790
3763300005,20140520T000000,325000,4,2.25,1870,9680,1170,700
1336800185,20140617T000000,1.19E+06,3,2.75,2500,5568,2500,0
1561910190,20140627T000000,399950,3,2.5,2570,10431,2570,0
5415350480,20140617T000000,752000,4,2.5,2940,10382,2940,0
1126059108,20150423T000000,1.20E+06,4,3.5,3930,43560,3930,0
3818700185,20140925T000000,400000,4,1.5,2150,11026,2150,0
7883601155,20140530T000000,240000,3,2,1330,6000,630,700
7559600430,20141111T000000,640000,5,2.5,3220,4759,3220,0
3449820380,20150402T000000,564450,3,2.5,2710,6174,2710,0
1523069022,20150506T000000,300000,3,1.5,1630,82764,1630,0
7569450480,20150317T000000,286000,3,2.5,1680,4226,1680,0
7202340190,20150219T000000,531800,3,2.5,1930,5344,1930,0
8651710190,20141024T000000,502000,4,2.25,2140,10943,1550,590
5450900010,20140821T000000,993500,4,2.25,4070,23321,4070,0
2201500980,20141020T000000,450000,3,1,1350,10000,1350,0
2624079028,20141027T000000,997950,4,3.5,4270,117176,4270,0
3095000185,20141013T000000,526000,3,1,1320,5250,1320,0
4476400275,20150114T000000,335000,3,1.75,2100,8298,1230,870
8018600980,20141203T000000,187250,2,1,710,14700,710,0
7173700591,20140811T000000,735000,3,2.25,2350,6000,1020,1330
2568800290,20150218T000000,425000,3,1,1180,8400,1180,0
5111400086,20140512T000000,110000,3,1,1250,53143,1250,0
1079350020,20140821T000000,305000,3,2,1490,7697,1490,0
88000591,20150414T000000,212000,3,1,1000,9450,1000,0
2524049108,20150512T000000,1.38E+06,5,4.25,4050,18827,2150,1900
1552800280,20140918T000000,298950,5,2.25,2300,11505,1300,1000
2423020010,20150316T000000,525000,3,1.75,1330,8136,1330,0
629410130,20140514T000000,707000,4,3.25,3200,7081,3200,0
4139440480,20140626T000000,695000,3,2.75,2590,12063,2590,0
4139440480,20141201T000000,796500,3,2.75,2590,12063,2590,0
7016300050,20140723T000000,420000,4,2.5,2030,8100,1150,880
3425059099,20140625T000000,625000,5,2.5,2700,21208,1950,750
9541600280,20140823T000000,620000,3,1.75,1670,9900,1670,0
3025300225,20141031T000000,1.45E+06,5,2.75,3090,19865,3090,0
7214770020,20150409T000000,549950,5,2.5,2650,54380,2650,0
7227801630,20150227T000000,275000,4,2,1440,10920,1440,0
7284900098,20140924T000000,705000,3,2.5,2820,7200,1780,1040
7696630080,20140506T000000,197000,3,1.75,1690,7735,1060,630
3235390010,20150505T000000,265000,3,1.75,1420,8126,1420,0
2966800010,20141120T000000,297000,4,1.75,1790,5341,1050,740
6600410290,20140819T000000,207500,3,1.75,1320,12528,1320,0
6300500479,20140819T000000,410000,3,2.5,1509,1418,1509,0
1450900020,20141003T000000,268000,3,2,1610,8416,1610,0
1284000010,20140805T000000,330000,4,1.75,1550,50094,1550,0
3626039028,20140818T000000,417500,3,1,1160,7491,1160,0
7856560380,20140804T000000,760000,4,2.25,2500,8500,2500,0
2770604346,20140705T000000,499000,3,2.5,1540,1326,1390,150
9202650130,20140618T000000,620000,4,2.5,1910,7683,1910,0
8700100010,20140710T000000,315000,3,2.5,2340,6837,2340,0
4045750010,20150409T000000,624950,3,2.5,2060,4730,2060,0
5706201470,20150428T000000,525000,3,2.25,1960,12350,1960,0
8835210130,20140808T000000,300000,2,1.5,1150,3927,1150,0
8731990440,20150310T000000,299900,4,2.75,2330,7200,1560,770
5540000050,20140612T000000,299000,3,2.5,2210,10119,1450,760
2470200020,20140514T000000,1.88E+06,4,2.75,3260,19542,2170,1090
9500900430,20140613T000000,265000,4,1.75,1900,10588,1900,0
3024089049,20140609T000000,280000,2,1.75,1610,158558,1610,0
6600410170,20140528T000000,124740,3,1,1340,15600,1340,0
7796000095,20150106T000000,1.09E+06,3,2.75,3170,34850,3170,0
1338600225,20140528T000000,1.97E+06,8,3.5,4440,6480,3140,1300
316000190,20150215T000000,219000,4,1,1370,5339,1370,0
9276200190,20150416T000000,569950,5,1,1420,6250,1420,0
1447600285,20140609T000000,212500,2,2,1030,21712,1030,0
5307100280,20140811T000000,680000,3,2.25,1820,8316,1320,500
1338800280,20140929T000000,1.46E+06,4,1.5,2650,6900,2400,250
3211200420,20140618T000000,300000,3,1,910,7700,910,0
2770604082,20150310T000000,629950,3,2.5,1680,1683,1120,560
7334600280,20141202T000000,349900,2,1.75,1550,9230,970,580
5406500440,20140812T000000,690000,4,2.5,2780,6235,2780,0
1235100328,20150225T000000,1.45E+06,5,4,4070,11334,4070,0
4141010050,20150121T000000,1.29E+06,3,2.5,3240,12625,3240,0
9510310280,20140709T000000,696000,4,3.5,3650,38546,2550,1100
725069102,20150330T000000,650000,3,2.25,2180,60112,2180,0
8562901350,20140812T000000,640000,3,3.5,2480,10800,2480,0
1442700430,20140808T000000,499950,5,2.5,3180,23809,3180,0
6806300980,20141223T000000,490000,4,2.5,3630,8387,3630,0
8562740290,20141010T000000,685000,5,2.5,3160,5635,3160,0
7454001405,20150403T000000,387500,4,1,1370,7140,1370,0
952007141,20150421T000000,401750,2,1.5,1070,1236,1000,70
1545806720,20140826T000000,254950,4,2,2180,8800,1170,1010
5561300980,20150320T000000,500000,4,2.25,2420,36680,2420,0
9348700480,20140715T000000,856500,4,2.5,3290,8147,3290,0
1868900285,20140523T000000,552000,3,1,1430,5000,1080,350
8651720470,20140910T000000,506500,4,2.5,1890,7200,1500,390
3904950190,20140527T000000,500000,3,2.25,1760,4539,1760,0
5300200050,20140729T000000,280000,4,2.75,2230,10160,1400,830
7334501300,20150306T000000,308000,3,1.75,1630,11475,1330,300
8078350280,20150205T000000,613500,3,2.5,2350,7035,2350,0
4068300280,20140708T000000,255000,3,1.75,1550,9720,1050,500
2625079030,20141028T000000,545000,3,2.5,3550,136343,3550,0
1024069063,20140923T000000,620000,4,2.5,2720,34498,1360,1360
3624039102,20141025T000000,450000,3,1.75,1740,6800,1740,0
8025700460,20150508T000000,279000,4,1.75,1840,7275,1090,750
8956000460,20150123T000000,625000,3,2.5,2010,3200,2010,0
2329800630,20140527T000000,274950,3,1.75,1670,7415,1320,350
2491200050,20141023T000000,423000,3,1.75,1820,6038,1040,780
6181700250,20150226T000000,350000,2,1,720,5820,720,0
2460500020,20150330T000000,305000,4,1.75,2370,10140,1460,910
7893801760,20141117T000000,368000,3,1.75,2120,11340,1060,1060
5259800440,20140926T000000,232000,3,1.75,1290,6604,1290,0
7338402850,20141126T000000,250000,4,3,1800,2500,1800,0
1423910130,20150211T000000,220000,3,1.75,1230,8917,1230,0
2769602135,20140813T000000,435000,3,2,1380,2500,750,630
4365200425,20140624T000000,350000,2,1,740,7680,740,0
2473380920,20140813T000000,206325,5,2.5,1720,10202,1720,0
2473380920,20150227T000000,339000,5,2.5,1720,10202,1720,0
2787700630,20150318T000000,399000,4,2.5,2100,7355,2100,0
6917700305,20150219T000000,529000,2,1,1210,7667,900,310
7215720420,20150304T000000,640000,4,2.5,2210,7722,2210,0
2856100250,20141106T000000,735000,4,2.5,2470,2550,2470,0
9421500130,20140616T000000,378000,5,2.5,2760,8015,1600,1160
1250201640,20140507T000000,775000,3,2,2540,7200,1600,940
5316100920,20140725T000000,2.25E+06,3,4.25,5150,7800,4170,980
6813600605,20150128T000000,1.35E+06,4,4.5,3420,7440,3420,0
1974300020,20140827T000000,380000,4,2.5,2270,11500,1540,730
1974300020,20150218T000000,624900,4,2.5,2270,11500,1540,730
3630020380,20141107T000000,379770,3,2.5,1470,1779,1160,310
1771000290,20141203T000000,340000,3,1.75,1280,16200,1030,250
5126310470,20150115T000000,515500,4,2.75,2830,8126,2830,0
1870400605,20141117T000000,600000,4,2.25,1970,7125,1500,470
4047200825,20141011T000000,400000,1,1,1390,60984,1390,0
7304300430,20141201T000000,364000,4,1,1020,11383,1020,0
8079010190,20140626T000000,440000,4,2.5,2250,7526,2250,0
1453600182,20140528T000000,285000,2,1,800,6240,800,0
9828700235,20150401T000000,669000,3,1,1560,4500,1560,0
3448002285,20140702T000000,475000,4,2,2100,13468,1050,1050
2513500010,20150504T000000,747000,2,1,990,4000,990,0
9284801100,20150105T000000,317000,3,1.5,1060,5750,1060,0
8901000491,20140828T000000,390000,2,1,1270,8164,1270,0
452002135,20150422T000000,1.07E+06,4,2.5,2740,5000,2740,0
6610000591,20141021T000000,1.21E+06,4,2.75,2470,5500,1570,900
7518501025,20150327T000000,580000,3,1.75,1970,5100,1130,840
6072400470,20141113T000000,518000,4,2.5,2070,10244,1370,700
1865800250,20141204T000000,147500,3,1.75,1010,6552,1010,0
6072650250,20150424T000000,555000,4,2.25,2220,8125,1450,770
8807900233,20140630T000000,427500,2,2,1090,934,1090,0
3585901025,20140613T000000,1.74E+06,3,2.5,4310,32093,2510,1800
9238440020,20140717T000000,265950,3,2.5,1490,3840,1490,0
9325800005,20141201T000000,247500,2,1,700,6046,700,0
7520000020,20140523T000000,244000,4,1,1450,8960,1450,0
3904920380,20150323T000000,578550,3,2.5,2120,6602,2120,0
3630080430,20140617T000000,451000,4,2.5,1670,3315,1670,0
8682262230,20140826T000000,489000,2,1.75,1810,4220,1810,0
3326079016,20150504T000000,190000,2,1,710,1164794,710,0
7214800430,20150305T000000,475000,3,3,2540,18900,1580,960
6430000275,20140506T000000,485000,3,2,1420,4080,1420,0
1924079090,20141016T000000,530000,3,2.75,2440,45738,1840,600
1509500380,20150128T000000,379000,4,2.5,2570,10155,2570,0
9809000010,20150106T000000,1.63E+06,5,2.5,3090,16583,3090,0
8722101100,20150319T000000,739000,3,1.75,2050,5160,1300,750
8651410670,20141125T000000,189950,3,1,920,6460,920,0
3629830250,20141222T000000,637500,4,3,2320,4468,2160,160
868001435,20150127T000000,2.23E+06,3,3,3450,16740,1960,1490
4168100020,20141204T000000,209950,3,1,1660,8800,960,700
814000020,20150220T000000,460000,3,1,1130,7000,830,300
7852010950,20141020T000000,543500,4,2.5,2550,5835,2550,0
2395710010,20140605T000000,376000,4,2.75,2420,5773,2420,0
3630000130,20141028T000000,430000,3,2.25,1470,1703,1470,0
2105200010,20140904T000000,515000,4,2.5,2030,39049,1530,500
2856100381,20140711T000000,580000,7,2.75,2310,2400,2310,0
5608030020,20150203T000000,600000,5,3.5,3370,16846,2650,720
3404700080,20141112T000000,476800,3,1.75,1900,43700,1900,0
1890000275,20150429T000000,815000,3,1.5,1940,3570,1740,200
7852000010,20140527T000000,455600,3,2.5,2420,8252,2420,0
5230300280,20140515T000000,270000,3,1,1010,9514,1010,0
4232902335,20140814T000000,1.20E+06,5,4,2710,2800,2380,330
4232900250,20140710T000000,525000,2,1.5,1340,3600,1340,0
1312930250,20140528T000000,242000,3,1.75,1310,9645,1310,0
6446200305,20140623T000000,715000,4,2.5,2650,30500,1680,970
7852020670,20150402T000000,475000,3,2.75,1890,3938,1890,0
4475000170,20141111T000000,370000,4,3,2580,5511,2580,0
7202360170,20140523T000000,788600,4,2.75,3500,7200,3500,0
6146600185,20140507T000000,160000,2,1,1040,13100,1040,0
2825079001,20140814T000000,800000,5,1.75,1930,501376,1930,0
3905040780,20140924T000000,520000,4,3,2190,5085,2190,0
2488200168,20140718T000000,725000,3,1.75,1530,4000,1530,0
3336000170,20141003T000000,335000,4,1,1480,6500,1480,0
8835700010,20150116T000000,919000,4,2.5,3620,17133,2220,1400
303800020,20150513T000000,425000,3,2.75,3370,13929,2650,720
3971700670,20150314T000000,420000,5,2.5,2100,14395,1140,960
2481610050,20141124T000000,905000,4,3,3370,47959,3370,0
4154304505,20140919T000000,435000,2,1,2240,7200,1120,1120
7202330170,20140717T000000,438000,3,2.5,1650,3031,1650,0
9430100020,20140617T000000,725000,4,2.75,2630,7505,2630,0
2436700280,20140528T000000,840000,4,1.75,2330,4000,1300,1030
7525211410,20140715T000000,425500,3,2.5,1970,2752,1970,0
3760500514,20140912T000000,853505,3,2.5,2820,14890,1770,1050
4067600255,20140522T000000,398000,2,1,590,10945,590,0
7853302130,20140604T000000,418500,3,2.5,2060,4399,2060,0
811000050,20141231T000000,826000,3,1.5,1890,5000,1890,0
8691330130,20140611T000000,742000,4,2.5,2810,10986,2810,0
6623400050,20140909T000000,180000,4,1,1470,18581,1470,0
9542801410,20150114T000000,286000,4,1.75,2190,8400,2190,0
7202330190,20141001T000000,421200,3,2.5,1440,3060,1440,0
3303950660,20140731T000000,390000,3,3,2480,14141,1500,980
4140930010,20140919T000000,739000,4,2.5,2780,6737,2780,0
2724069169,20140724T000000,499900,4,3,2180,12196,2180,0
7979900430,20141203T000000,670000,3,2.25,3340,13805,3340,0
1338300010,20141013T000000,842500,3,2.25,2560,3996,2150,410
5238800020,20141208T000000,492500,2,2.25,1600,80400,1600,0
4154305575,20140903T000000,836500,3,2.5,2230,7200,2230,0
6821102385,20150326T000000,334000,2,1,900,1818,900,0
6600410480,20140828T000000,179900,3,1,1010,9920,1010,0
4146800050,20141126T000000,563000,3,2,1580,5289,870,710
3793500050,20150303T000000,310000,3,2.5,1890,6300,1890,0
641900050,20140819T000000,335000,4,2.25,2160,8817,1460,700
641900050,20150206T000000,499950,4,2.25,2160,8817,1460,700
2402100715,20140726T000000,658500,2,1,1410,5101,1410,0
1453602313,20141029T000000,297000,2,1.5,1430,1650,1430,0
1890000225,20140620T000000,725000,6,1.75,2380,4080,2380,0
7525900050,20141205T000000,780000,3,2.25,2206,82031,866,1340
6413600290,20140509T000000,252500,3,1,1030,6127,880,150
952006728,20140613T000000,330000,3,2.5,1070,1155,720,350
1088801350,20150210T000000,525000,3,2.5,2320,9610,1730,590
3575302759,20140806T000000,365000,2,1.75,1270,7500,1270,0
3508100161,20150327T000000,500000,4,3,2570,9104,2570,0
8651410190,20141112T000000,179950,3,1,920,4875,920,0
1823099028,20140722T000000,440000,3,2,1790,32379,1790,0
745000005,20140825T000000,145000,1,0.75,480,9750,480,0
9414700020,20150422T000000,331000,4,3,2483,5701,2483,0
2331300415,20140620T000000,780000,3,2.25,2140,3000,2140,0
6815100380,20150514T000000,855000,3,1.75,1900,4000,1300,600
7575610250,20141014T000000,225000,3,2.25,1650,7739,1290,360
5153900080,20140714T000000,199000,3,1,1510,9100,1510,0
7525410190,20140502T000000,550000,3,1.75,2910,35200,2910,0
6819100020,20140529T000000,1.43E+06,4,4.25,4960,6000,3680,1280
1868902745,20140502T000000,805000,3,2,2710,4500,1880,830
3783100080,20140604T000000,261000,3,1.5,1810,29308,950,860
3327750020,20140909T000000,347000,3,1,940,9198,940,0
1112700010,20140619T000000,390000,3,2.25,1600,10240,1090,510
9269260420,20141110T000000,436000,4,2.5,2640,3899,2640,0
9286730020,20150331T000000,1.80E+06,5,3.25,3890,20005,2260,1630
8673400190,20140723T000000,557000,3,2.5,1630,1587,1630,0
1951600250,20150406T000000,135000,3,1,830,9600,830,0
3296900280,20150325T000000,425000,3,2.5,1800,14036,1800,0
5459000305,20150408T000000,648752,3,2.25,2060,9953,1070,990
4122900020,20140626T000000,1.39E+06,4,3,4040,20001,2020,2020
5212000020,20150324T000000,630100,4,2.75,1910,11356,1160,750
1825079005,20140609T000000,739000,4,2.5,2800,246114,2800,0
6450303235,20140818T000000,269000,3,1.5,1320,2625,1320,0
7227501190,20150427T000000,250000,3,1,1220,5038,1220,0
7853300020,20150320T000000,475000,5,2.75,3100,5298,3100,0
2922703235,20141119T000000,290000,1,1,550,5700,550,0
6138000095,20141118T000000,219000,3,1,1080,10639,1080,0
2356800020,20140929T000000,416000,2,1,880,6650,880,0
5379805495,20150413T000000,179000,2,1,720,8914,720,0
3861440010,20140715T000000,302000,4,2.75,2030,9120,2030,0
2505500009,20150427T000000,565000,4,2,2040,8281,2040,0
3388000080,20150422T000000,281700,3,1,1570,8316,1070,500
480000170,20140627T000000,480000,2,1,1500,3420,1500,0
2597650660,20141013T000000,775000,4,2.5,3180,15358,3180,0
7304300470,20140904T000000,375000,3,1.75,1260,11224,1260,0
7334600170,20141013T000000,345000,3,1.5,1390,13860,1390,0
7222000244,20150223T000000,300000,3,3,2850,9375,2240,610
9558020840,20150422T000000,364950,4,2.5,2070,2992,2070,0
5592900020,20141202T000000,410000,3,3.25,2650,7819,1760,890
8732190380,20150414T000000,231000,3,1.75,1220,8817,1220,0
2249800080,20140523T000000,445000,3,2,1630,8702,1630,0
2062600020,20140708T000000,530000,2,2.5,1785,779,1595,190
7660100309,20141226T000000,353500,3,2.5,1260,972,840,420
6093900280,20140507T000000,209950,3,1.5,1380,11130,1380,0
4154303125,20150423T000000,650000,3,1.75,2330,7200,1320,1010
2695600005,20140620T000000,325000,2,1,840,4239,840,0
3826500020,20140828T000000,257000,3,2.25,1730,9516,1180,550
9238440130,20140630T000000,337000,4,2.5,2230,5970,2230,0
3630030010,20140926T000000,541000,3,2.5,1790,4038,1790,0
1592000130,20141114T000000,577500,3,2.5,2280,10879,2280,0
2487200279,20141124T000000,560000,3,2.5,2430,5128,1270,1160
1959703070,20141029T000000,979700,5,3,3730,5500,2160,1570
4038700680,20140725T000000,750000,5,3,2230,8560,1150,1080
9390700095,20140808T000000,407500,2,1,770,2971,770,0
6392003810,20140523T000000,530000,4,1.75,1814,5000,944,870
7806210250,20150406T000000,235000,4,1.75,1920,9350,1000,920
2919200440,20150407T000000,715000,4,2.5,1860,3840,1170,690
6751500185,20150421T000000,795000,5,3,2750,10000,1730,1020
5137300130,20140509T000000,465000,4,2.5,1930,9653,1930,0
2744000010,20140513T000000,287600,3,2.5,1950,8251,1950,0
4279600010,20141230T000000,630000,6,3,2470,9328,2470,0
2540830020,20150401T000000,445000,3,2.25,1630,6449,1310,320
7214800190,20150105T000000,490000,4,2.25,2110,16200,1630,480
9169100185,20150225T000000,565000,3,1.75,1490,5000,1250,240
859000022,20140819T000000,330000,3,2.5,1740,1844,1320,420
1180005050,20141218T000000,463000,4,2.75,1900,6000,1300,600
3625700010,20140506T000000,1.87E+06,5,4,4510,15175,4510,0
7335400020,20140626T000000,219500,3,1,1090,6710,1090,0
8902000050,20141027T000000,622200,3,1.75,1720,7200,1420,300
1972200698,20140528T000000,474800,2,3.25,1400,1243,1400,0
415100010,20140611T000000,465000,4,2.5,2090,9702,1320,770
5500200010,20141014T000000,389950,3,1.75,1580,9049,1580,0
1842390130,20141024T000000,650000,4,2.5,2620,19864,2620,0
6362900007,20140905T000000,395000,3,2,1500,2506,870,630
5466380050,20141219T000000,304500,4,2.5,2030,5202,2030,0
7417700185,20150314T000000,307000,3,1,1020,8484,1020,0
4127000050,20150107T000000,485000,3,2.5,1540,7120,770,770
8084900170,20141023T000000,1.56E+06,5,3,3910,16200,2890,1020
2205700470,20150122T000000,650500,5,4.25,3920,11412,3920,0
3629200020,20150202T000000,960000,4,2.5,3180,10105,3180,0
6070800050,20150213T000000,710000,3,2.5,2330,9160,2330,0
6329000185,20150329T000000,540000,3,2.5,2600,23361,2150,450
8815400020,20140724T000000,601000,4,1.75,1950,4200,1040,910
1742800430,20150504T000000,463828,5,1.75,3250,13702,1650,1600
5006000170,20150211T000000,293000,4,1,1130,8308,1130,0
7202310010,20141020T000000,597500,3,2.5,2620,4800,2620,0
323089005,20150326T000000,240000,2,1,1120,45302,1120,0
1525079056,20140502T000000,284000,3,1.75,1800,23103,1800,0
4140900050,20150126T000000,440000,4,1.75,2180,10200,2000,180
7387500235,20140515T000000,340000,3,1.75,1960,8136,980,980
7387500235,20150317T000000,363000,3,1.75,1960,8136,980,980
3726800010,20140714T000000,270000,2,1,1150,3600,1150,0
2621760290,20140827T000000,365000,4,2.5,2800,6820,2800,0
6046401300,20140609T000000,428000,3,2,1310,2550,780,530
3326069026,20150401T000000,600000,3,1.75,2340,57499,2340,0
6608500290,20141024T000000,405000,3,2.5,1430,10200,1430,0
1862700290,20140711T000000,339900,4,2.5,2340,9748,1610,730
4331000190,20141223T000000,275000,3,1,1290,11250,1290,0
5101400994,20140717T000000,361600,2,1,760,6380,760,0
1615900020,20150320T000000,325000,6,2,2780,13950,2780,0
2804600005,20141219T000000,1.05E+06,3,2,2090,4077,1530,560
7431500280,20141110T000000,959750,4,3,3060,50002,2460,600
6303401365,20140603T000000,210000,3,1,1110,7962,1110,0
2817850290,20141201T000000,258000,3,2,1790,7879,1790,0
3205100080,20140708T000000,468000,3,1.5,1830,9848,1830,0
2464400280,20150504T000000,710000,4,3.5,2850,2910,1970,880
7889601300,20150421T000000,268000,3,1,1420,6000,1420,0
8151600101,20150116T000000,115000,2,1,790,7252,790,0
3764650010,20150513T000000,500000,3,2.5,2300,4307,2300,0
3521069150,20141017T000000,431000,3,2.5,2440,71002,2440,0
4345000440,20150223T000000,241500,3,2,1310,7349,870,440
1822059073,20150414T000000,300000,3,1,1380,12000,1380,0
2600130190,20141107T000000,982000,4,2.5,2790,10289,2790,0
7985100190,20150106T000000,248500,3,2.5,1360,7293,1360,0
305010050,20141231T000000,665000,4,2.5,2510,5936,2510,0
3761100257,20140714T000000,1.22E+06,3,3,4560,16339,4040,520
952003340,20140709T000000,380000,2,1,780,3910,780,0
3347401315,20140616T000000,220000,3,2,1410,7998,1410,0
513000585,20140707T000000,631500,4,2,2530,5650,1910,620
1049010050,20141219T000000,386100,3,2,1270,6760,1270,0
1370802455,20140813T000000,1.05E+06,4,4.5,3180,4606,1990,1190
4206901435,20150122T000000,650000,2,1.75,1450,4000,1350,100
1467400095,20150224T000000,545000,4,1.75,2040,53578,1160,880
2592210290,20141010T000000,870000,4,2.5,2650,12001,2650,0
3034200275,20140817T000000,380000,3,1.75,1240,8611,1240,0
7221400285,20150209T000000,265000,2,1,820,8423,820,0
7518502210,20140530T000000,645500,2,1,1890,5202,1890,0
1646501845,20140913T000000,570000,3,2,1270,3090,1270,0
8081020380,20150217T000000,1.20E+06,4,2.5,3350,11688,1760,1590
2158900095,20141027T000000,605000,2,1,1550,3200,1550,0
4031000460,20140610T000000,199500,3,1,920,9812,920,0
3881900605,20150315T000000,445000,2,1,950,4800,950,0
5700002285,20141016T000000,495000,4,1.75,2040,3570,1020,1020
6392002635,20140612T000000,594000,4,1.75,1870,5200,1200,670
6822100305,20140819T000000,465000,3,1.75,1720,5280,900,820
1871400585,20150422T000000,160000,2,1,1020,13647,1020,0
7300410010,20141204T000000,340000,4,2.5,2690,6099,2690,0
925069134,20140910T000000,870000,4,2,3090,41147,3090,0
2114700460,20140818T000000,249000,3,1.5,1070,5150,1070,0
3326059238,20150506T000000,500000,4,2.25,2050,7201,2050,0
3750606890,20140626T000000,220000,3,1.5,1660,15600,1660,0
9117100130,20140812T000000,368500,5,1.75,2810,9360,1520,1290
5469502660,20140929T000000,439950,4,2.25,2460,14600,1720,740
3356402232,20140924T000000,179900,3,1.75,1230,12000,1230,0
8030500010,20140528T000000,490000,4,2.5,2360,4367,2360,0
2425700022,20140929T000000,425000,4,1.75,1730,11890,980,750
3956100050,20140829T000000,533300,4,2.5,2770,21806,2770,0
5292200010,20150116T000000,447500,4,2,1770,3332,1630,140
4178310080,20140723T000000,768000,5,2.75,3030,13640,3030,0
1180002745,20140521T000000,285000,3,1.75,2380,6000,1320,1060
4047200655,20140509T000000,336900,3,1.75,1780,120661,1780,0
9477000080,20140714T000000,415000,4,1.5,1540,7886,1540,0
3905100840,20140723T000000,500000,3,2.25,1580,4379,1580,0
7885800290,20141103T000000,337000,4,2.5,3200,5772,3200,0
9475710170,20140919T000000,419950,4,2.5,2220,6800,2220,0
6885900415,20150107T000000,290000,4,2.75,2240,8162,1380,860
5285200020,20140718T000000,349950,2,1.75,1640,4176,1040,600
4039400430,20140516T000000,330000,3,1.5,1170,4950,1170,0
2481610170,20140609T000000,965000,4,2.25,3160,34560,3160,0
1795910420,20141031T000000,515000,3,2.5,2100,7851,2100,0
7135521680,20140522T000000,665000,4,2.5,2600,17388,2600,0
2011000020,20140826T000000,265000,3,1.75,1630,5999,1630,0
1196002395,20140917T000000,545400,3,2,2850,19200,2340,510
3876590420,20140624T000000,350000,4,3,2560,5606,2560,0
4358700164,20141113T000000,260000,2,1.5,980,1296,840,140
7631800015,20150407T000000,2.51E+06,3,3.25,5480,57990,5480,0
3260810150,20140926T000000,355000,3,2,2160,8091,2160,0
7015201015,20141028T000000,879000,3,3,3030,5156,2080,950
9348700450,20140818T000000,833000,4,3.5,3560,7178,2590,970
3151600035,20150107T000000,261590,2,1,760,6407,760,0
2254502070,20141105T000000,512500,3,3,2260,2400,2260,0
8127700210,20150427T000000,600000,2,1.75,1560,3200,880,680
2926049237,20141006T000000,417500,5,3,2270,6664,1340,930
7785000230,20140527T000000,970000,5,3,3480,15185,3480,0
2025701390,20140812T000000,316000,3,2.25,1900,7479,1900,0
1561900330,20150306T000000,397500,4,3,2350,9952,1650,700
1370800940,20140721T000000,1.35E+06,3,2.5,2390,5500,1700,690
8691300900,20140821T000000,840000,4,2.5,3730,9847,3730,0
3751606514,20140626T000000,270000,2,1,1780,81021,1780,0
5104510490,20140527T000000,312900,4,2.5,1630,4473,1630,0
3432500210,20150326T000000,325000,2,1,1130,6908,1130,0
2771604791,20140719T000000,680000,3,1.75,2140,3584,1070,1070
2537500040,20150304T000000,763000,4,2.5,3220,7873,3220,0
1222069089,20140904T000000,375000,1,1,800,533610,800,0
3332500100,20150408T000000,475000,3,2.5,1800,3300,1690,110
7625702616,20141121T000000,219000,2,2.5,809,940,809,0
2561330040,20150323T000000,415000,3,2.25,1820,9694,1240,580
1423049019,20140523T000000,90000,2,1,580,7500,580,0
1423049019,20150331T000000,220000,2,1,580,7500,580,0
9277200065,20150226T000000,616000,3,2,2900,5650,1520,1380
1920079039,20140815T000000,269500,2,1,1140,74052,1140,0
7515000035,20150424T000000,395350,2,1,1060,5754,1060,0
5315101728,20150319T000000,770000,4,3,2320,7200,1260,1060
326069164,20150429T000000,840000,4,2.5,3450,43216,3450,0
2695600410,20141106T000000,428950,2,1,1760,4441,1310,450
9348700610,20141217T000000,800000,4,3.75,3370,6766,3370,0
7308900100,20140619T000000,401000,4,1,1940,5753,1940,0
1453601502,20150226T000000,303697,4,2,2520,7334,1600,920
4077800593,20140915T000000,355000,3,1,1360,8968,1360,0
9268200641,20140820T000000,350000,2,1,800,5040,800,0
6705850300,20150414T000000,754999,4,2.5,3010,9323,3010,0
3720800115,20150331T000000,982218,3,1.75,2340,5500,2340,0
8079040330,20140927T000000,406500,3,2,1780,8621,1780,0
1824079052,20150401T000000,1.65E+06,4,3.25,4200,210394,4200,0
1923300315,20150217T000000,565000,2,1.75,1720,3000,860,860
3336001316,20141106T000000,160000,2,1,830,4500,830,0
9382200025,20150115T000000,220000,3,1,1090,6320,890,200
7237500650,20150213T000000,1.28E+06,5,4.25,5040,9466,5040,0
3100500065,20140708T000000,970000,5,2.75,3500,5040,2950,550
795000620,20140924T000000,115000,3,1,1080,6250,1080,0
795000620,20141215T000000,124000,3,1,1080,6250,1080,0
795000620,20150311T000000,157000,3,1,1080,6250,1080,0
8651430220,20140725T000000,183000,3,1,870,5200,870,0
7954300740,20140909T000000,527000,4,2.5,2830,6163,2830,0
4046601460,20140606T000000,407193,4,2,1880,14653,1880,0
6933600456,20150313T000000,970000,4,2.75,3600,5040,2610,990
9357000650,20140527T000000,535000,4,2.5,2340,5600,2340,0
7347600490,20140814T000000,245000,3,2,2040,13125,810,1230
5095400760,20140623T000000,337000,3,1.75,1310,12750,1310,0
1245003660,20150321T000000,630000,3,2,1470,6000,1090,380
3275300040,20140606T000000,320000,3,1.75,1370,9900,1370,0
2407000405,20150226T000000,228500,3,1,1080,7486,990,90
6664900330,20150223T000000,293000,3,2.5,1990,7577,1990,0
4036800900,20140924T000000,447000,3,1,1310,7000,1310,0
8648220150,20140507T000000,226500,3,1.75,1640,10762,1130,510
3876313170,20141209T000000,436000,3,2.25,1770,8000,1350,420
2738600220,20140804T000000,451000,3,2.5,2050,4876,2050,0
1593000690,20150408T000000,315000,3,1,1170,62290,1170,0
5101406536,20141028T000000,450000,2,1,1340,7250,1340,0
2267000485,20141201T000000,635000,3,1.5,2240,5300,1120,1120
822059059,20150325T000000,292500,2,1,880,17743,880,0
2310110230,20140520T000000,329900,3,2.5,2170,4905,2170,0
7974200777,20141118T000000,531000,2,1.5,1260,6660,1260,0
2025059201,20140731T000000,725000,3,1.75,1880,13300,1380,500
1074100110,20140525T000000,355300,3,2.5,1620,7410,1620,0
8000200090,20150427T000000,280000,3,2.5,1610,10022,1610,0
1247100035,20140630T000000,1.10E+06,4,2.75,3330,9143,3330,0
7010700210,20140605T000000,605004,4,2,1370,4000,1370,0
7950304065,20150309T000000,260000,2,1,690,6000,690,0
9523100026,20140723T000000,748000,4,2.5,3170,4979,2570,600
1093000090,20150416T000000,776000,2,2,1990,6180,1010,980
1532300155,20140916T000000,425000,4,1,1080,6095,1080,0
4006000423,20150108T000000,230000,4,1,1870,14703,1090,780
8665900331,20150130T000000,418000,3,1.75,1670,12075,1370,300
3370000150,20140804T000000,440000,4,2.5,2800,28254,2800,0
1853080540,20141124T000000,858450,5,2.75,3460,7977,3460,0
1023089197,20141007T000000,390000,3,2,1930,12443,1930,0
1175001075,20140916T000000,957000,4,3,2370,3836,1750,620
6392001810,20140904T000000,507000,3,1,1180,6000,1180,0
2767603160,20150225T000000,575000,2,1,1320,4750,1320,0
8129700985,20150427T000000,700000,3,1.75,1350,4000,1350,0
9406500600,20150205T000000,239950,2,1.5,1068,1452,1068,0
3830620300,20141103T000000,253000,3,1,1580,8240,1040,540
4237901250,20150327T000000,540000,4,1,1690,3417,1690,0
3754501240,20150206T000000,1.55E+06,3,4,5120,4600,4490,630
2226069018,20141112T000000,805000,4,2.5,3960,38615,3960,0
4206901215,20140612T000000,920000,4,3.25,2420,4000,1870,550
3904930730,20141105T000000,496600,3,2.5,1910,5562,1910,0
2115510300,20141016T000000,246000,3,2.25,1440,10500,1130,310
1773100620,20150505T000000,350000,5,3,2320,8400,1510,810
5075400150,20140523T000000,585000,3,2,1670,4572,1670,0
3893100319,20150323T000000,450000,3,1.75,1390,11700,1390,0
4139440610,20140512T000000,746000,3,2.5,2620,8950,2620,0
2481590090,20141027T000000,598555,3,2.5,3040,7880,3040,0
3222049151,20141030T000000,820000,3,2.5,2990,10711,1560,1430
1545805030,20141021T000000,266500,3,2.25,1740,5460,1210,530
620079042,20150323T000000,370000,2,1,2360,105850,1180,1180
6848200325,20140904T000000,625000,3,2.75,2240,3600,1650,590
6929603207,20141210T000000,243500,4,2,1610,6200,1610,0
3626039229,20150317T000000,340000,2,1,700,5829,700,0
5589900610,20140918T000000,559950,5,3,2730,9519,1670,1060
7153400100,20150219T000000,315000,3,2.75,1780,15114,1080,700
1125069086,20150428T000000,753000,3,2.5,3070,223463,3070,0
2902200076,20150128T000000,800000,3,3,2060,3200,2060,0
8024201210,20140911T000000,550000,3,2.25,1360,5111,1360,0
3755500065,20141106T000000,465000,3,2,1430,14250,1430,0
3890600150,20140528T000000,465000,3,2.25,1840,5752,1840,0
2141320230,20150410T000000,710000,4,2.25,2000,8068,2000,0
8078430360,20141216T000000,505000,3,2.5,1820,11012,1820,0
333100209,20150318T000000,690000,3,1.75,2330,16300,2330,0
5419800090,20141121T000000,217500,2,2,1070,8400,1070,0
1868900395,20140902T000000,500000,2,1,930,3750,930,0
1568100730,20150218T000000,325000,2,2,1040,5796,1040,0
1785400770,20140825T000000,500000,4,2.25,1960,12436,1960,0
2724079014,20150331T000000,721500,3,3.25,2970,234788,2040,930
1370801800,20140519T000000,924000,3,1.5,2200,5000,2200,0
3585901085,20140604T000000,2.01E+06,6,4.5,3810,28176,3810,0
424049283,20150415T000000,345000,2,1.5,830,1034,830,0
7851990230,20150316T000000,825000,4,3.5,3920,11086,3920,0
1423069076,20140926T000000,560000,3,2,2870,95396,1350,1520
1786830090,20140708T000000,599000,3,2,2560,14680,1330,1230
2968801240,20140512T000000,211000,3,1.5,1350,7620,1350,0
3344500210,20150424T000000,425000,4,2.25,1240,21190,910,330
226039317,20150107T000000,750000,4,2.75,3210,8520,1810,1400
7202330530,20150116T000000,479000,3,2.5,1690,3322,1690,0
3905090230,20150227T000000,612500,4,2.5,2550,10623,2550,0
6446200365,20150505T000000,605000,5,1.75,3240,34510,2690,550
856001130,20150223T000000,1.36E+06,4,2.5,3560,8960,3560,0
7861500150,20141202T000000,389900,3,2.5,2160,59241,2160,0
5014600210,20141215T000000,710000,4,2.5,3060,5000,3060,0
2215900900,20150505T000000,295000,3,2.5,1690,8564,1690,0
2025700740,20140702T000000,275250,3,2.25,1520,7199,1520,0
2591730230,20140912T000000,250000,4,2.5,2040,5770,2040,0
7611200195,20150220T000000,709000,3,2,2360,18000,2180,180
9297800090,20140708T000000,399500,4,1.75,1360,4840,1360,0
2215900930,20140509T000000,225000,3,2.5,2000,9202,2000,0
7215730930,20150112T000000,500000,3,2.5,1650,4648,1650,0
5201810110,20140609T000000,364900,3,3,2500,8304,2500,0
3575302562,20141113T000000,356000,3,1.5,1140,7500,1140,0
3438502290,20150202T000000,616750,3,1.5,2140,47743,2140,0
8881900230,20141202T000000,755000,3,2.75,2870,6600,2870,0
3500100015,20140812T000000,327500,2,1,830,8183,830,0
8651511250,20150415T000000,605000,3,2.25,1960,10139,1960,0
8651401960,20150413T000000,179950,4,1.5,1130,5200,1130,0
7937900040,20141219T000000,633000,5,2.75,3630,30570,3630,0
6199000141,20150312T000000,349950,4,2,1764,15600,1764,0
3271300365,20150407T000000,1.08E+06,3,2.75,2770,5800,1650,1120
9264030040,20150430T000000,425000,3,2.5,2650,12247,2650,0
9829200580,20140917T000000,990000,3,2.75,2500,6350,2370,130
2929600035,20140627T000000,410000,3,1,2710,19000,2710,0
3459410230,20141111T000000,590000,3,2.25,2490,8800,2490,0
7303200450,20150408T000000,242000,3,1.75,1500,7560,1500,0
924069042,20141125T000000,775000,3,2,1160,13747,580,580
287000110,20140625T000000,680000,4,1.5,1880,6200,1440,440
1018000276,20150327T000000,217000,3,2.5,1340,4200,1340,0
1560870040,20150421T000000,395000,3,2.5,1960,3953,1960,0
7135500120,20140519T000000,572500,3,2.25,2030,9791,1500,530
5101408835,20140909T000000,559900,5,3,2200,6380,1440,760
472000590,20140624T000000,845000,3,2,2540,4750,1840,700
104550750,20140728T000000,241000,3,2,1520,7131,1520,0
7576700150,20141001T000000,1.33E+06,3,2.25,2360,5504,2080,280
7137300245,20150429T000000,475000,3,1.75,1340,2805,1340,0
5511600315,20150218T000000,575000,2,1.5,1400,5810,1400,0
1422059039,20140828T000000,455000,4,2.75,3030,117378,1680,1350
1026069095,20140624T000000,839000,3,2.5,3200,203425,3200,0
2207100165,20150430T000000,475000,4,1.5,1580,10260,1030,550
1705400361,20141208T000000,600000,2,1,2120,6897,1060,1060
1370804115,20141106T000000,515000,2,1,1640,5200,1040,600
9527000090,20150318T000000,425000,3,2.25,1890,8400,1520,370
1556200145,20141007T000000,565000,4,2,1710,3875,1710,0
1245500286,20140523T000000,498000,2,2,1140,8282,1140,0
8824900120,20140606T000000,739000,4,3,2720,3800,1800,920
3959401645,20140604T000000,355000,2,1.75,1650,4000,950,700
9264900880,20140715T000000,263000,3,1.75,1790,7485,1330,460
2826049160,20140905T000000,375000,4,1.75,1680,6834,1680,0
3449500035,20140930T000000,322000,3,1.75,2200,12231,1250,950
9266700845,20150429T000000,325000,2,1,830,5100,830,0
2493200455,20141021T000000,290000,2,1,770,4800,770,0
6352600210,20140611T000000,809950,4,2.5,3280,6181,3280,0
4278900110,20141009T000000,969500,3,3.25,2080,3025,1220,860
7214790110,20140613T000000,665000,4,2.5,2790,43091,2790,0
9358400150,20150206T000000,635000,5,3.5,4150,13232,4150,0
1545802100,20141029T000000,272450,3,2.25,1780,7332,1780,0
8563000110,20150424T000000,427000,4,1.75,1460,9750,1460,0
8074400150,20150401T000000,261500,3,1,1410,8174,1410,0
1951800040,20140620T000000,488800,4,2.25,2170,9665,1300,870
7934000090,20150225T000000,340000,2,1,690,5200,690,0
50300090,20140811T000000,398950,4,3,3000,10297,3000,0
8651430210,20150321T000000,217000,3,1,870,5200,870,0
126059019,20150316T000000,799000,4,2.5,3170,94855,1910,1260
2599700040,20141230T000000,160000,4,1,1540,7350,770,770
9512501400,20140902T000000,447000,3,1,1270,8800,1270,0
9169600043,20150424T000000,765000,3,1.75,2190,6450,1480,710
4139900210,20140620T000000,1.32E+06,4,3.5,4410,36200,4410,0
9558010090,20140822T000000,445000,4,2.5,2790,8111,2480,310
8101900100,20150328T000000,310000,3,1,1510,6000,1170,340
5592900205,20150409T000000,380000,2,1.75,1800,7191,990,810
1624049228,20141124T000000,325000,4,1,2410,6975,1510,900
2473410360,20140617T000000,345000,4,2.75,2250,7412,1480,770
7750500120,20141118T000000,300000,3,1,950,4760,950,0
1630700361,20140627T000000,530000,4,1.75,2860,48351,1710,1150
1630700361,20150409T000000,583500,4,1.75,2860,48351,1710,1150
4025300210,20150217T000000,410000,2,1,1560,10125,1130,430
2922701175,20140919T000000,535000,2,1.5,1940,5700,970,970
7352200450,20150115T000000,2.05E+06,4,3.25,3580,19989,3480,100
9320990120,20140703T000000,345000,4,2.5,2040,5523,2040,0
1238500281,20150410T000000,539000,5,1,1700,11727,1700,0
1951800580,20141024T000000,590000,4,2.5,3700,12500,1920,1780
3530430100,20140815T000000,187000,2,1.75,1050,2926,1050,0
1623059092,20140509T000000,270000,3,2,1690,9583,1690,0
7177300735,20150329T000000,546000,2,1,1120,6180,1120,0
1525039057,20140702T000000,520000,3,1.75,1490,1036,1090,400
5393601635,20141229T000000,515000,5,2,2220,6000,1390,830
4217401240,20140717T000000,990000,3,2.5,2160,6000,1880,280
3438501450,20150507T000000,382000,2,1,870,10492,870,0
1872900065,20150410T000000,1.21E+06,3,1.75,1900,13600,1900,0
9285800180,20140626T000000,900000,4,3.5,3370,5000,2470,900
4322200220,20150421T000000,675000,3,2.75,3370,5350,2310,1060
1819800042,20141114T000000,460000,2,1,880,3300,880,0
2946001675,20140603T000000,234000,2,1,940,5375,940,0
1138010530,20150429T000000,399000,3,1,1340,7191,1340,0
7763400035,20150402T000000,253500,3,1.5,1440,12040,1440,0
925059107,20140820T000000,475000,3,1.5,1750,12632,1750,0
1112000100,20150330T000000,740000,5,3.5,3990,5000,2910,1080
7010700936,20140613T000000,799000,3,2.5,2860,4442,2860,0
9558010300,20150423T000000,390000,4,2.5,1940,3864,1940,0
7304301010,20140915T000000,421000,2,1.5,1400,11245,1400,0
2329800110,20150128T000000,296500,3,2.5,1770,6033,1770,0
8712100530,20140813T000000,895000,4,2,1710,4178,1710,0
3814800300,20140811T000000,386000,4,2.5,2810,11897,2810,0
4022300035,20141009T000000,424000,3,1,1580,13912,1580,0
6021503840,20140610T000000,749000,3,1,1580,5000,1580,0
5210200081,20141110T000000,523000,3,1,1440,8681,1440,0
821049123,20141028T000000,389000,4,2.5,2420,9147,2420,0
6929600945,20140825T000000,270000,4,1.5,1930,15000,1930,0
5229300027,20140910T000000,275000,3,1,1190,27215,1190,0
2214800730,20140905T000000,287500,4,2.5,2240,6944,1310,930
3521059124,20140924T000000,345000,2,2.5,2550,216344,2550,0
1931300850,20140527T000000,427000,2,1,920,3780,920,0
2206500110,20140905T000000,508450,4,1.75,1520,9600,1000,520
3856903515,20141222T000000,705000,3,2,1460,6250,1460,0
5561401530,20141029T000000,550000,1,1.5,1900,40600,1450,450
2206900065,20150501T000000,380000,3,1.5,1430,11173,1430,0
7852090820,20140729T000000,539900,3,2.5,2500,4203,2500,0
2354300915,20140903T000000,330000,2,1,720,7250,720,0
9214400120,20140602T000000,455000,2,1,1140,5720,850,290
7298050090,20141007T000000,510000,4,4,3530,10935,3530,0
1323059098,20150402T000000,315000,3,2,1220,14645,1220,0
7345000120,20140617T000000,206000,3,1,1320,7000,1320,0
8563050110,20140522T000000,592500,4,3,2170,8240,1370,800
3754010040,20141023T000000,744000,3,2.5,2020,7512,2020,0
8944320100,20141027T000000,334500,3,2.5,1990,3694,1990,0
6788201781,20140605T000000,886000,4,2,2660,3900,1480,1180
1036400100,20141021T000000,600000,4,2.5,2360,13500,1780,580
323089085,20150422T000000,850000,3,2,2740,101930,2740,0
7905200365,20150408T000000,550000,3,1.75,1360,5850,1000,360
2420069268,20140821T000000,184900,2,1,1230,5000,1230,0
7957600025,20140508T000000,245000,3,1.5,1260,7964,1260,0
1338600090,20140923T000000,370000,2,1,1040,4172,1040,0
5255690100,20150421T000000,480000,4,2.5,2700,9700,1670,1030
1646500365,20141121T000000,579000,3,1.75,1800,4429,1800,0
2645500021,20141009T000000,339275,3,1.5,1590,7260,1080,510
2220069003,20150223T000000,425000,3,2.75,1360,542322,1140,220
2123049498,20150120T000000,170000,3,1.75,1370,10780,1370,0
4139450360,20140514T000000,950000,4,2.5,3320,7644,3320,0
2600100300,20140916T000000,623000,4,2.5,2980,9235,1690,1290
2767600150,20140519T000000,477000,3,2.5,1350,2053,1350,0
1771000970,20141010T000000,330000,3,1,1160,9600,1160,0
7960100120,20140612T000000,600000,3,2.25,1480,5400,1480,0
424049039,20140707T000000,570000,3,2,1640,2808,820,820
7853220970,20140528T000000,515000,4,2.5,2680,7178,2680,0
439000230,20150429T000000,805000,4,2.25,2440,9889,1540,900
9406510040,20150206T000000,555000,4,2.5,2920,24074,2920,0
7697850360,20150204T000000,245000,3,2.25,1780,9598,1780,0
2923500750,20140718T000000,638150,4,2.5,2170,7275,1820,350
3024059057,20150501T000000,1.65E+06,4,4.5,5550,16065,3880,1670
322059095,20140811T000000,269950,4,2.5,2060,13500,1260,800
8651400580,20140920T000000,195000,3,1.5,1050,5525,1050,0
7812800855,20150311T000000,159100,2,1,790,7095,790,0
4151800265,20150306T000000,550000,3,1,1010,6120,1010,0
1005000062,20140801T000000,299000,2,1,1040,4600,1040,0
9528105305,20150121T000000,1.38E+06,4,3.5,3130,4500,2060,1070
7225000215,20150407T000000,249500,2,1,900,4500,900,0
5605000215,20150225T000000,700000,4,1,1470,5450,1470,0
1922059401,20140725T000000,275000,4,1,1080,26114,1080,0
3824100286,20150319T000000,565000,3,2.25,2440,8378,1480,960
1226039058,20150503T000000,425000,4,1.75,2520,11017,1320,1200
2770605175,20150227T000000,620047,4,1.75,1760,6000,880,880
6791200120,20140923T000000,480000,3,2.25,1820,13362,1220,600
6791200120,20150407T000000,515000,3,2.25,1820,13362,1220,600
4137010590,20140514T000000,420000,4,2.5,3040,24123,3040,0
5495200040,20150126T000000,610000,5,3.25,3490,23400,1890,1600
868000175,20141001T000000,849000,4,1.5,2440,8040,1440,1000
8820902549,20141119T000000,718000,3,1.75,2280,3446,2280,0
8731980040,20140506T000000,295000,3,2.25,1980,8000,1560,420
3096000040,20150430T000000,871000,5,1.75,2360,6150,1180,1180
4058800215,20140528T000000,430000,3,3.75,3890,7140,2390,1500
3579800405,20140825T000000,440000,4,2.5,2300,10880,1190,1110
3188100065,20140527T000000,405000,2,1,910,6490,910,0
8570900038,20140811T000000,340000,3,2,1140,11620,1140,0
4379400490,20140710T000000,675000,4,2.5,2390,5249,2390,0
952003575,20140527T000000,480000,3,1,1150,4945,1150,0
162500015,20141020T000000,362500,5,2,2330,8586,1270,1060
7732410360,20140822T000000,752888,3,2.5,2420,9000,2420,0
3031200120,20141118T000000,255000,4,1.75,960,8863,580,380
2131700900,20140813T000000,283700,1,1.75,1010,10900,1010,0
2122059198,20140825T000000,335000,4,2.5,2370,6000,2370,0
7340600735,20140603T000000,285000,3,1.75,2880,18296,1580,1300
2923049393,20140813T000000,278000,4,2.25,2400,7738,2400,0
7922710450,20150327T000000,731000,5,2.5,3670,8960,3670,0
192450180,20150310T000000,335000,3,1.5,1140,15890,840,300
782700120,20150323T000000,334200,3,1.75,1410,45302,1410,0
2887703155,20150225T000000,642000,6,1,1530,4305,1530,0
5700000245,20140602T000000,540000,4,1.75,1720,4240,1460,260
2420069003,20150331T000000,299000,3,2.5,1620,79993,1620,0
9274202165,20150120T000000,560000,3,1.75,1570,4375,970,600
9287802410,20140822T000000,852000,5,2.75,1990,3750,1990,0
2324039077,20150427T000000,306000,2,1,930,5650,930,0
9329300040,20140910T000000,440000,3,1.75,1550,7820,1210,340
259700180,20150428T000000,517000,4,1,1650,8250,1650,0
5100400315,20140523T000000,379000,2,1,800,6380,800,0
3424069076,20141013T000000,360000,2,1,930,6098,930,0
9138100261,20141029T000000,645000,4,1.5,2550,4000,1760,790
7227500740,20141107T000000,217000,2,1,720,4760,720,0
8150100265,20141118T000000,255000,2,1,620,4760,620,0
1150000040,20140721T000000,625000,3,2.5,2360,12164,2360,0
9238900616,20140610T000000,680000,3,1.75,1760,8400,1460,300
9289900065,20140911T000000,440000,3,1.75,2100,29735,1080,1020
7504020610,20140618T000000,615000,5,2.25,2480,12070,2480,0
7454001210,20140603T000000,239000,3,1,1040,6860,1040,0
2122039137,20150413T000000,462500,3,2.5,1656,108900,1656,0
6884800180,20140611T000000,619400,4,2,2090,3610,1790,300
7110000068,20140703T000000,975000,6,2.75,2520,54160,2520,0
7625701935,20141013T000000,330000,2,1,700,4000,700,0
4054500180,20140724T000000,985000,4,3.25,4030,36762,4030,0
2917200475,20150323T000000,430000,2,1,760,7114,760,0
3262300555,20140708T000000,2.46E+06,4,5.25,6500,14986,5180,1320
1245003740,20140723T000000,778000,3,2,1840,6000,1720,120
1796381120,20140728T000000,219000,3,2,1090,7350,1090,0
3761100180,20140917T000000,1.60E+06,4,2.5,2980,13341,1800,1180
6666800180,20150130T000000,715000,4,2.25,1900,8272,1460,440
8651200040,20140814T000000,950000,4,2.5,2790,15653,2790,0
5100402310,20141212T000000,425000,2,1,1280,5026,1020,260
421049170,20140717T000000,239000,3,1,1510,15022,1510,0
726059047,20141216T000000,310000,1,1,920,8282,920,0
5100403636,20150223T000000,400000,2,1,700,8120,700,0
1535204365,20141124T000000,428000,2,1.75,1980,44550,1280,700
4240400155,20140812T000000,600000,3,1,1440,4300,1440,0
5468750040,20150126T000000,415000,4,4,2740,8250,2740,0
9158100040,20140808T000000,401000,2,1,1400,8220,1400,0
7460000040,20141215T000000,292000,3,1.75,2270,7156,1370,900
2927600155,20140722T000000,291750,3,2.25,1310,12825,1310,0
8731950910,20150218T000000,227000,3,1.75,1680,7455,1680,0
1726600110,20140717T000000,675000,3,2.25,2260,13209,2260,0
3320000212,20141006T000000,397500,3,2.25,1350,980,1050,300
1670400068,20140618T000000,206000,2,1.5,1820,8867,1820,0
7424700145,20140730T000000,1.19E+06,3,3.5,3380,3333,2800,580
2408800120,20140716T000000,360000,4,1.75,2140,49658,2140,0
1776230180,20141008T000000,427500,4,2.5,2430,3249,2430,0
7889601320,20140725T000000,115000,2,1,940,6000,940,0
7589200153,20140609T000000,559000,3,1.5,2070,5386,1140,930
8032700175,20141027T000000,420000,4,1,1510,1501,1510,0
9238430300,20141106T000000,550000,4,1.75,2550,39460,1890,660
6150700180,20140922T000000,282150,2,1,700,5940,700,0
3330501645,20150223T000000,260000,3,1,1150,3090,1150,0
7853210180,20141002T000000,428000,3,2.5,2340,3466,2340,0
6149700194,20141015T000000,319950,3,3.25,1510,1245,1510,0
3625049079,20140801T000000,1.35E+06,3,2,2070,9600,1590,480
2979800750,20140911T000000,552000,2,1,1150,5000,1050,100
2887700970,20150209T000000,637000,4,2.75,2190,2867,1470,720
8732130940,20140609T000000,213000,4,1.75,1980,9000,1480,500
2968800645,20150428T000000,215000,3,1,960,7200,960,0
2351800065,20150217T000000,590000,3,1.75,2180,6120,1380,800
2822069080,20141121T000000,390000,4,2.5,2560,43560,2560,0
5018200110,20140922T000000,287000,4,2.25,2270,11997,1540,730
1235100371,20140717T000000,580000,5,2.75,3550,9600,3550,0
3904930410,20141028T000000,424000,3,2,1330,5632,1330,0
3529000880,20150309T000000,610000,4,2.5,2110,6360,2110,0
8081020330,20140729T000000,1.32E+06,4,3.25,3470,11843,2270,1200
2516000515,20141218T000000,623500,4,3,1550,3350,860,690
3223039010,20140804T000000,260000,2,1,570,81893,570,0
9828702588,20150311T000000,906000,3,2.5,2030,1800,2030,0
6672920150,20150406T000000,330000,3,2,1500,11233,1500,0
9485700150,20150304T000000,275000,2,1,920,7688,920,0
3500100208,20141119T000000,290000,3,1,1470,8200,1040,430
4083302915,20140917T000000,599950,2,1,1150,3775,1150,0
1560920450,20140924T000000,550000,4,3,4180,35169,4180,0
2475200930,20140722T000000,289000,3,1.75,1690,3449,1690,0
2064800120,20140602T000000,411000,4,2.75,2150,9915,1240,910
272000945,20150325T000000,826000,3,3.25,2330,4000,1730,600
9476700035,20140710T000000,400000,4,2,2680,13680,2350,330
859000018,20140814T000000,342000,3,2.5,1740,2226,1320,420
4237900645,20141010T000000,475000,2,1.75,1320,3420,1080,240
2436200436,20140708T000000,1.21E+06,4,3.5,3150,5500,3150,0
7635801321,20140723T000000,455000,4,3,2480,9238,2050,430
3975400085,20140624T000000,850000,4,3,3330,4000,1790,1540
1099600220,20150108T000000,185000,3,1,1010,6400,1010,0
8952900245,20140715T000000,850000,6,3.25,4920,20590,2730,2190
1622049140,20140805T000000,239900,4,1.75,1570,18730,1200,370
2824069373,20140515T000000,765000,5,3.75,3580,14275,3190,390
1774000330,20140707T000000,437000,3,1.75,2220,17568,2220,0
1555300530,20140714T000000,240000,3,1.5,1010,10350,1010,0
4402700593,20150428T000000,395000,2,1,1440,7808,860,580
2556500040,20150106T000000,320000,3,1,1230,7492,1230,0
1737100040,20141022T000000,525000,3,1.75,1710,7350,1280,430
7575620120,20150422T000000,260000,3,3,2390,8993,1680,710
2817900100,20150330T000000,450000,3,2.75,2840,39324,2200,640
1939100610,20140623T000000,560000,4,2.5,2300,7989,2300,0
4174600386,20150414T000000,310000,5,3,2270,5001,1360,910
1310440590,20150413T000000,440000,3,2.5,2290,6302,2290,0
4037200690,20141208T000000,458450,4,1,1330,9715,970,360
8072000035,20150326T000000,200000,3,1,1200,10703,1200,0
2125410210,20141206T000000,430000,3,2.25,2160,6527,1580,580
3755000120,20150226T000000,360000,3,1,1120,10500,1120,0
3598600088,20150109T000000,311000,4,2.5,2090,11645,1200,890
4083305633,20140722T000000,615000,3,3.25,1470,1152,1470,0
9545200180,20141126T000000,575000,3,1.75,2270,10136,2270,0
46100504,20140617T000000,2.03E+06,4,3.75,4100,22798,2540,1560
952000925,20140922T000000,430000,3,1.75,1440,4025,720,720
4039300490,20140603T000000,400000,3,1.5,1200,4800,1200,0
8151600941,20140828T000000,340000,3,1.75,1720,10710,860,860
3448001975,20150504T000000,351000,1,0.75,930,6600,930,0
2141500040,20140912T000000,440000,4,2.5,2400,8038,2400,0
2798600120,20150422T000000,298000,4,2.5,1960,11798,1960,0
2227900040,20150114T000000,300000,4,1.75,1890,9205,1260,630
3395040580,20141023T000000,310000,3,2.25,1590,3056,1590,0
6137610620,20140808T000000,500000,4,2.5,2590,9354,2590,0
7518505375,20150505T000000,399900,3,1,860,1664,860,0
9206950100,20140617T000000,343000,3,2.5,1270,2509,1270,0
9542890100,20141229T000000,415000,2,2.25,1130,2191,1130,0
4254000620,20141007T000000,410000,3,2.5,1860,15457,1860,0
6414100026,20150108T000000,320000,2,1,1802,11225,1802,0
1346300035,20140626T000000,1.99E+06,5,3,4480,5000,3420,1060
2212210360,20140702T000000,253000,2,1,1310,7128,940,370
205000410,20140915T000000,630000,3,2.5,2320,32772,2320,0
2892600056,20150106T000000,216000,2,1,1130,12500,1130,0
3396800120,20150427T000000,540000,3,2.5,2180,11100,1230,950
2320069089,20140930T000000,212000,3,1.5,1830,12233,1830,0
4036400110,20150129T000000,300000,3,2.75,2340,12282,1470,870
7518506716,20140827T000000,969950,3,2.5,2830,3750,2830,0
9826701765,20140808T000000,715000,3,1,1610,7680,900,710
1438700040,20140825T000000,1.32E+06,5,2.75,2410,19447,2290,120
5494000040,20141201T000000,1.44E+06,4,2.75,2660,9547,1930,730
7224500375,20140715T000000,305000,3,1,1030,5350,1030,0
1025049254,20141204T000000,458000,3,4,1390,1569,1150,240
2407000110,20150414T000000,275000,3,1.75,1580,8775,1220,360
7203600745,20141014T000000,550000,3,2.75,2330,4780,1730,600
7234601198,20140604T000000,742000,3,3.25,1540,704,1540,0
1931300110,20140725T000000,700000,3,1,1570,4000,1570,0
8624700015,20141112T000000,640000,4,3,2940,5763,1640,1300
6149700315,20150410T000000,352000,3,0.75,1240,7200,1240,0
2064800880,20150201T000000,301500,3,1,1410,7419,1050,360
3902300450,20140702T000000,630000,4,2.5,2190,9880,1410,780
1332300110,20150223T000000,340000,3,2.5,3040,6255,3040,0
7663700610,20150310T000000,477500,4,1.75,1860,9364,1080,780
7520000330,20140813T000000,285000,3,2.5,1690,7460,870,820
1521049156,20141010T000000,255000,3,2.75,1900,16117,1900,0
6648760150,20140728T000000,315000,3,2.5,1600,7982,1600,0
1807900300,20141217T000000,830000,6,3,2530,9000,2530,0
4310700778,20150210T000000,539950,3,2.25,1860,1558,1860,0
5364200620,20140814T000000,980000,3,2.25,2390,4590,2090,300
1939130120,20140718T000000,735000,4,2.5,3100,8529,3100,0
7280300375,20150122T000000,536000,5,2.25,2650,9140,1350,1300
2767602720,20150223T000000,575000,3,2,1520,5000,1140,380
3300701185,20140925T000000,500000,2,1,1510,4000,930,580
8731901910,20140616T000000,285500,4,1.75,1960,7950,1960,0
2558640110,20140514T000000,498000,4,2.75,2270,7375,1290,980
9465200405,20140821T000000,412000,2,1,910,6282,910,0
2896000450,20150323T000000,607000,4,2.5,2100,8220,1300,800
1320069255,20140624T000000,199000,3,1,1000,8512,1000,0
8651720150,20140721T000000,492500,4,2.75,2760,18306,1630,1130
3840700757,20140619T000000,585000,4,2.5,2840,11044,2840,0
8856970530,20141208T000000,326995,3,2.5,1860,5321,1860,0
2473351050,20140813T000000,372500,4,2.25,1920,9660,1920,0
7003200120,20140627T000000,528000,2,0.75,840,40642,840,0
1321059097,20140924T000000,400000,3,1.5,2390,32109,2390,0
2571910100,20141029T000000,344000,4,2.5,2100,8501,2100,0
5104511050,20140902T000000,409950,4,3,2430,7163,2430,0
2771603990,20140715T000000,625000,3,2,1880,4000,1280,600
9407001770,20150512T000000,304950,3,1.75,1350,9000,1350,0
3211230300,20140929T000000,381500,2,2,2160,35183,2160,0
3229200040,20140723T000000,215000,3,1.75,1430,13399,900,530
3810000843,20150427T000000,345000,5,1.75,2840,12870,2840,0
4045700455,20150316T000000,363000,3,0.75,2510,20000,2510,0
3322049095,20150205T000000,240000,3,1,1690,20063,1690,0
8682280970,20150204T000000,548050,2,2,1930,5479,1930,0
9269200650,20141027T000000,314000,2,1,720,4920,720,0
7701961220,20140626T000000,800000,4,2.5,2990,16809,2990,0
7883603945,20140715T000000,400000,5,1.75,2300,6720,2300,0
1352300580,20141114T000000,247000,1,1,460,4120,460,0
8714600145,20150401T000000,540000,2,1.75,1240,4120,890,350
323089172,20140718T000000,410000,4,2.5,1900,15123,1900,0
8651511030,20141002T000000,525000,3,1.75,2120,9146,1260,860
7015200900,20150410T000000,820000,4,2.5,2440,5737,1700,740
736100065,20150310T000000,1.25E+06,4,2.25,3300,15375,2820,480
3123049131,20141218T000000,244000,2,1,1180,10200,1180,0
1773101530,20141218T000000,275000,1,1,520,4800,520,0
6917700650,20141008T000000,577000,2,1.75,2070,23160,1260,810
3574800090,20141202T000000,446950,5,2.5,2250,7945,1360,890
7853220610,20140729T000000,457000,3,2.5,2050,5694,2050,0
9537200037,20150428T000000,320000,4,1.5,1310,137214,1310,0
5470100090,20140905T000000,210000,3,1.5,1250,9484,1250,0
3826500730,20140922T000000,220000,4,2.5,2130,9100,1290,840
2998800040,20140613T000000,589000,3,2,2250,8800,1250,1000
7658600150,20140630T000000,435000,4,2,1880,3840,970,910
3816300065,20140716T000000,375000,3,1,1520,10798,1520,0
1561600056,20141017T000000,1.74E+06,4,3.5,4010,9654,4010,0
8682261250,20141211T000000,545000,2,1.75,1660,5581,1660,0
6392002550,20141022T000000,970000,3,2.25,3400,10000,3400,0
1370803835,20140718T000000,705000,2,1.75,2320,6755,1380,940
7805450040,20150316T000000,915557,5,3.25,3740,11536,2540,1200
8019200823,20150209T000000,259000,4,1.5,1810,9000,1810,0
5457800930,20140613T000000,1.70E+06,2,2.25,3170,3000,1990,1180
3715500110,20141201T000000,427000,3,1.75,1680,8610,1290,390
6058600385,20140811T000000,390000,2,1,930,3100,930,0
7708250040,20150212T000000,363000,3,2.5,2390,8000,2390,0
2769600035,20140807T000000,612000,4,2.5,2680,3626,1680,1000
5500100120,20140916T000000,380000,4,1.75,1790,10186,1790,0
4472000040,20140818T000000,230000,4,3,1680,6003,1150,530
9376301591,20150414T000000,580000,3,1.75,1570,2600,1570,0
4232903990,20141119T000000,770000,3,1,2230,3200,1630,600
7575500150,20140924T000000,207200,4,2,1260,8400,1260,0
6817801430,20150305T000000,525000,3,2,1790,11430,1190,600
2883200760,20150209T000000,925000,3,2.5,2440,7419,1520,920
1797500985,20140902T000000,883000,4,2.25,2410,4000,1650,760
2896400210,20150508T000000,455000,4,2.5,1780,2992,1780,0
8691510150,20140922T000000,343500,3,2.5,1900,5194,1900,0
6163901380,20141114T000000,244000,2,1,960,8450,960,0
9477000650,20141119T000000,397000,3,1.75,1640,11730,1640,0
2560800165,20150316T000000,180500,2,1,850,5000,850,0
5589300495,20150304T000000,310000,3,2.75,2150,6576,1900,250
2517000600,20150128T000000,315000,4,2.5,2780,3969,2780,0
5364200477,20140603T000000,718000,3,1,1030,4958,1030,0
7349400100,20141009T000000,279950,3,1.75,1930,7267,1330,600
1455600062,20141021T000000,689000,3,2.5,2080,9612,1700,380
629810720,20140818T000000,828000,4,2.5,3520,9901,3520,0
3395800455,20140625T000000,150000,2,1,890,8100,890,0
9191201385,20150301T000000,505400,3,1.75,1640,3400,930,710
6648150040,20140513T000000,1.68E+06,5,3.25,4860,23723,3820,1040
7211400615,20140515T000000,217450,3,1,1040,5000,1040,0
6870000150,20141218T000000,677000,4,2.5,2820,4174,2820,0
3324079092,20150427T000000,361000,2,2.5,1320,48787,1320,0
8901000543,20140609T000000,620000,3,2.5,2590,7237,2590,0
7428000120,20141210T000000,176000,3,2.25,1540,5449,1180,360
6675500112,20150414T000000,330000,3,1,960,7218,960,0
8898701340,20141029T000000,290000,3,2.5,1190,8175,1190,0
3904921120,20140715T000000,711000,4,2.5,2770,9532,2770,0
1545806960,20150422T000000,295000,3,1.75,1060,8100,1060,0
3303990410,20141111T000000,1.10E+06,5,3.25,4010,12110,4010,0
1862900690,20140925T000000,257500,3,2,1140,7078,1140,0
123039333,20140609T000000,240000,4,1,1910,16320,1910,0
8077210230,20141212T000000,645000,4,2.5,2340,8955,2340,0
9550200650,20140506T000000,499000,2,1.75,1170,2400,740,430
4326000220,20141020T000000,321000,3,1,1290,9526,1290,0
1862400522,20140822T000000,449000,3,2.5,1810,1658,1810,0
7589200165,20150107T000000,515000,3,2.5,1820,5280,910,910
925059042,20141002T000000,456000,4,1.5,2220,12385,1270,950
2924079044,20140723T000000,865000,3,3.75,3830,219106,3830,0
5535600110,20140618T000000,515500,4,2.5,2920,7700,2920,0
1428900033,20141119T000000,576925,4,2.5,2630,6100,2630,0
1822059382,20150102T000000,243000,3,1.75,1320,10416,1320,0
3584000180,20140528T000000,253400,3,2,1400,8640,1400,0
7812500180,20150413T000000,292000,3,2.5,1600,3580,1600,0
984210220,20141203T000000,271500,3,2.5,1490,8005,1090,400
8682310220,20140827T000000,765000,2,2.5,2170,6750,2170,0
7586200061,20150312T000000,375000,3,3.25,1280,1730,1090,190
5127100100,20150511T000000,382880,3,2,1620,9566,1620,0
7856000150,20140609T000000,852500,3,2.5,2630,10100,1580,1050
5076700025,20141124T000000,475000,3,1.5,1240,8738,1240,0
9221400600,20140523T000000,462000,3,1.75,1300,2580,820,480
1924059278,20140611T000000,762400,3,1.75,2430,14607,1230,1200
6163901283,20150130T000000,330000,4,1.5,1890,7540,1890,0
7504460090,20140725T000000,473000,3,2.25,1890,12236,1890,0
4154302560,20141121T000000,550000,3,1.5,2440,7200,2440,0
7905390220,20140623T000000,449500,3,2.25,1780,7280,1340,440
8691330910,20140521T000000,744000,4,2.75,2830,13059,2830,0
9169100175,20150507T000000,700000,4,2,2490,4700,1690,800
5706202070,20140930T000000,511100,4,2.5,1560,12220,1560,0
9478501020,20140916T000000,317950,3,2.5,1980,4500,1980,0
426069095,20141014T000000,542950,3,2.5,2070,39768,2070,0
6752000330,20140815T000000,490000,3,1.75,1490,11360,1490,0
9834200555,20150219T000000,760000,4,3.5,3090,4060,2420,670
726059344,20150421T000000,475000,3,2.25,1580,8659,1220,360
8106100085,20140509T000000,1.70E+06,5,4.5,5190,23716,3390,1800
3831250150,20150326T000000,435000,3,2.75,2692,6197,2692,0
7852020760,20141101T000000,399000,3,2.5,1740,3690,1740,0
3142600120,20140826T000000,627000,3,2,1940,3800,1050,890
7831800495,20141002T000000,346500,4,2.5,2150,5100,1290,860
4037000065,20150414T000000,412000,3,1.5,1320,8000,1320,0
7574910450,20150203T000000,845000,4,2.5,3360,40471,3360,0
6703700025,20141105T000000,373000,3,1.75,1850,9655,1100,750
5418500970,20140808T000000,725000,4,2.25,2880,8882,2480,400
5379806180,20140813T000000,376000,6,2.5,2420,11662,1420,1000
3332000061,20140805T000000,552500,3,1,2020,4120,1520,500
7635800600,20140626T000000,365000,5,2,2280,19000,2280,0
1825079086,20140521T000000,700000,4,2.5,3010,46173,3010,0
4399200085,20150305T000000,315000,4,2.25,2550,9736,2550,0
7131300031,20150331T000000,262500,4,2,1540,5110,1540,0
2719100355,20141104T000000,660000,3,2.25,2280,6150,2280,0
2517010120,20150413T000000,340000,4,2.5,2450,6941,2450,0
5700000600,20140702T000000,660500,5,2.5,2950,5500,1720,1230
5075400035,20140627T000000,280000,1,1,690,1950,690,0
5141000571,20140825T000000,267000,1,1,800,2480,800,0
3664500300,20141106T000000,230000,2,1,1470,25661,1470,0
2607730490,20140922T000000,417000,3,2.25,1840,11403,1840,0
88000790,20140714T000000,252000,3,1,1170,9730,1170,0
4083303540,20150320T000000,791000,5,1.75,2344,4800,1544,800
6430500219,20140910T000000,415000,1,1,1230,3774,830,400
203900610,20140724T000000,339000,3,1.75,1150,13278,1150,0
6083000123,20150504T000000,158000,3,1,1140,10477,1140,0
2490200620,20140811T000000,535000,3,1,1660,5100,1260,400
9528102870,20150304T000000,818900,3,1,1080,4120,980,100
2436700610,20150422T000000,550000,4,2,1720,4000,1420,300
7655900031,20150306T000000,240000,2,1,590,8717,590,0
7011201333,20140917T000000,590000,3,3.25,1290,1230,1090,200
9412200730,20150224T000000,369300,3,1.5,1480,21320,1480,0
3024079096,20150414T000000,510000,4,2.5,2600,118666,1400,1200
5423600040,20140707T000000,542500,3,2.5,2040,10086,2040,0
3291800120,20150102T000000,262500,3,1,970,7854,970,0
3052700921,20150211T000000,900000,6,3,2620,4350,1760,860
2424059119,20141014T000000,1.10E+06,4,3.5,4560,41636,4170,390
4335000145,20140813T000000,368000,3,1.75,1750,14400,1750,0
1980200384,20141022T000000,825000,4,3.5,3620,6499,3620,0
5637200150,20150114T000000,343500,3,2,1660,7509,1660,0
8864000970,20141204T000000,273500,4,1,1360,6000,1020,340
3885808210,20150120T000000,1.00E+06,3,2.5,2044,5610,2044,0
7986400265,20141029T000000,770000,5,3,2370,6000,1340,1030
9459200120,20150304T000000,400000,3,2,1170,3868,1170,0
1311200120,20140513T000000,225000,3,1,1660,7210,1100,560
3649100031,20150305T000000,345000,4,1,2020,18150,2020,0
2475400120,20141001T000000,450000,3,2.5,2530,8116,2530,0
6365900065,20140718T000000,334850,2,1,870,5635,870,0
3959400645,20150107T000000,605000,5,3,3670,9600,1980,1690
4139660040,20141121T000000,760000,5,3.5,3180,14000,3180,0
3241600027,20141006T000000,390000,2,1.5,1870,12960,1350,520
8946400100,20140804T000000,488000,3,2.5,1940,5660,1940,0
3625059152,20141230T000000,3.30E+06,3,3.25,4220,41300,2460,1760
624110110,20150222T000000,1.06E+06,5,4.5,4820,13165,3950,870
522079015,20150322T000000,608000,3,2,2400,217800,1590,810
3204300455,20140822T000000,1.39E+06,3,2.25,2930,6000,1920,1010
5414100040,20140915T000000,299950,2,1,800,3000,800,0
1930301015,20150428T000000,818000,3,3.25,2200,4800,1910,290
1898200100,20140528T000000,355000,3,2.5,2400,9701,2400,0
9471200065,20141015T000000,1.86E+06,5,3.25,5570,9600,3860,1710
510003085,20140623T000000,660000,3,3.25,1980,2850,1980,0
2579500110,20140701T000000,2.37E+06,3,2.25,3530,17450,1840,1690
1762600090,20150424T000000,1.21E+06,4,2.5,3430,35120,3430,0
6700390090,20140625T000000,255950,3,2.5,1720,3676,1720,0
6817801020,20140821T000000,475000,3,1.5,1930,11092,1500,430
7931000053,20141229T000000,362950,4,1.75,2140,159865,1140,1000
1828000620,20140701T000000,452000,3,1.75,1110,9012,1110,0
2423400040,20140804T000000,315000,3,1.75,1970,8200,1270,700
6064800730,20150129T000000,330950,3,2.5,1630,2844,1630,0
3388300590,20140611T000000,535000,5,2.25,2520,49222,2520,0
1591600506,20150225T000000,479000,4,2.25,2270,9464,1520,750
6798100661,20140616T000000,340000,3,2.5,1212,1174,1212,0
8732800100,20140916T000000,312000,4,2,1890,8362,1890,0
2025701080,20150318T000000,305000,3,2.25,1370,6600,1370,0
4345000490,20141202T000000,270000,3,2.5,1770,7336,1770,0
2771104010,20140605T000000,529999,3,2.5,1710,1664,1300,410
3307700405,20140723T000000,587100,2,1,1190,6967,1190,0
6817800910,20141118T000000,459800,3,2,1690,16061,1690,0
259801140,20141212T000000,451000,4,1.75,1680,7800,1330,350
1176001293,20140617T000000,2.48E+06,3,3.25,4340,4947,3060,1280
820079101,20141222T000000,525000,3,2.25,2040,435600,2040,0
40001065,20140529T000000,250000,2,1,1110,26051,1110,0
3330501975,20141117T000000,475000,5,2,2040,6180,2040,0
3021059175,20150312T000000,235000,4,1.5,1920,11595,1920,0
8092500720,20140711T000000,230000,3,1.5,1330,9548,1330,0
9828702120,20140701T000000,581000,4,1,1630,2566,1630,0
6751300375,20140702T000000,415000,3,1,1520,9030,1520,0
6751300375,20141016T000000,522500,3,1,1520,9030,1520,0
6073300790,20150105T000000,383000,3,1.5,1340,7725,1340,0
8074400035,20141030T000000,315000,3,1.75,2500,8289,1250,1250
2254501335,20140922T000000,591000,3,2,1460,3600,1460,0
7504021510,20141219T000000,750000,4,2.25,3140,12150,3140,0
7625701386,20140516T000000,430000,3,1.75,2150,4333,1200,950
1775500371,20150501T000000,712000,4,2.5,3140,32336,3140,0
3244500037,20150406T000000,510000,3,2.5,2310,53578,1340,970
9828701745,20150123T000000,480000,2,1,710,4800,710,0
1994200040,20140613T000000,538000,3,1,1460,7200,1260,200
8122100265,20141205T000000,464000,2,2.75,730,5000,730,0
7202290180,20150102T000000,476000,3,2.5,1440,3840,1440,0
4025300360,20150326T000000,349500,3,2,1130,16875,1130,0
2557000540,20150207T000000,270000,3,2.25,1810,8262,1810,0
9388100015,20141119T000000,740000,3,2.5,2710,18480,2000,710
6305900300,20141013T000000,395000,4,2.5,2740,8336,2740,0
7202340530,20150410T000000,498000,3,2.5,1690,4088,1690,0
7849202296,20150130T000000,339900,3,2.5,1470,4675,1470,0
255520150,20140902T000000,539000,3,2.5,2830,9972,2830,0
3578401770,20150226T000000,400000,3,1,1410,9704,1140,270
984000410,20150218T000000,225000,3,2.5,2170,11745,1410,760
9834200925,20140910T000000,330000,3,2.25,1340,4080,1170,170
2225039103,20140626T000000,1.39E+06,3,3,2480,5500,1730,750
6445800015,20150430T000000,490000,3,2.75,1990,31200,1990,0
1311800040,20141220T000000,260000,4,2.75,2240,7200,1140,1100
1473120730,20140627T000000,469900,4,2.5,2990,8913,2990,0
6820100035,20141112T000000,493000,6,1.75,2120,3801,1220,900
1824079107,20140528T000000,740000,4,2.25,2920,46355,2920,0
2891000610,20141211T000000,148900,4,1.75,1700,6000,1700,0
6600220090,20141118T000000,475000,2,2.5,1620,14467,1620,0
4447300165,20141223T000000,415000,2,1,760,4000,760,0
2891000450,20140707T000000,229500,3,1,1230,6000,1230,0
9286000110,20140814T000000,1.36E+06,5,3.75,4960,13990,3760,1200
2558160220,20141210T000000,385000,4,2.5,2030,11375,1330,700
2422000067,20150427T000000,230000,3,2.25,1830,11331,1250,580
2887701970,20140808T000000,425000,2,1,970,2700,770,200
8581400015,20140722T000000,189900,2,1,1000,4179,1000,0
7972603950,20150102T000000,238000,2,1,750,6480,750,0
7882600332,20140819T000000,968060,4,2.5,2620,16200,1570,1050
5078400210,20140616T000000,921000,4,1.5,2220,9496,1490,730
1180008355,20140507T000000,380000,5,1.75,3000,6000,1500,1500
2781600195,20141117T000000,285000,1,1,1060,54846,1060,0
3342100995,20141022T000000,449000,4,2.5,1980,5400,1980,0
2818600115,20140709T000000,625000,4,1,1600,5500,1600,0
8732020720,20140521T000000,318989,4,2.25,2000,9000,2000,0
1563100557,20141010T000000,445000,3,1.5,1310,1266,1120,190
9533100145,20150205T000000,750000,3,1,1120,8549,1120,0
3761700067,20150306T000000,959000,3,2.5,3320,11875,3320,0
8029500360,20141202T000000,330000,3,2.5,2370,9102,2370,0
7011201106,20150216T000000,425000,2,1.5,830,1241,830,0
3235100110,20141202T000000,280000,3,1,940,7913,940,0
2623089141,20141023T000000,476500,4,2.5,2250,50155,2250,0
1241500147,20140521T000000,556000,3,2.25,2020,3600,2020,0
1524079188,20140729T000000,1.86E+06,4,5.25,5240,320917,5240,0
9262800208,20140919T000000,637000,4,3.5,4083,68377,4083,0
1062100115,20141204T000000,405000,3,2,1450,6081,1450,0
6381500265,20140627T000000,397000,5,1,1170,6757,800,370
7203220300,20140724T000000,895990,4,2.75,3555,6565,3555,0
4027701220,20140828T000000,259000,3,2,1610,14046,1610,0
114100758,20141022T000000,420000,2,1,960,112384,960,0
9376301110,20140519T000000,518000,3,2.5,1680,2096,1380,300
9371700085,20140722T000000,425000,3,1.75,1380,8182,1380,0
2122049096,20140808T000000,182500,2,1,1040,13920,1040,0
546000245,20140716T000000,549900,3,1.5,1380,3031,1380,0
2783600210,20140916T000000,445000,3,1.75,1850,16863,1280,570
5210200184,20140606T000000,452000,2,1.75,1740,5400,990,750
2125049133,20141104T000000,715000,5,1.75,1920,6500,1260,660
7940710100,20140911T000000,559000,3,2.5,2010,5200,2010,0
6072800246,20140702T000000,3.30E+06,5,6.25,8020,21738,8020,0
5466700450,20141015T000000,250000,4,1.75,1860,7350,1090,770
1425039029,20140923T000000,1.23E+06,5,4,4390,6656,2930,1460
422069067,20150512T000000,276500,4,2.25,2380,128937,2380,0
2472920740,20141114T000000,440000,4,2.5,2880,7386,2880,0
2338800100,20140508T000000,543200,6,2.25,2820,15600,1970,850
3524039060,20140601T000000,250000,1,1,750,4000,750,0
7539900040,20140728T000000,625000,4,2.5,1750,9000,1410,340
1646502055,20140613T000000,530100,3,1,1540,3399,1200,340
1025049268,20140721T000000,549900,2,1.75,1140,936,940,200
324059076,20150311T000000,430000,4,1.5,1560,6534,1560,0
1853080730,20141210T000000,835000,3,2.5,2960,6856,2960,0
6708200040,20140507T000000,409500,4,2.75,2140,13000,1320,820
3438501452,20140520T000000,329000,4,2.5,1600,6765,830,770
9287802380,20140522T000000,940000,4,2.75,2080,4000,2080,0
2652501513,20140813T000000,539950,3,2,1560,3200,1560,0
2421059125,20150414T000000,579950,4,2.5,2880,213444,2140,740
1250202990,20140611T000000,881000,5,3,2510,4125,1590,920
6914700165,20140804T000000,362500,3,1,960,5424,960,0
920069052,20150421T000000,243950,2,1,1120,35500,1120,0
7853310590,20140529T000000,658000,4,2.75,3310,6166,3310,0
1898600100,20141124T000000,218250,3,1.5,1080,9774,1080,0
5611500100,20140522T000000,655000,4,2.5,2860,12394,2860,0
1796370590,20150305T000000,255000,3,2,1490,7599,1490,0
7831800110,20150115T000000,215000,3,1,1210,7175,1210,0
4218400175,20150223T000000,1.27E+06,3,1.75,2240,5657,1910,330
5317100750,20140711T000000,2.92E+06,4,4.75,4575,24085,3905,670
3365900175,20150402T000000,424305,3,2.5,1600,5960,1600,0
7649900175,20140520T000000,494000,4,1.75,2090,4300,1250,840
8159600360,20140605T000000,560000,4,2.5,2260,3713,2260,0
9272202260,20140924T000000,130000,3,1,1200,7000,1200,0
2820069048,20150504T000000,468000,4,2.5,2480,176418,2480,0
6744700343,20141209T000000,480000,5,3,2240,15435,1390,850
925049318,20140811T000000,475000,3,1.75,1550,4054,1550,0
6648700150,20150225T000000,285000,4,1.75,2130,8151,1330,800
510001400,20140630T000000,765000,5,3,2870,5700,1950,920
7606200090,20150327T000000,208000,2,1,1160,5750,1160,0
8562890590,20141003T000000,372000,3,2.5,2430,5000,2430,0
441000115,20141209T000000,470000,2,1,900,5512,900,0
3876200330,20140626T000000,451000,5,2.75,2830,8925,2830,0
1508210100,20140827T000000,442200,4,1.75,1620,8132,1620,0
2944500330,20140825T000000,330000,4,2.5,2510,8580,2510,0
4302200625,20140924T000000,335000,3,1.75,1790,5120,940,850
2722049246,20141114T000000,280000,3,2,1640,13249,1640,0
142000175,20140822T000000,625000,3,1.75,2240,6050,1250,990
9558041130,20140903T000000,345000,3,2.5,1870,3584,1870,0
5112800210,20141024T000000,255950,4,1,1500,11050,1500,0
2461900850,20150105T000000,570000,4,1,1490,6000,1490,0
647100096,20150331T000000,685000,3,1.5,2230,8558,2230,0
2787311110,20140902T000000,273148,3,1.75,1710,7210,1240,470
1545801500,20140625T000000,246500,3,2.5,1620,7686,1620,0
3811300110,20150406T000000,349950,5,2.5,2250,7176,1310,940
7519001321,20150210T000000,545000,4,2,1700,2350,850,850
8641500252,20150227T000000,403000,3,2.5,1502,1400,1502,0
8562891240,20150211T000000,299950,4,2.5,1900,4054,1900,0
8644210110,20150501T000000,792000,3,2.5,3320,12840,2600,720
8024202380,20141002T000000,418000,5,2.5,1980,10205,1080,900
5006000035,20150427T000000,332500,4,1,1670,8102,1670,0
421069081,20150127T000000,337000,3,2.5,2235,43560,990,1245
5053300015,20150121T000000,212000,2,1,1070,7386,1070,0
8857320120,20150310T000000,542000,2,2.25,1800,2819,1800,0
7852110690,20140522T000000,622500,4,2.5,2980,8107,2980,0
6084600330,20140829T000000,260000,3,1.75,1670,8511,1340,330
5561000330,20150505T000000,525000,3,1.75,2620,38350,1320,1300
2225059273,20141114T000000,975000,5,3.5,5470,35071,4590,880
1370803445,20140909T000000,1.14E+06,4,1.75,3080,6500,1700,1380
1236300268,20150303T000000,500000,3,1,940,10360,940,0
7752700110,20140618T000000,554000,5,2.25,1870,11411,1170,700
2781250230,20140605T000000,343000,4,2.5,2070,4500,2070,0
4027701055,20150424T000000,515000,2,1.75,950,15219,950,0
2755200040,20140712T000000,492000,2,1,1290,6272,890,400
2193320450,20150213T000000,655000,4,3,2570,8022,1370,1200
2895550330,20150506T000000,290000,3,2.5,1600,6848,1600,0
8712100790,20140701T000000,952500,4,1.5,2550,5055,2550,0
7883603700,20140822T000000,235000,2,1,1010,7500,1010,0
3438502731,20150401T000000,323000,3,1.5,1720,7110,1720,0
2025049161,20140506T000000,1.05E+06,3,2.5,2200,1970,1610,590
1222029077,20141029T000000,265000,0,0.75,384,213444,384,0
5706500385,20150129T000000,200000,2,1,1400,9600,1400,0
4024101254,20141204T000000,419995,3,2.25,1830,7500,1330,500
7923250090,20150310T000000,1.50E+06,3,3,3110,9015,1590,1520
6675500082,20140812T000000,455000,3,2.5,1600,7829,1600,0
4046710180,20150325T000000,660000,3,3.5,3600,37982,3600,0
1771000760,20140513T000000,319000,3,1,1390,12823,1390,0
3421069044,20141223T000000,390000,3,1.75,2092,250905,2092,0
6600000330,20140627T000000,718500,3,1.5,1200,6240,1030,170
2041000025,20141203T000000,474000,2,1,1090,3160,840,250
2215500230,20140825T000000,615750,4,2,2140,6360,1840,300
6639900176,20141114T000000,551000,3,2.5,2010,17362,2010,0
104510180,20150211T000000,230000,3,2.25,1500,7210,1150,350
7202360760,20140711T000000,790000,4,2.5,3500,9198,3500,0
3879901285,20150326T000000,1.23E+06,3,2.5,2660,1967,1870,790
1559900110,20141223T000000,325000,3,2.25,1440,6443,1440,0
7202260040,20140801T000000,705000,4,2.75,2780,6207,2780,0
7334600730,20141211T000000,259000,4,1.75,1580,8856,1580,0
1723049419,20141204T000000,306000,3,1.5,1250,8700,1250,0
3438501081,20141215T000000,315000,3,1,970,6828,970,0
2916200054,20150413T000000,392500,3,1,1100,7650,1100,0
3024059149,20141112T000000,1.07E+06,4,2.25,3240,12930,2730,510
1862400528,20140716T000000,350500,2,2.5,1290,1445,1290,0
6329000385,20140618T000000,825000,4,3.5,3810,9792,3810,0
7812800215,20140808T000000,235000,4,1,1500,6360,1500,0
2324079057,20150302T000000,650000,3,2,2660,257875,1530,1130
1982201485,20140512T000000,675000,4,3,2400,3340,1200,1200
740500040,20141001T000000,265000,4,1,1860,8505,1860,0
3025049052,20140812T000000,822500,2,1,1450,7098,1450,0
5244801255,20150428T000000,705000,3,2.75,2260,4000,1540,720
2397101606,20141208T000000,2.63E+06,6,4.75,5540,7200,3950,1590
7234601445,20140623T000000,685000,2,1.5,1300,1676,1300,0
3693901105,20141020T000000,630000,4,2,1610,5000,1610,0
3124059006,20140508T000000,1.25E+06,4,3.25,3820,24166,3310,510
2523039310,20150112T000000,359000,4,2.5,1820,11325,1390,430
5469650040,20150316T000000,784500,4,5,5820,13906,3750,2070
5021900945,20140703T000000,850000,3,2,2470,8800,2470,0
1152700220,20140903T000000,410000,3,2.5,3040,6054,3040,0
1423900220,20140709T000000,252000,4,1.75,1120,8250,1120,0
3425059066,20140812T000000,618000,5,1.75,1880,18295,1880,0
5347200165,20141002T000000,265000,3,1,1070,4800,970,100
5145100300,20140918T000000,465000,3,2,1560,8509,790,770
6141100395,20150204T000000,240000,2,1,870,6552,870,0
5153200506,20140731T000000,217000,3,1,1000,12000,1000,0
9122000385,20140806T000000,415000,4,2.25,2520,4200,1510,1010
3279000120,20141222T000000,274000,2,2,1700,7992,950,750
3438503223,20150223T000000,420000,5,3,2150,6117,1370,780
6788201240,20150318T000000,1.06E+06,4,2.75,1590,6000,1590,0
4139900120,20140605T000000,1.42E+06,4,5.25,4670,43950,4670,0
1868900775,20140505T000000,618500,3,2,1800,5000,1080,720
764000180,20150109T000000,295000,3,1.5,1670,10800,1670,0
3578400910,20150316T000000,400000,3,2,1010,12252,1010,0
5631500191,20150326T000000,595000,3,2.5,2550,6677,2550,0
6448000100,20140617T000000,1.73E+06,4,3,3700,20570,1850,1850
1545801340,20141231T000000,261000,3,1.75,1350,7686,1350,0
5244800915,20141016T000000,780000,5,2.5,1660,4000,1660,0
4217400590,20141118T000000,589000,3,1.5,1390,5040,1090,300
1683600110,20150305T000000,230000,3,1.75,1720,9125,1140,580
3630090110,20141018T000000,690000,4,3.5,2980,2147,2490,490
1785400210,20150129T000000,524000,4,2.25,2190,15491,2190,0
3319500317,20140522T000000,380000,2,2.5,1230,987,1060,170
2492200256,20141112T000000,357500,3,1,1000,4080,740,260
3797300110,20141027T000000,330000,3,2,2500,10697,2500,0
1870400615,20150309T000000,635000,5,1.75,2240,4750,1120,1120
8823901445,20150313T000000,934000,9,3,2820,4480,1880,940
3630000150,20150128T000000,358500,2,1.75,1400,865,1110,290
5727500301,20141006T000000,401000,3,1.5,1470,6867,1470,0
4167960330,20150109T000000,270000,3,2,1820,7750,1820,0
2484700155,20141014T000000,705000,4,2,2060,6000,1370,690
4046700300,20141030T000000,325000,3,2,1670,17071,1100,570
4365200865,20140902T000000,384950,3,1,1540,7740,1540,0
6713700205,20140715T000000,310000,3,1,1210,9730,1210,0
293800900,20141006T000000,829950,4,2.5,3430,42775,3430,0
3375800220,20150330T000000,353000,3,2.5,2550,6021,2550,0
8898700820,20140707T000000,170500,2,1,1060,7700,820,240
2725069156,20140716T000000,885250,4,2.5,3670,49658,3670,0
8043700300,20140608T000000,2.70E+06,4,3.25,4420,7850,3150,1270
2372800100,20140925T000000,245000,3,1.5,1550,9126,1550,0
7518501822,20141017T000000,469000,3,2.5,1190,1290,1190,0
1928300620,20140608T000000,455000,3,1,1300,3550,1300,0
1402950100,20141121T000000,305000,4,2.5,2430,5959,2430,0
2616800600,20140530T000000,840000,7,4.5,4290,37607,4290,0
2597530760,20140623T000000,905000,5,3.5,3500,10155,2570,930
7345200650,20141231T000000,219200,3,2,1680,7000,1680,0
259800750,20150223T000000,455000,3,1.5,1250,8004,1250,0
723049197,20140627T000000,195000,2,1,1020,8100,1020,0
2883200775,20141113T000000,799000,3,1,1510,4178,1510,0
3995700245,20140627T000000,285000,2,1,910,8155,910,0
1775900220,20140922T000000,300000,3,1.5,1320,15053,1320,0
7999600180,20140529T000000,83000,2,1,900,8580,900,0
6145601745,20150414T000000,220000,2,1,890,4804,890,0
818500100,20140603T000000,174500,2,2.5,1240,2689,1240,0
3904920730,20150427T000000,695000,4,2.5,2960,10760,2960,0
3211000040,20141204T000000,255000,3,1.5,1020,11410,1020,0
9557300040,20150225T000000,539000,5,2.25,2590,7245,1510,1080
7011201482,20150317T000000,552700,2,1,1100,2800,1100,0
5315100667,20140603T000000,571500,3,1,1300,6710,1300,0
8598900157,20150313T000000,263700,3,1,1200,6561,1200,0
1346300150,20141020T000000,3.30E+06,8,4,7710,11750,6090,1620
9268710220,20140528T000000,186950,2,2,1390,1302,1390,0
2224079086,20141110T000000,520000,3,1.75,1430,53628,1430,0
1761600150,20140730T000000,358000,3,1.5,1250,7194,1250,0
2123049086,20140807T000000,210000,2,0.75,840,49658,840,0
4389201095,20150511T000000,3.65E+06,5,3.75,5020,8694,3970,1050
2802200100,20140811T000000,543000,4,2.25,2060,8767,2060,0
6706000040,20150423T000000,330000,4,2.25,2000,10679,1350,650
9828701690,20140806T000000,529000,3,2,1530,3400,990,540
7891600165,20140627T000000,295000,1,1,700,2500,700,0
1238500978,20140922T000000,365000,3,1,950,8450,950,0
8673400141,20141015T000000,473000,3,3,1380,1081,1380,0
9421500150,20140623T000000,403500,3,1,1830,8004,1200,630
148000035,20140602T000000,544000,3,1.5,1790,8203,1790,0
2436700395,20141023T000000,621000,3,1,1340,4000,1340,0
8010100040,20140801T000000,672600,3,2.25,1520,5750,1400,120
1193000220,20150407T000000,689800,2,1.75,1370,3125,1090,280
8827901415,20150507T000000,613000,3,1.5,1470,4480,1130,340
7732410220,20140701T000000,808000,4,2.25,2500,8866,2500,0
415100015,20140725T000000,301000,3,1,1060,9241,1060,0
2130400150,20140925T000000,340000,3,1.75,1210,9635,1210,0
1555200590,20141223T000000,206000,3,1,920,8400,920,0
2174503500,20141103T000000,550000,3,1.5,1340,6000,1340,0
6371500120,20141224T000000,325000,2,1,960,4800,960,0
3904900610,20141012T000000,475000,3,2.5,1630,7586,1630,0
9527000490,20140730T000000,432100,3,1.75,1840,7350,1310,530
2457200120,20150303T000000,359000,3,2,3085,7280,1560,1525
3501600100,20150105T000000,490000,3,1,920,4800,780,140
1245001295,20140522T000000,648360,4,1.75,2260,7005,1130,1130
9536601295,20141007T000000,340000,3,1.75,1730,11986,1730,0
2205700180,20150403T000000,545000,3,2,1610,8069,1090,520
623049232,20140715T000000,115000,2,0.75,550,7980,550,0
9413600100,20150219T000000,705640,3,2.25,2400,12350,1420,980
6064800410,20140730T000000,300000,3,2.25,1960,1585,1750,210
8964800975,20140731T000000,1.65E+06,4,2.75,3190,14904,1940,1250
4473400155,20150417T000000,1.14E+06,4,3.5,3160,4200,2180,980
7657000210,20140818T000000,280000,3,1.75,1550,7410,1550,0
8732040180,20141219T000000,245000,4,1.75,1930,7650,1280,650
9547202950,20141030T000000,564000,4,1,1170,4590,1170,0
1370802770,20140919T000000,849000,3,1.75,2520,4534,1460,1060
3885803465,20150409T000000,698000,3,1.75,1220,7447,1220,0
2896610210,20140925T000000,319000,3,1,960,8556,960,0
3760500455,20150224T000000,1.45E+06,3,3.5,4110,15720,2230,1880
3324069541,20140710T000000,695000,4,3.5,3310,21050,2400,910
3600072,20150330T000000,680000,4,2.75,2220,5310,1170,1050
2722049218,20141027T000000,287500,4,2.25,2250,12000,2250,0
1225039052,20141112T000000,465000,3,3.25,1510,1850,1230,280
8807810090,20140925T000000,335000,3,1,1350,14212,1350,0
9508850120,20140627T000000,602000,4,1.75,2420,37800,1880,540
5126300650,20150225T000000,482000,3,2.5,2950,6545,2950,0
6303400965,20140909T000000,220000,5,1,1260,8382,1260,0
7116500925,20140520T000000,206000,4,2,1700,6025,1700,0
9241900115,20150324T000000,1.10E+06,4,3,3320,5760,2120,1200
7202330410,20150320T000000,491150,3,2.5,1470,3971,1470,0
5151600300,20140812T000000,390000,4,2.75,2500,12848,2120,380
1332200100,20150507T000000,393000,4,2.5,2641,8091,2641,0
1939130730,20140717T000000,635000,4,2,2260,8457,2260,0
472000015,20140516T000000,490000,2,1,1160,5000,1160,0
3667500015,20140925T000000,770000,4,3.5,3680,2242,2670,1010
6430000945,20141204T000000,665000,2,2,1615,4590,1615,0
322059161,20141001T000000,287000,3,1,1250,26862,1250,0
7905200205,20141021T000000,410000,3,1,1230,7020,1090,140
1772600665,20150225T000000,562000,3,2,2510,5200,1470,1040
203101530,20140530T000000,475000,2,2,1540,54450,1540,0
820000018,20141014T000000,387500,3,3.25,1860,2218,1860,0
1560800110,20140617T000000,580000,5,2,2700,10875,1540,1160
2869200110,20140621T000000,930000,3,2.5,3290,6830,3290,0
6151800300,20150213T000000,625000,3,1.75,2700,18893,2110,590
4475000180,20141203T000000,325000,3,2,1570,5600,1570,0
3223059206,20140627T000000,235000,3,1.75,1950,8712,1950,0
5102400025,20140625T000000,450000,2,1,1380,4390,880,500
194000145,20150312T000000,745000,4,2.75,2410,5650,2070,340
5560000540,20140723T000000,223000,4,2,1200,8470,1200,0
3326049077,20140728T000000,630000,4,1.75,1770,12278,1350,420
3126049517,20140508T000000,413450,3,2.5,1540,1614,1470,70
2568200740,20140811T000000,720000,5,2.75,2860,5379,2860,0
2622059138,20150416T000000,339000,3,1.5,1740,21980,1740,0
6738700205,20150505T000000,1.12E+06,4,3.5,2830,4000,1840,990
1778350150,20140811T000000,839000,5,4,4280,11307,2710,1570
6613000930,20140902T000000,2.95E+06,4,3.25,3890,25470,3030,860
324069058,20140530T000000,568000,4,2,2340,50233,1170,1170
4345300180,20150406T000000,269000,3,2,1410,10577,1410,0
7525100590,20150406T000000,382000,2,2,1350,2560,1350,0
955000453,20150413T000000,574000,2,2.25,1100,1114,900,200
7852150720,20140922T000000,405000,3,2.5,2070,4697,2070,0
9545220100,20140728T000000,572000,3,2.5,2360,9938,1690,670
7504000230,20141205T000000,675000,4,2.25,2760,12100,2760,0
7657000540,20140902T000000,165000,4,1,1220,7980,1220,0
7657000540,20150304T000000,260000,4,1,1220,7980,1220,0
7893203770,20150304T000000,196000,3,1,1220,6719,1220,0
8035350120,20150224T000000,515000,3,2.5,3020,12184,3020,0
8820902350,20141203T000000,810000,4,3.5,3470,7396,2520,950
5089700300,20150311T000000,365650,4,2.25,2380,7700,2380,0
7234601541,20140728T000000,651000,3,3,2260,1834,1660,600
7972603931,20141009T000000,240000,2,1,720,6345,720,0
318390180,20141029T000000,299000,3,2,1730,6007,1730,0
2597520900,20140804T000000,768000,3,2.5,2660,10928,1830,830
5652600556,20141028T000000,397380,2,1,1030,5072,1030,0
8935100100,20140701T000000,476000,4,3,2890,6885,1590,1300
4154301371,20150106T000000,315000,3,1,890,5200,890,0
1105000787,20140926T000000,240000,3,2.25,1410,7290,940,470
2492201005,20140708T000000,325000,2,1,810,4080,810,0
9265410090,20141008T000000,160000,3,1.75,1370,8006,1370,0
2619950740,20150109T000000,435000,3,2.5,2260,5100,2260,0
9412200330,20150410T000000,427500,3,1.75,1430,16200,1430,0
1079450410,20150417T000000,450000,5,2.5,2510,10240,1410,1100
9238900850,20140919T000000,688000,3,1.5,1760,4880,1290,470
2112701165,20150408T000000,285000,4,1,1430,3600,980,450
2767604067,20140820T000000,530000,3,3.25,1510,1125,1510,0
522049122,20150402T000000,195000,4,1.75,1320,7694,1320,0
8857600360,20140828T000000,250200,3,1.5,1180,7384,1180,0
4389200761,20150128T000000,1.10E+06,3,2.25,1560,8570,1080,480
6421000330,20141112T000000,732500,3,2.5,2470,10321,2470,0
2154900040,20141030T000000,194250,3,2.25,2190,8834,1390,800
259801030,20150309T000000,526000,4,2,1610,8000,1190,420
326049038,20150504T000000,520000,4,2.75,2700,9882,2700,0
6384500590,20141113T000000,526000,3,1.75,1530,6125,1120,410
3023069166,20140708T000000,1.14E+06,5,4,7320,217800,7320,0
3826000735,20140626T000000,202000,2,1,920,7569,920,0
7852110740,20141112T000000,645500,4,2.5,2990,8622,2990,0
3222049087,20150422T000000,570000,1,1,720,7540,720,0
726049131,20150320T000000,325000,3,2,1750,9000,1750,0
9424400110,20141216T000000,725000,2,1,2410,5930,1930,480
193300120,20141126T000000,192000,3,1.75,1240,10361,1240,0
1245001751,20140709T000000,560000,2,1,1010,9219,1010,0
1386800054,20141201T000000,283450,5,2.75,2770,6116,1490,1280
6814600150,20140905T000000,863000,4,1.75,2800,5400,1400,1400
9828200790,20141028T000000,815000,4,2,1400,4800,1400,0
9476200650,20150416T000000,245000,2,1,1020,7679,1020,0
9533600100,20141208T000000,1.32E+06,4,3,2860,10292,2860,0
4139430410,20141107T000000,1.16E+06,4,3.5,4270,12305,4270,0
7852030330,20140903T000000,480000,3,2.5,2270,4488,2270,0
7202270930,20140606T000000,600000,4,2.5,2560,5593,2560,0
223039254,20140624T000000,329950,2,1,900,5220,900,0
7843500090,20140822T000000,299500,4,2.5,2010,12085,2010,0
2491200330,20140918T000000,460000,3,2.5,1690,5131,1690,0
8113101582,20150415T000000,515000,5,3.5,2310,5249,1560,750
993002225,20140623T000000,405000,3,2.25,1520,1245,1520,0
9530100921,20141027T000000,483000,4,1.5,1220,3780,1220,0
3235390100,20150203T000000,377000,4,2.5,2170,11511,2170,0
5122400025,20140708T000000,568000,4,1.75,2790,17476,1450,1340
9297300750,20141105T000000,355000,2,1.75,1760,4600,850,910
3856900590,20140806T000000,640000,4,1.75,2100,3000,1500,600
4024700100,20150121T000000,270000,4,1,1430,5909,1070,360
114100131,20150114T000000,559950,5,3.5,2450,8193,2450,0
2296700330,20141014T000000,515000,4,3,1820,8261,1420,400
1995200215,20140826T000000,352000,4,1.75,1850,5712,1850,0
2287600035,20140625T000000,595888,3,1.75,1870,9000,1870,0
2923501130,20140722T000000,588000,4,2.25,2580,7344,2580,0
2485000076,20150122T000000,1.05E+06,4,3.25,3680,8580,1840,1840
9264921020,20140908T000000,260000,3,1.5,1750,7000,1750,0
5318100965,20150217T000000,1.60E+06,4,3.5,3890,3600,2860,1030
3501600215,20150414T000000,380000,2,1,1000,4800,1000,0
8682230610,20140602T000000,802000,2,2.5,2210,6327,2210,0
1337800665,20140811T000000,1.33E+06,4,3.25,2850,4800,2700,150
7960100220,20150416T000000,710000,4,2.75,2460,3600,1640,820
1549500272,20140609T000000,600000,3,2.5,2630,77972,2630,0
9547202380,20140902T000000,707900,3,1,1750,5355,1750,0
3518000180,20141120T000000,179950,2,1,1100,7323,780,320
6792100090,20140914T000000,683000,4,2.5,2620,10489,2620,0
5702330120,20140603T000000,222400,3,2,1200,9566,1200,0
1189000910,20140708T000000,517000,2,1.5,1920,3408,960,960
6204200590,20141029T000000,410000,3,2.75,1690,5763,1180,510
4443801340,20141006T000000,480000,3,1.75,1680,2552,840,840
2473370750,20150224T000000,430000,3,1.75,3440,10428,3440,0
2644900109,20150427T000000,439950,5,1.75,2190,7500,1290,900
293620220,20150421T000000,797500,4,2.5,3270,8223,3270,0
2624049115,20140710T000000,379000,4,1.5,1280,5460,1080,200
7942600910,20141216T000000,575000,1,1,1310,8667,1310,0
643000110,20150325T000000,247500,3,1,1660,11060,1110,550
9485951460,20140623T000000,385000,4,2.75,2700,37011,2700,0
6378500230,20140520T000000,423000,4,1.75,1940,6909,970,970
430000175,20141215T000000,550000,3,1.75,1520,5618,1170,350
1493300115,20140910T000000,415000,4,1,1620,4329,1620,0
2024059059,20141010T000000,693000,3,2.25,2090,45535,1280,810
2922701085,20150327T000000,543000,2,1,1070,4700,1070,0
4058801780,20150327T000000,465000,5,1.75,2000,10246,1200,800
2114700384,20150427T000000,280000,3,2.5,1020,2217,720,300
9829201020,20141118T000000,1.39E+06,3,1.25,2400,6653,2400,0
6918720100,20150130T000000,665000,6,3,2480,9720,2480,0
1450100330,20150312T000000,237950,3,1.75,1310,7314,1310,0
518000040,20150102T000000,440000,4,2.75,2420,10200,1220,1200
4242900245,20150112T000000,618000,2,1,1890,4700,1030,860
1231001130,20141113T000000,572000,3,2.25,1860,4000,1020,840
7445000115,20140527T000000,725000,3,1.5,2500,4774,1450,1050
7802900504,20140625T000000,454000,3,1,1970,22144,1970,0
4317700085,20150122T000000,535000,4,1,1660,10656,1180,480
8732040580,20141218T000000,249000,3,2.5,1850,7200,1500,350
3223039149,20140709T000000,395000,4,2.75,1970,37026,1970,0
4073200757,20141231T000000,690000,3,2,1890,6620,1890,0
3226049054,20141003T000000,526500,3,1.5,1310,7236,1170,140
5490700035,20140807T000000,325000,4,1.5,1870,7220,1870,0
9834200975,20150210T000000,495000,3,3,1520,4080,1520,0
3305100210,20141021T000000,825000,5,3,3070,8474,3070,0
3123039042,20141223T000000,383000,3,1.5,1400,14850,1400,0
1105000360,20150428T000000,320000,3,1.75,1960,11931,980,980
1724079048,20141208T000000,475000,3,2.5,2680,87117,1340,1340
7437100770,20140521T000000,275000,3,2.5,2030,6326,2030,0
8925100115,20141015T000000,1.15E+06,2,2.25,2320,9300,1920,400
4019300051,20141125T000000,455000,3,1.75,1760,11371,1760,0
5300200085,20140702T000000,262000,5,1,1870,7800,1580,290
9417400110,20140915T000000,390000,4,1,1280,4840,940,340
9264920870,20141023T000000,300000,3,2.25,1730,10030,1730,0
9169600209,20140820T000000,746300,3,1.75,2060,5721,1140,920
6123000090,20140908T000000,267000,3,1.5,1030,8223,1030,0
2592401080,20150402T000000,525000,3,2.5,1720,7950,1720,0
2423020090,20150424T000000,570000,3,1.75,1210,7350,1210,0
2968801130,20141027T000000,360000,4,2.25,2620,8100,1550,1070
3325069064,20150326T000000,1.05E+06,3,1,1860,44431,1860,0
3629910210,20141103T000000,699950,3,2.5,2510,4106,2510,0
622079089,20140616T000000,375000,4,2.5,2040,109336,2040,0
1919800090,20141215T000000,625000,4,1.75,2410,6770,1220,1190
9274200850,20141016T000000,464050,2,1,780,2750,780,0
1737320120,20140502T000000,470000,5,2.5,2210,9655,1460,750
2473100450,20140909T000000,330000,4,2,1590,9100,1040,550
7923200150,20140915T000000,537000,4,1.75,2230,7957,2230,0
7524600120,20150305T000000,250000,3,2,1560,32137,910,650
424069206,20150112T000000,835000,4,2.5,2950,48351,2950,0
9523103590,20150316T000000,770000,4,1,1480,3750,1480,0
161000120,20141118T000000,650000,4,2,2850,4497,1730,1120
1623049241,20141107T000000,335000,3,1.75,2390,30409,1560,830
7229700165,20141202T000000,350000,3,1.75,1740,29597,1740,0
3031200205,20140724T000000,415000,5,2.75,2060,8906,1220,840
2600100110,20141119T000000,788000,4,2.5,2680,8778,2680,0
5652601140,20141014T000000,640000,4,2.75,3150,7379,2430,720
2473530100,20140523T000000,388000,4,2.5,2440,7155,2440,0
3558900590,20141125T000000,360000,6,1.75,2230,10080,1390,840
3558900590,20150324T000000,692500,6,1.75,2230,10080,1390,840
8121100395,20140624T000000,425000,4,1.5,1600,6180,1600,0
8121100395,20150311T000000,645000,4,1.5,1600,6180,1600,0
7100000110,20150114T000000,340000,3,1,1580,8308,1580,0
925069042,20150105T000000,713000,4,3.25,2840,54400,2840,0
7568700740,20140521T000000,430000,3,2.75,2550,11160,2550,0
7205510230,20150306T000000,280000,3,2.25,1700,7210,1250,450
9268700040,20150226T000000,215000,3,2,1470,2052,1470,0
2473480210,20140528T000000,306000,3,2.5,1680,11193,1680,0
4024100120,20140625T000000,299900,3,1,1110,8593,1110,0
4038200120,20140825T000000,534000,5,1.75,2120,8625,1200,920
4218400395,20140728T000000,1.16E+06,3,2.75,2380,5572,1930,450
669000210,20140716T000000,1.17E+06,3,2.5,2670,5000,2000,670
6018500015,20140711T000000,199990,2,1,890,6430,890,0
2600140120,20140812T000000,946000,4,3,3140,9058,2140,1000
6381500090,20150220T000000,295000,4,1,1260,7800,1260,0
4109600306,20150218T000000,475000,2,1,920,5157,920,0
2624079010,20150429T000000,750000,5,3.5,2990,212137,2450,540
7204200025,20141028T000000,1.23E+06,4,2.5,3120,49456,2590,530
8856003525,20150323T000000,183500,3,1,1010,7520,1010,0
1695900025,20150327T000000,450000,2,1,1010,3627,1010,0
3331001285,20150108T000000,180000,3,1,1020,5500,1020,0
239000155,20150105T000000,707000,5,4.5,3540,21217,2940,600
1721801280,20150304T000000,230000,2,0.75,900,3527,900,0
5557700210,20141209T000000,192500,3,1,1100,9750,1100,0
5416500040,20141017T000000,309000,3,2.5,1990,3614,1990,0
3271300155,20141001T000000,759000,3,1.5,1980,5800,1520,460
3303980210,20150427T000000,1.12E+06,4,3.75,4040,14212,4040,0
1944900090,20140519T000000,462000,5,1.75,1250,10530,1250,0
7663700401,20141220T000000,229000,4,1.5,1820,22814,1820,0
5694500386,20141020T000000,399950,2,2.25,1140,1184,1010,130
7227800180,20150403T000000,325000,5,2,1730,10532,1730,0
2767604558,20140721T000000,512000,2,2.25,1170,1313,1170,0
5422950040,20140725T000000,410000,5,2.75,2910,5802,2910,0
2660500283,20140624T000000,210000,2,1,970,5500,970,0
3308010040,20140925T000000,325000,4,2.25,2130,8499,1600,530
5423030040,20150406T000000,685000,3,2.5,2520,10175,1630,890
8604900245,20140518T000000,488000,2,2,1360,4688,780,580
7349650230,20150302T000000,247500,3,2.25,1620,6000,1280,340
8902000175,20140620T000000,489000,4,2,2120,11479,1060,1060
582000065,20141125T000000,725000,4,1.75,2700,6000,1450,1250
2123049194,20150409T000000,199950,3,1.5,1370,10317,1370,0
1830300090,20150401T000000,670000,5,3,2520,13001,2010,510
7522600110,20141229T000000,275000,3,2,1540,10410,1540,0
5457800740,20150407T000000,1.00E+06,3,1.75,2610,6360,2130,480
5115000100,20140523T000000,255000,3,2,1490,8371,1490,0
4038400150,20141113T000000,465000,3,1.75,2760,9137,1380,1380
1796500100,20150211T000000,259000,3,1.75,1260,3604,1260,0
8956000100,20141121T000000,695000,3,3.5,2630,4713,2030,600
3876313120,20150501T000000,505000,3,1.75,1800,7210,1370,430
6819100040,20140624T000000,631500,2,1,1130,2640,1130,0
5318101185,20141016T000000,630500,3,1,1180,3600,1180,0
424069112,20140616T000000,999000,4,2.75,2800,19168,2800,0
2533300025,20140710T000000,740000,3,1.5,1830,4000,1350,480
5101404482,20140929T000000,650000,3,2.5,2220,6380,1660,560
8682231210,20140805T000000,554000,2,2,1870,5580,1870,0
1525069021,20141201T000000,400000,3,2.5,2580,214315,2580,0
5076700115,20150223T000000,529941,3,2,1660,10000,1010,650
3332000615,20141020T000000,310000,3,1,1330,3740,1330,0
3332000615,20150422T000000,389000,3,1,1330,3740,1330,0
5569620410,20140909T000000,731781,3,3,2630,4972,2630,0
3009800015,20150422T000000,502501,2,1,1100,4750,1100,0
6189600040,20141117T000000,443000,3,1.75,1810,7950,1810,0
9834200365,20140815T000000,607000,3,2,2060,4080,1060,1000
1959701800,20140702T000000,2.15E+06,3,3.5,4660,5500,3040,1620
8917100153,20140910T000000,585000,4,2.5,2370,15200,1660,710
2344300180,20140619T000000,1.03E+06,3,2.5,2430,10500,2430,0
3216900100,20140612T000000,315000,3,2.5,1880,7000,1880,0
425000065,20141021T000000,180000,2,1,1150,5695,1150,0
2426069085,20140513T000000,322500,3,2,1350,14200,1350,0
7199350600,20140602T000000,568500,3,2.75,2180,7519,1310,870
6909700040,20140611T000000,813000,4,2.75,3370,6675,1920,1450
4147200040,20150414T000000,1.09E+06,5,2.25,3650,13068,1850,1800
1062100100,20140626T000000,424000,4,2,2100,4857,2100,0
2124049254,20140717T000000,235000,2,1,670,5600,670,0
6841700100,20140929T000000,740000,3,3.5,2420,4000,1820,600
7544800195,20140813T000000,415000,1,1,760,3000,760,0
8807810110,20140522T000000,432000,3,2.75,2200,14925,1100,1100
1126059201,20150504T000000,1.27E+06,5,3.25,4410,35192,3880,530
1422200090,20140915T000000,676500,3,1.75,1300,2446,880,420
871000065,20141120T000000,419000,2,1,720,4592,720,0
4054710090,20150320T000000,650000,3,2.5,2180,37042,2180,0
8075400360,20140822T000000,239000,2,1,1130,15190,1130,0
9551202875,20140709T000000,900000,4,2.5,2230,4372,1540,690
4027700930,20150428T000000,330000,5,1.75,2100,7347,1070,1030
1535204165,20141204T000000,510000,3,1.75,2060,58341,1100,960
3303860590,20140627T000000,465000,4,2.5,3060,6000,3060,0
1925069066,20140623T000000,1.70E+06,3,2.75,2810,18731,2810,0
6137610540,20140827T000000,490000,3,2.25,2550,8588,2550,0
2525049263,20140709T000000,2.68E+06,5,3,4290,20445,4290,0
126059310,20141130T000000,1.00E+06,3,2.25,3040,52302,3040,0
4254000540,20140708T000000,469950,4,2.75,2530,14178,2530,0
5101405067,20140509T000000,536000,3,1.75,1300,5413,1300,0
5468000180,20150305T000000,244950,4,2.5,1790,19177,1790,0
1930301220,20150417T000000,575000,3,1,1530,2400,890,640
9282801450,20150325T000000,361000,5,2.75,2380,7500,1300,1080
4037000925,20150327T000000,650000,5,2.25,2400,13450,1200,1200
3336000230,20150323T000000,230005,2,1,1030,6000,830,200
3621059043,20140527T000000,293000,4,2.5,3250,235063,3250,0
126049231,20140516T000000,445000,3,3,1970,24318,1970,0
3331000220,20140814T000000,280000,4,1.5,1940,6386,1140,800
3904900230,20140716T000000,520000,3,2.25,1850,10855,1370,480
525069133,20140805T000000,780000,4,3.25,3900,40962,3900,0
2721049061,20140709T000000,625000,3,1.75,3160,76230,2160,1000
5381000411,20150410T000000,239950,3,1.75,1440,7200,1440,0
603000150,20140616T000000,335000,3,1.5,2040,6000,1340,700
3904960690,20150417T000000,612000,3,2.5,2120,7401,2120,0
7686202730,20140804T000000,200000,2,1,830,8000,830,0
9264910300,20140710T000000,345000,3,1.75,3140,8571,1670,1470
1437910090,20150128T000000,520000,4,2.5,2410,6440,1550,860
2652500740,20140618T000000,855000,4,2.25,2190,4080,1800,390
9274200735,20150507T000000,567500,4,1.75,2190,5060,1190,1000
1745000090,20141110T000000,208000,3,1.5,1210,7247,1210,0
5101405338,20140821T000000,452000,3,1.75,1880,16239,880,1000
9348500220,20140728T000000,555000,3,3,2410,12183,2410,0
1066600090,20140905T000000,519000,5,2.75,2620,8861,1350,1270
3331500455,20141203T000000,474950,3,2.25,1850,2575,1850,0
1427300120,20150121T000000,419000,3,2.25,1760,16418,1190,570
1861400068,20140911T000000,390000,2,1,860,1800,860,0
4040500100,20141020T000000,539000,7,2.25,2620,6890,2620,0
6117501250,20140801T000000,569000,4,1.75,2400,21196,1590,810
9523103990,20141208T000000,611000,3,1,1850,5000,1850,0
3221069054,20141028T000000,760000,3,2.5,4040,147856,4040,0
8838900032,20140518T000000,732000,3,2,1940,55756,1940,0
1455100355,20140708T000000,1.68E+06,3,2.5,3490,8343,2150,1340
1853080120,20140903T000000,919950,5,2.75,3170,7062,3170,0
2806800120,20140610T000000,400000,4,2.5,2530,7563,1440,1090
3216000090,20140729T000000,785000,4,2.5,3230,21781,3230,0
1525059165,20140629T000000,835000,3,2.25,2120,54014,2120,0
8901000835,20150211T000000,640500,2,1.75,1640,6750,1340,300
8001400300,20150316T000000,310000,4,2.5,2130,9013,2130,0
1138000450,20141016T000000,355000,4,1,1440,7215,1440,0
2485000100,20140529T000000,685000,3,1.75,1940,7313,1440,500
7689600215,20141017T000000,202500,3,1,1120,8576,1120,0
7852010940,20150505T000000,540000,3,2.5,2400,5817,2400,0
739980360,20141117T000000,295000,4,2.5,1810,4871,1810,0
1102001055,20150424T000000,518000,3,1,1270,6612,1270,0
2781250970,20150501T000000,250000,2,1.75,1350,4023,1350,0
3624079067,20140508T000000,330000,2,2,1550,435600,1550,0
4443800785,20141121T000000,481000,2,1,1620,3880,920,700
3303900090,20141023T000000,898000,3,2.25,2650,12845,1770,880
686530530,20140804T000000,570000,5,1.75,2510,9750,2510,0
4254000220,20150307T000000,475000,4,2.5,2040,16200,2040,0
7575600610,20150209T000000,265000,3,2.5,1660,5250,1660,0
7631800110,20140918T000000,380000,3,2.5,1980,17342,1580,400
7732410120,20140819T000000,790000,4,2.5,2690,8036,2690,0
2493200040,20150312T000000,620000,2,2.25,2910,6110,2910,0
2568300040,20140819T000000,709050,4,3.5,2720,9000,2670,50
1781500385,20140806T000000,296500,3,1,1280,5100,1280,0
626710220,20140813T000000,475000,3,2.5,2160,35912,2160,0
9414500230,20141022T000000,440000,3,2.25,1760,10835,1290,470
6638900405,20141208T000000,405000,2,1,800,6016,800,0
7327902612,20150513T000000,269500,2,1,930,4000,730,200
7923600330,20141119T000000,520000,5,1.75,2040,5280,1020,1020
2011400782,20140804T000000,229500,1,1,1180,22000,1180,0
821049149,20141009T000000,335000,4,1.75,2000,10890,1390,610
4054700300,20141021T000000,680000,4,2.75,3310,50951,3310,0
3931900580,20150313T000000,1.39E+06,4,3.5,3130,3900,2550,580
2485000165,20141215T000000,740000,4,2.5,2300,9900,1600,700
1117000150,20150317T000000,270000,3,2.25,2140,9990,2140,0
4321200600,20150504T000000,510000,4,2,2210,5572,1760,450
123039364,20140521T000000,300000,2,1,970,13700,970,0
2175100205,20150323T000000,1.30E+06,5,2.25,2690,10800,2020,670
8813400165,20140819T000000,675000,4,2,1890,5188,1670,220
2597531020,20141104T000000,925850,6,3.25,3140,14923,3140,0
723069013,20140718T000000,255500,2,1,1440,43560,1150,290
1137800230,20140514T000000,450000,3,2.5,2910,17172,2910,0
3221069057,20141105T000000,280000,3,1,1310,22652,1310,0
3832500230,20150105T000000,245000,4,2.25,2140,8800,2140,0
1138010220,20150317T000000,344950,3,1,1090,6712,1090,0
3205500230,20140811T000000,381000,3,1.75,1330,7216,1330,0
4389201241,20141230T000000,1.95E+06,4,4,4690,6900,3480,1210
9808700025,20150211T000000,1.50E+06,3,1.5,1910,21374,1910,0
4399210110,20140619T000000,232603,3,1.75,1750,11461,1750,0
7972602490,20141212T000000,220000,5,2.5,1760,10200,1760,0
2128000180,20140811T000000,600000,4,1.75,1810,7700,1390,420
4345000090,20141105T000000,239000,3,2.5,1360,5754,1360,0
6413100242,20140826T000000,400000,3,1.75,1730,9211,1730,0
4218400455,20140708T000000,2.18E+06,6,2.75,4710,11000,3690,1020
1568100220,20140908T000000,350000,3,1,1010,8551,1010,0
1626069220,20140905T000000,562000,3,2.5,2400,97138,2400,0
3342103149,20140910T000000,380000,3,1.5,1540,8400,1540,0
8127700410,20141015T000000,511200,4,1.75,1480,7875,740,740
3629970090,20141014T000000,680000,4,2.5,2520,5000,2520,0
8910500237,20140726T000000,350000,3,3.25,1210,941,1000,210
621069218,20150219T000000,410000,5,2.5,2670,184140,1410,1260
3394100230,20140522T000000,1.05E+06,4,2.5,3030,12590,3030,0
8682211030,20141028T000000,391265,3,2,1440,3900,1440,0
5427100150,20140626T000000,1.41E+06,4,2.25,3250,16684,3250,0
7579200600,20150428T000000,575000,3,2,1750,5750,870,880
7302000610,20150508T000000,316000,4,1.5,2120,46173,2120,0
3004800175,20150416T000000,165000,3,1,1050,5156,1050,0
2397101055,20140812T000000,850000,3,2.25,1950,3600,1430,520
2354300845,20140804T000000,210000,3,1,1020,6000,1020,0
984220330,20140824T000000,325000,4,2.5,1820,9161,1220,600
7273100026,20150407T000000,682000,4,2.5,2390,53941,2390,0
6386200100,20140718T000000,430000,3,2.5,1400,7508,1400,0
9324800025,20141125T000000,325500,3,1.5,1540,8110,1190,350
4058800930,20140720T000000,385000,3,1.75,2370,6360,1280,1090
1972201161,20150323T000000,435000,1,1,670,1800,670,0
2202500025,20140721T000000,550000,4,1,2420,15520,2420,0
4077800258,20141009T000000,400000,3,1,1000,7800,860,140
2558700220,20140721T000000,503000,4,2.75,2100,7350,1240,860
290200230,20140819T000000,676000,4,2.5,2800,5368,2800,0
1951100100,20141113T000000,180000,3,1,940,11055,940,0
9499200220,20140611T000000,234000,3,2,1640,5280,1640,0
999000215,20140512T000000,734200,4,2.5,2760,5000,1680,1080
822069118,20140729T000000,920000,3,3.25,3660,66211,3660,0
2425049066,20140616T000000,1.92E+06,4,2.5,3070,34412,2070,1000
7950700110,20141209T000000,224000,3,1.75,1100,10125,1100,0
9253900408,20150408T000000,1.40E+06,3,2.75,3130,19530,1690,1440
3313600077,20140919T000000,185000,3,1,1320,7155,1320,0
452001540,20140818T000000,554600,3,1.75,1470,5000,1470,0
3832710210,20140825T000000,268000,3,1.75,1480,8009,980,500
8563000300,20140915T000000,675000,4,2.25,2260,8715,1530,730
1313000650,20140711T000000,620000,4,2.25,2210,10039,1710,500
3424069066,20140521T000000,396450,3,1.75,1540,12446,1540,0
2206500300,20140820T000000,565000,5,1.75,1910,9720,1390,520
3083001095,20140824T000000,410000,3,1.75,1760,3520,1160,600
809002290,20140519T000000,1.19E+06,4,3,2240,6000,1270,970
6669070220,20140821T000000,716125,3,2.25,2110,7279,2110,0
2325069054,20140521T000000,225000,2,1,1396,111949,1396,0
8820901792,20140711T000000,640000,4,2.75,3040,7274,2320,720
3488300110,20140910T000000,374000,2,1,1140,5650,980,160
3971700330,20150415T000000,415000,4,2,1780,12161,1160,620
5561400220,20140819T000000,592500,4,2.5,3370,35150,1770,1600
2979800762,20140904T000000,365000,3,2.5,1484,1761,1484,0
6600220300,20140914T000000,600000,4,2.5,2230,12753,1180,1050
2817910220,20141216T000000,465000,4,2.5,2820,39413,2820,0
7696620100,20150422T000000,254999,3,1,1580,7560,1000,580
7760400900,20140916T000000,279000,4,2.5,2040,8076,2040,0
3353404265,20141231T000000,460000,3,2.5,2720,40813,2720,0
9828702666,20140728T000000,507000,4,2.25,1490,956,1020,470
1823059223,20140520T000000,291000,3,1.75,1560,9788,1560,0
2197600388,20141202T000000,350000,2,1.5,830,1077,830,0
4239400300,20141129T000000,90000,3,1,980,2490,980,0
1328300820,20140806T000000,329000,3,1.75,1980,7000,1360,620
7805450870,20140814T000000,909000,4,2.5,3680,11648,3680,0
419000035,20141015T000000,187000,2,1,860,5400,860,0
3131201105,20140709T000000,580000,3,1.75,1850,5100,1020,830
112900110,20140903T000000,345000,3,2.5,1620,5992,1620,0
5249802240,20140515T000000,497000,4,2.5,2240,7200,2240,0
7950302345,20140815T000000,345000,3,1,1010,3060,1010,0
2473371570,20141119T000000,313500,3,1.75,1610,7350,1610,0
3982700088,20150402T000000,910000,3,2.5,2720,7250,2720,0
3448000755,20140604T000000,399950,3,1.5,2080,5244,1190,890
1446400615,20140527T000000,268000,4,2,1930,6600,1030,900
2484700145,20141229T000000,559000,4,1.75,2250,8458,1450,800
1753500100,20140709T000000,309000,3,2.25,1980,8755,1300,680
7853300770,20140609T000000,410000,3,2.5,1960,4400,1960,0
7236100015,20140520T000000,259000,3,1,1320,8625,1320,0
1959701695,20141124T000000,950000,5,2,2940,5500,2340,600
4024101421,20141202T000000,320000,4,1,1460,7200,1460,0
327000165,20150413T000000,1.15E+06,4,2.5,2330,30122,1490,840
7893800534,20141124T000000,394250,3,2,2620,10107,2620,0
6430500191,20141106T000000,315000,1,1,700,3876,700,0
2354300835,20141224T000000,480000,2,2,1140,12000,1140,0
9510300220,20140804T000000,556000,3,2.5,2750,35440,2750,0
7852130410,20141027T000000,450000,3,2.5,2480,5647,2480,0
5101406522,20141001T000000,420000,3,1.5,1130,5413,940,190
2768200090,20150317T000000,890000,6,3.75,2770,5000,1870,900
1761300650,20141006T000000,295000,4,2,1710,8814,1030,680
1081330210,20140911T000000,410000,4,2.25,2150,27345,2150,0
4137070090,20140611T000000,308900,3,2.5,2250,7294,2250,0
327000100,20141022T000000,1.16E+06,4,2.5,2960,26742,1480,1480
8682281510,20150128T000000,665000,2,2.5,2300,6984,2300,0
3297700100,20140903T000000,577000,3,1.75,1740,5500,970,770
7518506717,20140917T000000,959000,3,2.5,2830,3750,2830,0
65000210,20140626T000000,471000,2,1.75,1240,6417,1240,0
3905040590,20150421T000000,560000,3,2.5,2180,7169,2180,0
5451210150,20140514T000000,955000,5,2.25,2510,9887,2510,0
1778360150,20140620T000000,1.24E+06,7,5.5,6630,13782,4930,1700
6649900301,20141231T000000,579000,3,2.5,2300,18540,1800,500
9264901490,20150428T000000,335000,4,2.25,3220,7889,3220,0
7853220910,20140915T000000,485000,3,2.5,2270,7887,2270,0
9346700150,20140702T000000,552000,3,2.5,1840,9900,1840,0
2327000110,20140714T000000,950000,4,3.25,3820,15293,3820,0
7137900490,20150316T000000,203700,3,2,1660,7958,1130,530
9264960850,20140709T000000,412000,4,3.5,3360,9767,2450,910
1545808960,20150106T000000,237500,3,2,1350,8960,1350,0
486000085,20140815T000000,866800,4,3.5,2970,5000,2200,770
7977200945,20150310T000000,425000,3,1,1000,5100,860,140
3056700150,20140625T000000,200000,3,2,1190,6833,1190,0
7896300150,20140929T000000,280000,3,1.75,1670,6034,990,680
7399100210,20141126T000000,140000,3,1.5,1200,2002,1200,0
2473370110,20141114T000000,370000,5,2.5,2250,10400,1280,970
2770605420,20140916T000000,550000,2,0.75,1040,4000,930,110
7856400300,20140702T000000,1.41E+06,2,2.5,3180,9400,2610,570
7856400300,20150322T000000,1.51E+06,2,2.5,3180,9400,2610,570
7923700330,20140528T000000,510000,4,1.5,2040,8800,1020,1020
5632500110,20140716T000000,351000,3,1,1160,10518,1160,0
723049219,20150325T000000,210000,3,1,880,10800,880,0
2320069111,20150507T000000,449999,4,1.75,2290,36900,1690,600
7972604345,20140519T000000,137000,3,1,950,7620,950,0
3222069156,20141217T000000,270000,3,1,1010,14510,1010,0
1722069097,20141229T000000,540000,3,2.5,3100,100188,1820,1280
4022905473,20141205T000000,565000,5,3,2560,12480,1590,970
5318101695,20150409T000000,940000,4,1.5,2430,3600,2430,0
5216200090,20140616T000000,385000,2,1,830,26329,830,0
9526500090,20140822T000000,400000,3,3,2090,7634,1450,640
423059039,20150321T000000,365000,3,2,2030,8649,2030,0
6909700437,20140522T000000,353250,2,1,1060,1600,1060,0
1205000215,20150429T000000,455000,2,1.5,1090,6750,950,140
3223039229,20140527T000000,475000,4,3.5,3400,234352,2500,900
4077800474,20141124T000000,571500,4,1.75,1920,7455,960,960
1604600227,20150328T000000,441000,2,1,1150,3000,780,370
9542200220,20150213T000000,810000,6,2.75,3970,9500,2180,1790
6600220490,20150409T000000,550000,3,2.25,1880,11556,1880,0
2138700141,20140702T000000,736000,2,1,1500,4000,1100,400
4046600820,20150224T000000,375000,3,1.75,2190,17550,2190,0
9430100360,20150205T000000,717500,3,2.5,2530,9932,2530,0
2447500015,20141121T000000,581000,2,1.75,1930,11200,1430,500
1524039043,20140725T000000,629000,3,2,1510,4560,1510,0
2303900100,20140911T000000,3.80E+06,3,4.25,5510,35000,4910,600
8651400230,20141208T000000,225000,3,2,1100,5200,1100,0
7437100210,20140618T000000,315000,3,2.5,1730,6368,1730,0
3630020150,20150310T000000,425000,3,2.5,1480,1386,1480,0
1773600691,20140625T000000,346500,3,1,1150,11802,1150,0
5448300150,20150105T000000,550000,3,2.25,1950,26500,1570,380
2260000210,20150209T000000,565000,3,1.75,2380,10450,1400,980
6815100085,20141224T000000,1.00E+06,4,2,3100,8000,2040,1060
5141000720,20140805T000000,400000,2,2,2010,3797,1450,560
9276200455,20141121T000000,724950,4,2,2270,5760,2270,0
5459500165,20140708T000000,623000,3,1.75,2050,16313,2050,0
9828701295,20140624T000000,295000,2,1,650,5400,650,0
164000261,20140521T000000,700000,4,3.25,2780,7875,2780,0
2767704682,20150408T000000,482000,2,1.5,1300,1229,1160,140
6791050450,20140821T000000,770000,3,2.5,2730,11380,2730,0
1221039066,20141017T000000,310000,4,2.5,3140,22100,1820,1320
686300450,20140708T000000,720000,4,2.25,2410,8400,2410,0
3822200087,20150319T000000,355000,3,1,1180,5965,1180,0
6669250100,20140729T000000,512000,4,2.5,2600,4506,2600,0
1453602310,20141216T000000,303000,2,1.5,1400,1650,1400,0
984200690,20140618T000000,299000,5,2.5,2220,9360,1110,1110
5468770180,20140623T000000,285000,3,2.5,1660,6263,1660,0
5459500100,20140924T000000,680000,3,1.75,2330,9652,1590,740
2968801605,20140902T000000,285000,4,1.75,1440,6720,720,720
2141310580,20141125T000000,707000,4,2.25,2920,17023,1690,1230
2325039067,20140507T000000,690000,3,2,1760,6428,980,780
2426059103,20150422T000000,872000,4,2.25,2860,40284,2860,0
3541600450,20141104T000000,290000,4,1.75,2090,12750,1360,730
5631501161,20150417T000000,425000,4,1.75,1910,16785,1110,800
3224510300,20150126T000000,925000,3,2.75,3280,10558,2040,1240
4027700466,20141219T000000,340500,3,1,1770,12458,1770,0
1702901500,20141121T000000,365000,2,1,920,6600,920,0
8146300205,20140710T000000,725000,3,1.75,1690,8489,1690,0
3526039019,20140702T000000,811000,3,3,2470,7410,1860,610
5230300210,20141210T000000,299000,3,1,1040,9514,1040,0
7907600100,20150421T000000,287500,4,2,1220,9147,1220,0
9322800210,20140520T000000,879950,4,2.25,3500,13875,1830,1670
3352400661,20141110T000000,135900,2,1,760,3800,760,0
3625710100,20140512T000000,1.23E+06,4,2.25,3070,16028,1870,1200
3626039207,20141017T000000,522500,4,1.75,2100,6480,1300,800
7568700215,20150312T000000,399500,4,1.5,1660,6617,1660,0
1604600540,20150504T000000,450000,3,1,1430,5960,1430,0
1421039067,20141027T000000,218000,4,1,1620,17500,1620,0
7137970210,20150327T000000,289999,3,2,1490,9285,1490,0
2767603255,20150224T000000,540000,2,1,1170,4750,1170,0
3575303700,20140725T000000,324950,3,1,1240,7500,1240,0
1702901340,20140613T000000,718500,3,2,2910,6600,1920,990
2320069014,20140709T000000,495000,3,2,2660,192099,2660,0
3141600600,20140521T000000,260000,6,2,2220,8797,2220,0
2201501015,20140502T000000,430000,4,1.5,1920,10000,1070,850
3782760040,20140603T000000,402500,3,3.25,2780,4002,2780,0
6613001241,20140811T000000,1.42E+06,4,3,3110,4408,2510,600
3276980120,20141028T000000,275000,3,2.25,1820,9766,1450,370
1321400650,20140603T000000,250000,3,2.25,1765,7652,1765,0
643300180,20140523T000000,665000,3,2.75,1800,9550,1320,480
322059210,20150203T000000,425000,3,2.5,2650,144183,2650,0
9551201560,20140722T000000,760000,2,1,1410,3600,1310,100
7202330330,20140814T000000,447000,3,2.5,1650,3076,1650,0
5153900150,20140708T000000,205000,3,1,1180,8240,1180,0
1788700230,20140506T000000,191000,3,1.5,800,8850,800,0
49000051,20150316T000000,350000,2,1.75,1430,7921,1430,0
3343301393,20150330T000000,789888,5,3.5,3300,7860,2410,890
2832100215,20150323T000000,443000,2,1,1220,10170,980,240
1980200015,20140929T000000,695000,4,3.5,3530,7202,2660,870
1825049013,20150213T000000,560000,4,2,1380,4048,1380,0
7550800015,20140714T000000,550000,3,1.75,1410,5000,810,600
8682230760,20140724T000000,850000,2,2.5,3360,6750,3360,0
8645511500,20150420T000000,352750,4,2.75,2270,24237,1360,910
8567450220,20140818T000000,550000,4,2.5,2890,9045,2890,0
1556200205,20141118T000000,774900,5,1,1750,3861,1750,0
9476200580,20140710T000000,250000,3,1,1010,8711,1010,0
8965410150,20140825T000000,962800,4,2.5,3780,23623,3780,0
5031300011,20141104T000000,299500,3,1.75,1880,11700,1880,0
5101408735,20141103T000000,250000,2,1,800,5220,800,0
2623069010,20150116T000000,745000,5,4,4720,493534,3960,760
2624089040,20150217T000000,279475,2,1,1060,10600,1060,0
3345700165,20141202T000000,450000,3,2.25,2530,27227,2530,0
379000051,20140826T000000,307700,5,2.25,1980,13132,1260,720
871000155,20141211T000000,665000,3,1,1650,5102,1300,350
7852020580,20140724T000000,375000,3,2.75,1890,3930,1890,0
7298050110,20150303T000000,420000,4,2.5,3360,11637,3360,0
2114700615,20140708T000000,148000,2,1,630,4200,630,0
809001965,20140729T000000,707000,3,1.5,1980,4000,1980,0
9557200090,20141112T000000,399000,3,1,990,4250,840,150
5126210360,20141022T000000,570000,4,2.5,3420,115434,3420,0
3528000210,20150323T000000,853000,4,2.25,3440,35025,3440,0
424059052,20141222T000000,400000,3,1,1300,14138,1300,0
594000115,20140512T000000,615000,2,1.75,2040,28593,2040,0
2207100740,20150106T000000,463000,3,1,1250,7700,1250,0
7784000100,20140603T000000,600000,4,2.5,1960,14242,1290,670
3732800495,20141028T000000,429000,5,2.5,2720,8120,1360,1360
2025059131,20140904T000000,980000,4,4.25,3250,11780,2360,890
6699000740,20150421T000000,359500,6,3.75,3190,4700,3190,0
8651610580,20141107T000000,715000,4,2.5,2570,7980,2570,0
5412300100,20150325T000000,240000,3,1.75,1420,6984,980,440
8096600100,20141215T000000,455000,4,2,2120,9442,1060,1060
722079015,20141017T000000,610000,3,2.5,2080,167270,2080,0
339350150,20150311T000000,675000,3,2.75,2740,5735,2740,0
2560805440,20150129T000000,283500,3,1.75,1250,5375,1250,0
7131300047,20140826T000000,235000,2,1,2150,4500,1260,890
3459600180,20140626T000000,827000,4,2.5,3230,12100,1870,1360
7663700663,20140910T000000,353000,2,1,860,8511,860,0
5415350770,20140923T000000,747500,4,2.5,2810,11902,2810,0
3083000940,20150412T000000,341000,2,1,1040,4000,1040,0
1670400090,20141124T000000,182000,3,1,1160,18055,1160,0
2781250610,20141202T000000,250000,3,2,1470,2781,1470,0
3764500090,20140521T000000,655000,4,3.5,2350,13402,1670,680
7401000040,20140507T000000,405000,3,2.25,1660,8307,1660,0
4323700230,20140818T000000,390000,4,1.75,2020,9750,1100,920
3500100047,20141008T000000,275400,2,1,890,8180,890,0
3885807362,20140604T000000,791000,3,2.25,2430,5500,1810,620
7199340650,20140508T000000,424500,3,1.75,1460,7700,1460,0
5014000120,20140617T000000,430000,3,1,980,7200,980,0
3758900037,20150505T000000,865000,4,2.5,2580,10631,2580,0
2724201202,20150304T000000,163000,2,2,1250,7543,1250,0
7855600730,20140908T000000,920000,4,2.75,3140,9085,1570,1570
7151700360,20141211T000000,1.03E+06,5,3.25,2680,3011,1870,810
3811300090,20140724T000000,325000,3,1.75,1810,8048,1290,520
538000450,20140603T000000,315000,5,2.5,2090,4698,2090,0
6303400475,20140911T000000,227000,4,1,1120,8763,1120,0
3388110230,20140729T000000,179000,4,1.75,1790,7175,1410,380
9834201215,20141009T000000,276000,2,1,870,2676,820,50
844000375,20150303T000000,335000,4,1.5,3160,19745,1840,1320
3816700150,20141114T000000,430000,3,2,2350,12480,1600,750
7237301210,20141118T000000,266490,3,2.5,1810,4113,1810,0
130000175,20140806T000000,655000,4,2.75,3160,8197,1580,1580
9468200175,20141114T000000,635500,3,2,1660,3600,1000,660
8643200061,20140626T000000,235000,5,2.5,2500,9583,1300,1200
7805460760,20150427T000000,885000,3,2.5,2880,11443,2880,0
6713700155,20140818T000000,352500,3,1,1470,8400,1470,0
3236500220,20140709T000000,450000,3,2.5,1460,7573,1460,0
3625049042,20141011T000000,3.64E+06,5,6,5490,19897,5490,0
7935000450,20140919T000000,1.05E+06,3,2.25,2480,15022,1330,1150
1324300018,20141121T000000,476000,2,2.25,1140,1332,1140,0
4123820450,20140507T000000,375000,3,2.5,1830,13042,1830,0
9325200120,20140909T000000,600600,4,3.5,3110,6829,3110,0
3918400097,20141117T000000,567000,4,1.75,2630,11213,1430,1200
8126300410,20140725T000000,650000,4,1.75,2390,12000,1470,920
7227800040,20140604T000000,190000,5,2,1750,10284,1750,0
1020069042,20141001T000000,858000,4,3.5,4370,422967,2580,1790
3213200245,20150115T000000,435500,1,1.75,1020,4512,770,250
455000760,20150311T000000,685000,3,2,2500,6733,1770,730
104510230,20141119T000000,252000,3,2,1540,7210,1540,0
4140090110,20140912T000000,512500,4,2.25,2200,6900,2200,0
6072500490,20140801T000000,423800,3,2.5,1940,7415,1940,0
6705120100,20150504T000000,460000,3,2.25,1453,2225,1453,0
3764390100,20140722T000000,434000,3,2.75,1830,3200,1830,0
2988800011,20150414T000000,244000,3,1,2000,15900,1000,1000
1073100065,20150217T000000,348125,3,1,1400,8451,1400,0
1136100062,20140509T000000,585000,4,3.25,2400,29252,2400,0
3356402020,20140508T000000,230000,3,1,1390,16000,1390,0
8039900180,20140805T000000,450000,3,2,1680,11250,1680,0
4174600391,20150323T000000,393000,5,2,1820,5054,910,910
6865200981,20141221T000000,517000,2,1,1140,3750,1140,0
1236900090,20140915T000000,400000,3,1,1060,12690,1060,0
925069152,20150304T000000,890000,2,1.75,3050,50965,3050,0
9456200405,20150310T000000,205950,3,1,970,11963,970,0
2420069220,20141203T000000,209000,3,1,1320,3954,1320,0
6381501965,20140612T000000,430000,4,1.75,1890,6000,1110,780
9191201325,20150301T000000,534000,4,1.75,2040,2750,1260,780
9547202245,20140627T000000,735000,4,3,2370,3672,1650,720
1924069115,20150224T000000,873000,3,2.25,2720,54450,2720,0
8121200970,20141118T000000,475000,4,2.25,1970,7532,1390,580
323049176,20140530T000000,325000,3,1.75,2180,10230,1090,1090
826079047,20140814T000000,500000,3,2.25,2990,216057,2990,0
8078550610,20150120T000000,279000,4,2.75,2180,8475,1330,850
3904930530,20150414T000000,350000,3,2,1440,5469,1440,0
7504020970,20150421T000000,660000,4,2.25,3180,13653,3180,0
8642600090,20150218T000000,324950,2,1.5,1643,14616,1643,0
2239000011,20150127T000000,500000,4,2,1530,7816,1530,0
9382200121,20140718T000000,187300,2,1,1310,7697,850,460
7942601475,20140520T000000,345600,5,3.5,2800,5120,2800,0
7375300100,20141124T000000,400000,3,1.5,1510,7642,1510,0
7974200457,20150122T000000,935000,5,3,2700,5001,2700,0
923059206,20140715T000000,374000,4,1.75,2220,15600,1140,1080
782700150,20140609T000000,328000,3,1.75,1440,45302,1440,0
2144800146,20140826T000000,257500,3,2,1300,9334,1300,0
1337800220,20140908T000000,1.00E+06,4,2.5,2230,3600,1630,600
3530410081,20140626T000000,216500,2,1.75,1390,4482,1390,0
1525059198,20140521T000000,1.19E+06,3,2.25,2760,40946,2760,0
8665000040,20140730T000000,360000,4,2.5,3200,7282,3200,0
5016001619,20150122T000000,699999,3,0.75,1240,4000,1240,0
826069184,20141002T000000,535000,3,2.5,1960,47044,1960,0
123039147,20150319T000000,464950,3,2,2190,19800,2190,0
8089510150,20141202T000000,925000,4,2.5,3540,18168,3540,0
8818400450,20140508T000000,930000,3,3.25,2640,4080,1840,800
6324000115,20140922T000000,727500,3,2,2660,5000,1940,720
1133000694,20150312T000000,325000,4,1.75,1670,9500,1670,0
4441300325,20140905T000000,695000,3,3.25,3080,12100,2080,1000
3288301010,20140625T000000,585000,4,2.75,2890,6825,1560,1330
8125200481,20140926T000000,319000,3,2.25,1800,9597,1200,600
8857600540,20150106T000000,265000,6,2.5,2000,7650,1790,210
1901600090,20140626T000000,359000,5,1.75,1940,6654,1940,0
1901600090,20150426T000000,390000,5,1.75,1940,6654,1940,0
9144300120,20150128T000000,374500,3,1,960,9531,960,0
3401700031,20140822T000000,661000,2,1.5,1750,46173,1750,0
5332200375,20141203T000000,900000,3,2.5,2320,5000,1620,700
8582400015,20150413T000000,600000,5,2.5,2380,8204,1540,840
4131900042,20140516T000000,2.00E+06,5,4.25,6490,10862,3940,2550
3964400120,20150508T000000,512500,4,1.75,1620,4240,1620,0
2212600040,20140604T000000,229500,3,1.75,1770,33224,1770,0
8562750300,20140731T000000,589000,3,2.5,2320,5663,2320,0
2705600067,20150323T000000,539950,3,2.5,1330,2183,1330,0
3023049143,20141020T000000,640000,4,2.5,3420,21344,3420,0
8944300110,20150108T000000,218250,3,1,1270,7344,970,300
7277100395,20150225T000000,675000,4,3.5,2550,3600,1880,670
9407001830,20140717T000000,338000,5,2,1860,9000,1860,0
4406000620,20150331T000000,231750,3,1,1020,7615,1020,0
2414600366,20141114T000000,199900,1,1,720,7140,720,0
98000870,20141001T000000,1.06E+06,4,3.5,4460,16271,4460,0
9211500230,20141002T000000,263000,4,2.75,1830,7315,1250,580
3600600065,20140820T000000,279950,3,1.5,1520,7200,1160,360
7177300090,20140520T000000,395000,3,1.5,1080,2940,1080,0
6664900410,20140626T000000,252500,3,2,1900,8002,1900,0
1853000530,20150312T000000,1.15E+06,4,3.75,5300,37034,5300,0
3751604653,20140826T000000,205000,3,1,1370,10708,1370,0
8563001130,20140828T000000,654000,5,2.5,2960,8968,1640,1320
1324079029,20150317T000000,200000,3,1,960,213008,960,0
1236300214,20140722T000000,700000,3,2.5,2190,7982,2190,0
2525049086,20141003T000000,2.72E+06,4,3.25,3990,18115,3990,0
8822900115,20141209T000000,306000,2,1.75,1200,2622,800,400
3832080610,20150406T000000,270000,3,2.5,1780,5015,1780,0
1657300450,20141029T000000,340000,3,2.25,2630,9916,2630,0
1151100035,20140611T000000,450000,4,2.5,2300,19250,2300,0
3876311490,20140724T000000,580000,4,2.75,3210,6825,1810,1400
9297300590,20141103T000000,435000,4,1.75,2290,4400,1290,1000
3260350100,20140818T000000,690000,4,2.5,2780,4688,2780,0
3886902615,20140617T000000,720000,4,2.5,2650,11520,2110,540
2193300620,20150217T000000,403000,3,2.25,1840,13020,1390,450
7016100120,20140612T000000,440000,3,2.75,1560,7392,1030,530
8857600220,20141023T000000,178500,3,1,1200,8470,1200,0
1645000580,20141002T000000,270000,4,2.5,1900,8282,1900,0
4337600205,20141112T000000,129888,2,1,710,9900,710,0
1545805730,20150218T000000,260000,3,1.75,1360,15210,1360,0
8650100120,20140829T000000,339950,5,2.5,2990,7292,2990,0
4047200820,20140822T000000,250000,3,1,1640,26127,1640,0
1822059156,20150114T000000,680000,3,3.5,3650,103672,2050,1600
8812401450,20141229T000000,660000,10,3,2920,3745,1860,1060
1854750090,20140716T000000,1.23E+06,3,3.5,3680,11491,3680,0
6071200455,20140523T000000,550000,3,2,1830,9152,1830,0
6790200110,20150102T000000,675000,5,2.75,2570,12906,2570,0
6710100131,20150410T000000,981000,3,3.25,2730,9588,1900,830
8856004415,20150325T000000,168000,3,1,1150,8000,1150,0
3276940100,20140522T000000,1.00E+06,4,3,4260,18687,4260,0
9407100300,20150401T000000,320000,3,1,1260,9600,1260,0
1224049095,20150204T000000,959000,6,3.25,4440,17424,2220,2220
7899800586,20150409T000000,372000,4,1,2300,7680,1270,1030
2607730110,20140707T000000,391500,3,2.5,1920,9625,1920,0
1781500180,20150327T000000,390000,2,1,1080,4725,1080,0
2341800195,20141106T000000,302000,2,1,890,5000,890,0
52000067,20141103T000000,495000,3,3.5,1650,1577,1100,550
1972202023,20140904T000000,504500,3,2.5,1820,1545,1640,180
2919700540,20150318T000000,555000,4,1.75,2320,4800,2170,150
6613000375,20150317T000000,1.55E+06,4,3.5,3260,5000,2630,630
2391600735,20140909T000000,550000,3,1.5,1730,5750,1250,480
1337300145,20140721T000000,1.80E+06,4,2.5,3320,8325,3320,0
9164100035,20150429T000000,655000,1,1,1660,5422,830,830
821069025,20150213T000000,685000,3,2.5,3290,90796,3290,0
1566100555,20150501T000000,721000,4,2,2280,8339,1220,1060
2397100705,20140714T000000,1.52E+06,4,4.25,3650,5328,2330,1320
822069066,20150223T000000,365000,4,2.5,1620,219542,1620,0
3834000820,20140613T000000,458000,3,2,2020,8555,1220,800
1432700880,20150409T000000,280000,2,1,1150,12861,1150,0
3658700395,20150409T000000,628000,4,1.75,1940,3060,1000,940
1564000410,20150218T000000,781500,4,2.5,3440,6332,3440,0
984100450,20140624T000000,295000,3,1.75,2000,7560,1300,700
4449800063,20150403T000000,435000,2,1,750,2786,750,0
7694600201,20150322T000000,300000,3,1.75,1420,7200,1000,420
844001145,20150326T000000,208500,2,1,880,4814,880,0
8682281960,20140603T000000,930000,2,2.5,2680,11214,2680,0
1604600790,20150211T000000,316000,2,2,860,3000,860,0
1796380330,20140623T000000,249900,3,2,1310,6738,1310,0
3416600490,20140731T000000,675000,3,2.25,1780,4252,1540,240
3904901520,20141030T000000,447000,3,2.25,1440,4667,1440,0
1556200155,20150417T000000,675000,3,2,1510,3817,1510,0
567000401,20150421T000000,546000,4,2.5,2100,1397,1580,520
6450300673,20141231T000000,310000,3,2,1310,1361,1310,0
4440400155,20150106T000000,190000,3,1,1280,5100,880,400
2450000165,20140618T000000,650000,3,1.5,1320,8114,1320,0
9828701605,20141002T000000,585000,3,2.5,1740,2350,1130,610
856000985,20141106T000000,1.43E+06,4,2.5,2910,7364,2910,0
7504100360,20150112T000000,565000,4,2.5,2500,12090,2500,0
7883606725,20141111T000000,174900,3,1,1100,6000,1100,0
2926049564,20140924T000000,360000,3,2.25,1381,1180,1381,0
7418700040,20150429T000000,234000,3,1,960,9624,960,0
3756900027,20141125T000000,575000,8,3,3840,15990,2530,1310
7237300610,20150303T000000,315000,3,2.5,2200,5954,2200,0
1312900180,20150325T000000,225000,3,1,1250,7820,1250,0
3824100211,20140626T000000,370000,3,1.5,2380,14500,1850,530
455000395,20140523T000000,606000,3,1,1500,3920,1000,500
2472950120,20140603T000000,272500,3,2,1410,7622,1410,0
7977201709,20150323T000000,475000,3,1.75,1680,3420,960,720
5095400040,20140605T000000,270000,3,1,1500,13500,1500,0
2324039152,20140818T000000,624000,4,1.75,2710,9216,1440,1270
1442300035,20140702T000000,355000,3,1.75,1730,7416,1730,0
6145601725,20141104T000000,345000,3,1,960,3844,960,0
7137950210,20141120T000000,342000,4,2.5,2380,7792,2380,0
2720069019,20141103T000000,316000,3,1.75,1120,98445,1120,0
1560920040,20140731T000000,539950,4,2.5,2960,37430,2960,0
7812801785,20150218T000000,221347,3,2,1580,6655,790,790
8860500300,20140718T000000,330000,3,2.5,1870,4657,1870,0
6142100090,20140718T000000,279000,4,2.5,1810,13000,1470,340
4083302225,20141014T000000,850000,4,3,2550,3784,1750,800
2591700037,20150212T000000,746000,3,1.75,1910,12321,1100,810
5458300580,20141001T000000,478000,2,2,1200,1867,600,600
3362400650,20150116T000000,820000,4,2.75,2420,4635,2420,0
5553300375,20140820T000000,2.16E+06,3,3.5,3080,6495,2530,550
2024059111,20141023T000000,820000,3,3,3850,38830,3850,0
6649900090,20150418T000000,887000,3,2,3000,22040,2470,530
3356403400,20140724T000000,159000,3,1,1360,20000,1360,0
2771604190,20140617T000000,824000,7,4.25,3670,4000,2800,870
6638900265,20140925T000000,812000,4,2.5,2270,5000,2270,0
8731960540,20141215T000000,242000,4,2.5,1750,11400,1750,0
7853301400,20140520T000000,625000,4,2.5,3550,8048,3550,0
123039176,20141212T000000,399888,4,1,2370,30200,1570,800
4178500150,20140922T000000,289000,3,2.25,1670,6600,1670,0
7702600930,20140804T000000,400000,3,2,1860,12944,1860,0
3892500150,20140521T000000,1.55E+06,3,2.5,4460,26027,4460,0
6021500970,20140528T000000,345000,2,1,1080,4000,1080,0
6021500970,20150407T000000,874950,2,1,1080,4000,1080,0
9136100056,20140528T000000,875000,3,2.75,2280,4280,1280,1000
205000120,20150310T000000,628990,4,2.5,2540,32647,2540,0
3019300090,20140723T000000,535000,2,3.5,2560,5000,1280,1280
5492200090,20141007T000000,770126,4,2.75,2390,9300,1430,960
1777600900,20140710T000000,710000,4,2.5,2870,8995,1870,1000
9297301050,20140618T000000,465000,3,1.75,1510,4800,860,650
5745600040,20140814T000000,359000,3,1.75,2200,11520,2200,0
2114700090,20150301T000000,151000,2,0.75,720,5040,720,0
2597530650,20140815T000000,820000,3,2.5,2970,9600,2970,0
1099600620,20150326T000000,160000,3,1.5,960,6497,960,0
3693901720,20140701T000000,535000,4,1.75,1420,5000,1420,0
7417100123,20150423T000000,365000,3,2.25,1800,9010,1300,500
8691410730,20150220T000000,708000,4,2.5,3090,5600,3090,0
3832300090,20140709T000000,215000,3,1,1200,7280,1200,0
2525049113,20140725T000000,1.95E+06,4,3.5,4065,18713,4065,0
1523059103,20140926T000000,390000,4,2.5,2570,22215,2570,0
3187600100,20140513T000000,570000,3,2,1530,5401,1530,0
1628700107,20140625T000000,383000,3,1.75,1500,13430,1500,0
1152700120,20150409T000000,370000,4,3,2490,5706,2490,0
808300180,20150211T000000,454000,4,2.5,3040,12522,3040,0
3585300194,20150324T000000,1.40E+06,5,3.25,4140,32700,2190,1950
3342700610,20140728T000000,371000,4,1.75,1690,10854,1690,0
7376300085,20150505T000000,530000,3,1.75,1430,10350,1430,0
6204000040,20140610T000000,608000,4,2.75,2490,9714,1400,1090
3992700475,20141111T000000,450000,3,1.75,1350,7200,1350,0
9510920120,20140730T000000,780000,4,2.5,3140,14421,3140,0
9485920120,20140829T000000,290000,4,2.5,2340,52272,2340,0
1685200110,20140916T000000,225000,3,1.75,1610,14182,1100,510
7574910650,20140911T000000,805000,4,2.5,3320,38032,3320,0
4178600040,20150407T000000,660000,3,2.5,2390,15669,2390,0
3793700210,20140613T000000,299000,3,1.75,1180,13927,1180,0
1972200325,20140919T000000,530000,2,2.25,1260,1312,1260,0
7010701383,20141017T000000,680000,3,2.5,1800,4400,1350,450
3353401340,20150216T000000,199900,4,1.75,1790,12000,1790,0
3352401037,20150108T000000,224000,3,1.75,1760,6300,1060,700
8802400906,20140829T000000,244000,3,1.75,1540,8885,1440,100
4443800940,20150408T000000,485000,4,1.75,1260,3880,860,400
2215450100,20150112T000000,330000,4,2.5,2240,7589,2240,0
8900000100,20141231T000000,509000,4,2,1630,1724,1030,600
8079010220,20141117T000000,440000,4,2.5,2350,7203,2350,0
8078050120,20141210T000000,244000,3,2,1350,8587,1350,0
1773101215,20140717T000000,399700,4,1.75,1320,4800,870,450
2768100205,20140625T000000,519000,4,2.5,1950,2617,1250,700
5537200043,20140508T000000,211000,4,1,2100,9200,1050,1050
868000905,20140708T000000,950000,3,2.5,3480,7800,1750,1730
8635760490,20140902T000000,410000,3,2.5,1830,2839,1830,0
3052700245,20150325T000000,750000,4,2,2640,5000,2040,600
9320901250,20140910T000000,133400,3,1,900,2550,900,0
2420069042,20150424T000000,240000,3,2,1553,6550,1553,0
6870300090,20140604T000000,539000,3,2.5,1710,2300,1570,140
1223089066,20140814T000000,688000,4,3,3400,292723,3400,0
7974200937,20140513T000000,465000,3,1.5,1270,5112,1270,0
2998300146,20140617T000000,936000,3,1.75,2960,12420,1480,1480
7202290650,20141230T000000,620000,4,2.5,3040,9606,3040,0
1326039061,20141020T000000,429950,3,1.75,1430,9750,1430,0
4142450330,20140707T000000,296475,3,2.5,1520,4170,1520,0
6139100076,20150427T000000,330000,4,2,1820,9450,1100,720
8126300360,20140730T000000,445000,3,2.25,1800,11200,1270,530
1231000645,20140801T000000,846000,4,3.25,2720,4000,2070,650
8149600265,20150514T000000,725000,4,1.75,1980,5850,1380,600
9264950410,20150504T000000,369000,4,2.5,2550,7349,2550,0
9541800065,20140609T000000,625000,3,1.75,2210,16200,1390,820
7202330790,20140618T000000,535000,3,2,2120,4080,2120,0
7335400065,20141218T000000,229950,4,1.5,1570,6717,1570,0
1313500090,20150423T000000,229999,3,1.75,1310,6960,1310,0
1797500600,20140825T000000,850000,5,3.5,3150,4120,2460,690
5561301220,20140610T000000,589900,4,4.5,3870,35889,2530,1340
5700002165,20141030T000000,513000,2,1,1840,4322,1160,680
9202650040,20140926T000000,401000,3,1,1120,8321,1120,0
7211401975,20140905T000000,260000,3,2.5,1440,2500,1440,0
126039394,20150508T000000,525000,4,2.75,2300,26650,2300,0
3204800150,20150320T000000,470000,3,3.5,2070,11658,1370,700
7686204750,20150121T000000,205000,4,1.5,1420,8063,940,480
7524950900,20150210T000000,620000,3,2.25,2010,7495,1570,440
7211400850,20140811T000000,229000,3,1.5,1200,5000,1200,0
8024202520,20140509T000000,445000,2,2,1150,6634,860,290
7340600068,20140514T000000,215000,2,1,1240,7200,1240,0
8682260850,20140729T000000,504975,2,2.5,1900,4871,1900,0
6804600720,20140801T000000,495000,4,2.25,2350,10072,2350,0
1865820300,20150311T000000,205000,3,1,1120,8342,1120,0
3163600076,20140730T000000,152275,1,1,1020,6871,1020,0
5418500650,20150325T000000,586000,4,2.25,1930,8338,1930,0
8682220230,20141017T000000,779950,2,2.5,2680,7625,2680,0
3578401210,20141218T000000,557000,4,1.75,2660,11315,2660,0
9122001225,20141029T000000,610000,4,2.25,2200,7200,1220,980
5667100025,20140708T000000,405000,3,1.5,1010,7683,1010,0
5089700750,20140509T000000,320000,4,2.25,2310,7490,2310,0
3331500650,20140919T000000,356000,3,1,920,3863,920,0
9528102865,20150226T000000,794500,5,3,3030,4120,1930,1100
6928000590,20140508T000000,349000,3,1.75,1590,9620,1590,0
1423069162,20140604T000000,549000,4,2.25,2740,88426,2740,0
7877400245,20140718T000000,193000,3,1,960,10761,960,0
7430500301,20141016T000000,700000,3,1.5,2240,7227,1440,800
7852010900,20150324T000000,523000,3,2.5,2400,6182,2400,0
4022900652,20141118T000000,565000,5,3.25,2860,20790,1800,1060
7852030790,20150505T000000,500000,4,2.5,2960,5027,2960,0
3528900330,20140707T000000,1.45E+06,4,3.25,3770,4103,2710,1060
2623069106,20150219T000000,710000,6,3.5,3830,68825,3830,0
88000173,20141015T000000,333000,4,2,2750,9001,2750,0
3179102305,20140717T000000,580000,3,1.75,2100,6874,1300,800
5379803386,20140801T000000,289950,4,1.75,1500,8400,1200,300
8127700845,20150219T000000,375000,2,1,710,4618,710,0
8562901010,20140926T000000,505000,2,3,2770,10800,1910,860
4058200915,20140721T000000,324950,3,1.75,2050,6720,1050,1000
8861700110,20140714T000000,490000,4,2.25,1960,10275,1960,0
6822100155,20140512T000000,630000,4,2,1770,6000,1770,0
3345700215,20140620T000000,595000,3,2.75,3290,22649,3290,0
582000644,20150501T000000,872500,4,2,1990,6000,1260,730
6126601380,20150222T000000,490000,2,1,1760,5250,1000,760
3303850330,20141216T000000,1.90E+06,4,3.25,5080,27755,5080,0
3343902281,20150505T000000,310000,2,1,1020,8102,1020,0
2023059052,20150504T000000,450000,3,1,1350,92721,1200,150
7504001430,20141023T000000,539000,3,1.5,1740,12000,1740,0
9290850330,20140707T000000,888550,3,2.5,3540,38322,3540,0
7955080300,20140714T000000,269950,3,2.5,1520,8720,1080,440
3980300371,20140926T000000,142000,0,0,290,20875,290,0
3755100220,20140819T000000,300000,3,1.75,1310,9761,1310,0
3425059076,20140922T000000,780000,2,3.25,3000,24004,2410,590
8728550150,20140715T000000,545000,3,2.5,2660,20369,2660,0
2108500110,20150415T000000,278000,3,2.25,2120,9804,2120,0
7941130110,20141201T000000,342000,3,2.25,1200,2845,1200,0
1545807180,20150506T000000,190000,4,1.75,1900,9861,1900,0
1972200382,20141121T000000,387000,2,1.5,1010,948,1010,0
2473420100,20150304T000000,279950,3,2.25,1850,7480,1850,0
722059020,20150318T000000,550000,6,4.5,4520,40164,3580,940
1626079154,20140520T000000,439000,3,2,2010,251341,1510,500
1152000040,20141010T000000,774888,3,2.25,2420,23507,2420,0
5152960330,20140610T000000,480000,5,2.5,2732,9500,1870,862
6431000206,20140508T000000,835000,4,2,1910,6960,1910,0
2397101185,20150303T000000,1.50E+06,5,3.5,3520,5400,2400,1120
2922700865,20150326T000000,771000,4,2,2220,3760,1370,850
3271800870,20140807T000000,1.23E+06,4,2.25,2020,5800,1760,260
1562200090,20141017T000000,600000,4,2.5,2090,7290,1420,670
1431700210,20140702T000000,305000,3,1,1580,7424,1010,570
2566300100,20150327T000000,1.39E+06,5,1.75,2650,11340,2650,0
5379806155,20140910T000000,216500,3,1,1020,11652,1020,0
952006857,20150122T000000,370000,3,2.5,1070,1219,720,350
3792400110,20140630T000000,492650,4,1.75,2120,9786,1640,480
3755100540,20140725T000000,431200,5,1.75,1360,10609,1060,300
2122059014,20150409T000000,277500,4,2,1700,12048,1700,0
110000040,20150317T000000,278000,5,1.5,1820,8712,1090,730
3876800580,20140902T000000,351000,4,1,1430,8400,730,700
3127200021,20140616T000000,850000,4,3.5,4140,7089,3160,980
2397101460,20140811T000000,885000,2,2,1313,3600,1313,0
1720069146,20140715T000000,399950,3,2,1590,87120,1590,0
7878400043,20140805T000000,185000,3,1.75,1080,9262,1080,0
9282801030,20140925T000000,440000,5,3,2730,6000,1470,1260
6072800265,20140813T000000,2.40E+06,4,3.25,3800,19798,3800,0
5267000180,20140821T000000,299000,3,2.25,2540,9961,1320,1220
2722049077,20140828T000000,299500,3,1.75,1810,34500,1230,580
1115100278,20150317T000000,420000,3,1.5,1540,7506,1540,0
8075400530,20140627T000000,234000,4,1,1390,18000,1390,0
1997200245,20140714T000000,540000,2,1.75,1460,4800,850,610
926069009,20140609T000000,649950,4,2.5,2350,63162,2350,0
6381500110,20150108T000000,330000,3,1,1160,7912,1160,0
7203100850,20150427T000000,840000,4,3.25,3500,5960,3500,0
3529300330,20141107T000000,370000,3,2.5,1980,6922,1980,0
3204800330,20140625T000000,410000,3,1.5,1250,7700,1250,0
6411600411,20141209T000000,257000,2,1,770,7200,770,0
8685500145,20141230T000000,350000,3,1,1920,6710,1320,600
7277100610,20140825T000000,380000,2,1,1120,7560,1120,0
1775800750,20150310T000000,344000,3,1,1150,12402,1150,0
2856101105,20140527T000000,488000,3,2.5,1590,2550,1590,0
4443800705,20141008T000000,465000,3,1,910,3880,780,130
3878900464,20150504T000000,229500,2,1.75,1870,6625,960,910
8151600900,20141112T000000,445000,5,3,2420,11250,2420,0
1612500155,20150317T000000,246000,4,1.5,2120,7110,2120,0
4140500180,20140604T000000,545000,5,2.5,2730,17240,1660,1070
3342103174,20140813T000000,518000,4,2.5,2560,5672,2560,0
2078500210,20141031T000000,565000,4,2.5,2620,10016,2620,0
3955900910,20150410T000000,445000,4,2.5,2760,8558,2760,0
3472800068,20140717T000000,968000,5,2.5,2900,9799,1450,1450
8928100205,20150331T000000,725000,3,2,1820,6324,910,910
2473400110,20140826T000000,315500,3,1.75,1870,8400,990,880
2558720120,20140505T000000,487585,4,1.75,2010,9211,1470,540
2023049361,20150323T000000,246500,2,1,940,6000,940,0
6821101285,20140814T000000,819000,3,1.75,1850,6000,1650,200
2780910100,20141218T000000,349900,5,2.5,2530,4229,2530,0
9357000230,20140822T000000,267000,3,1,940,4700,940,0
3649100015,20150513T000000,480000,3,2.25,1820,15000,1480,340
1189000180,20140910T000000,525000,2,1,1510,3360,880,630
3905120610,20140625T000000,578000,4,2.5,2070,5415,2070,0
993002177,20150506T000000,345000,3,2.5,1380,1547,1380,0
6384500535,20150326T000000,499000,3,1,1270,6250,910,360
7751800115,20140826T000000,425000,3,1.5,1390,9680,1390,0
4137020820,20141027T000000,268000,4,3,1840,7510,1840,0
9407000230,20141204T000000,240000,3,1,1600,12566,1600,0
3306200230,20150303T000000,147000,3,1.5,1480,9606,1100,380
3888100176,20150306T000000,500000,4,2,2120,7806,1770,350
7011201325,20141028T000000,1.01E+06,4,2.75,2940,5400,1940,1000
1424130220,20150309T000000,991500,4,3,3820,26895,3820,0
9165100375,20141118T000000,510000,5,2,2740,3838,1370,1370
1651500040,20140801T000000,1.98E+06,4,4,4360,12081,4360,0
8929000090,20140702T000000,484998,4,2.5,1540,1870,1540,0
3303850360,20140625T000000,1.28E+06,4,3.5,4660,17398,4660,0
2011000120,20140529T000000,210000,3,1.75,1590,7617,1590,0
6751100205,20140804T000000,450000,2,1,1180,10720,1180,0
5078400035,20150402T000000,875000,4,1.75,2360,8286,1320,1040
6073300530,20150428T000000,529950,4,2.75,1860,7500,1220,640
9818700645,20140723T000000,415000,3,1.75,1470,4000,1070,400
6181700625,20150220T000000,590000,4,2,2990,12970,1960,1030
8718500610,20140526T000000,379950,3,1.5,1690,9144,1140,550
7950302150,20150410T000000,385000,1,1,660,3570,660,0
923000115,20141029T000000,588000,3,1.75,2310,7620,2310,0
1722800835,20140811T000000,252500,2,1,770,2191,770,0
7436300180,20140519T000000,530000,3,3.5,2320,3174,2060,260
1630700276,20150105T000000,385000,2,1.5,1370,159865,1370,0
2558670110,20140829T000000,419000,3,2.25,1700,7650,1340,360
402000110,20141017T000000,175000,2,1,960,5508,770,190
442000175,20150331T000000,515000,2,1,1150,5664,870,280
8825900410,20150218T000000,945000,4,2.5,2910,4680,1850,1060
984210120,20140620T000000,359900,5,2.25,2290,7420,1290,1000
8044050040,20140807T000000,419950,4,2.5,2260,5164,2260,0
2771604370,20140926T000000,460000,3,1.75,1300,4000,900,400
5028602020,20150305T000000,255000,3,2.25,1850,7151,1850,0
643300040,20141104T000000,481000,4,1.75,1920,9500,1470,450
643300040,20150313T000000,719521,4,1.75,1920,9500,1470,450
224059025,20140620T000000,1.08E+06,3,3,4910,43560,4000,910
3379200100,20140523T000000,334000,4,2.5,2210,6080,1410,800
6338000493,20140912T000000,675000,4,2.75,2280,3200,1520,760
293000068,20140613T000000,556000,3,1.75,1640,7437,1090,550
6169901095,20140815T000000,900000,4,2,1980,7200,1700,280
4443800375,20141002T000000,400000,3,1,900,4084,900,0
9376301800,20150324T000000,724950,4,1.75,1960,4340,980,980
6799300150,20140903T000000,321000,4,2.25,1800,4500,1800,0
3271800910,20140701T000000,1.36E+06,4,3.5,4270,5800,3170,1100
42000245,20140613T000000,171000,4,2,1520,19672,1020,500
1625069101,20140707T000000,1.36E+06,4,3,5430,108900,5430,0
4046700110,20150224T000000,323000,3,1.75,1950,15037,1950,0
2423600100,20140502T000000,491500,4,1.75,2190,125452,2190,0
621069154,20140721T000000,226000,4,1.5,1200,10890,1200,0
2436200025,20141009T000000,580000,6,1.75,2180,4000,1380,800
9808610410,20140822T000000,640000,4,2.5,2320,11259,2320,0
1370803640,20140820T000000,619790,3,1.75,1040,5097,800,240
3779300210,20140630T000000,383962,4,2.5,2700,6998,2700,0
424049059,20140815T000000,373000,3,2,1400,2445,840,560
5422560850,20141210T000000,541338,3,2.5,2060,8123,1010,1050
558100065,20141003T000000,254922,2,1,780,8160,780,0
4442800040,20140624T000000,575000,3,2.25,2400,5000,1440,960
4038600300,20140902T000000,650000,4,3,2900,15535,1870,1030
5070000120,20140813T000000,269950,3,1.5,1740,9547,1740,0
795002450,20150430T000000,270950,2,1,780,6250,780,0
3579000180,20141229T000000,495000,3,2.75,2430,14861,1530,900
6821102170,20140507T000000,794154,4,2,2210,8556,1210,1000
5151900110,20141219T000000,340768,3,1.5,1510,11200,1510,0
5101407790,20140801T000000,375000,2,1,900,5413,900,0
2538400040,20140524T000000,820000,4,2.5,3670,7000,3670,0
1025049266,20140930T000000,555000,2,2.25,1160,954,960,200
4340610040,20140612T000000,312500,2,1.5,1070,1200,1070,0
3204300610,20141202T000000,450000,2,1,950,4560,950,0
6793300220,20150105T000000,739000,3,2.75,2950,6667,2950,0
1568100087,20150413T000000,320000,3,2,1420,1716,1050,370
4338800600,20140609T000000,235000,3,1,1590,13000,1590,0
7211400535,20150323T000000,275500,4,1,1290,5000,1290,0
8682261140,20140618T000000,564000,2,2,1690,4500,1690,0
4435000145,20150501T000000,263000,4,1.75,1340,8700,1340,0
421059018,20141104T000000,257000,3,1.75,1397,18000,1397,0
1321059013,20150319T000000,725000,4,2.5,3750,218506,3750,0
2143700406,20141211T000000,300000,3,2.25,2000,7560,1400,600
8961950410,20140707T000000,328000,3,2,2250,7904,2250,0
1788800770,20140728T000000,187500,3,1,840,8400,840,0
7518507685,20150223T000000,400000,3,1,1100,5100,1100,0
2490200220,20150302T000000,515000,3,1.5,1660,5100,1210,450
284000025,20150420T000000,1.41E+06,2,2,2180,18525,1580,600
522059189,20150417T000000,235000,3,1,1460,8400,1460,0
7203150330,20140717T000000,669000,4,2.5,2470,4945,2470,0
3124089060,20150424T000000,282000,3,1,1250,13503,1250,0
7518504130,20140626T000000,663000,3,2,1480,3876,860,620
7893802670,20150424T000000,279900,3,3.25,2240,5000,1540,700
2548100180,20140507T000000,335000,3,2,1570,7200,1570,0
4024100915,20141231T000000,689000,4,2.75,3250,10000,3250,0
1026069106,20150421T000000,413100,3,2.25,1790,231303,1250,540
7852020720,20150327T000000,506950,3,2.5,2080,4931,2080,0
9828702265,20140506T000000,500000,3,2.5,1480,1171,1480,0
5104511250,20140613T000000,540000,5,3,3610,9775,3610,0
9828201885,20140822T000000,812000,3,2.5,2040,4559,2040,0
7525950110,20140828T000000,1.20E+06,4,3.25,3850,19842,3180,670
3211260120,20141215T000000,370000,3,2.25,3230,35306,3230,0
7250000065,20140825T000000,338000,3,2,2440,23512,1640,800
1446400564,20140507T000000,185000,4,1,1490,6600,1490,0
224059021,20141219T000000,450000,3,1,1150,35415,1010,140
6392000625,20140712T000000,451000,2,1,900,6000,900,0
6817850110,20150421T000000,785000,4,2.5,3210,24527,3210,0
3902100175,20140728T000000,850000,5,3,3900,5250,2620,1280
7205400180,20141223T000000,235000,3,1,1240,18000,1240,0
7351200295,20150114T000000,1.15E+06,3,1.75,1760,6788,1760,0
291310260,20140516T000000,377500,3,2.25,1410,1377,1290,120
3026059204,20140530T000000,825500,3,2.5,2780,11964,2780,0
2856102105,20140610T000000,1.06E+06,5,3.25,3230,3825,2480,750
3343301343,20141120T000000,880000,5,3.5,4600,8764,3180,1420
8682302030,20140521T000000,413800,3,2,1440,4421,1440,0
1048000160,20140627T000000,504200,2,1.5,1200,1687,1200,0
5714200140,20150422T000000,421500,4,3,2793,5703,2793,0
1152200030,20150305T000000,855169,4,2.5,2970,5050,2970,0
3157600075,20150207T000000,380000,3,2,1440,3218,850,590
1972200554,20140804T000000,580000,3,2.25,1480,1026,1480,0
9429400060,20150409T000000,377000,3,2.5,1870,5333,1870,0
301401610,20140930T000000,329900,4,2.75,2475,4000,2475,0
1025039326,20140828T000000,921800,4,2.5,2950,7024,2950,0
9385200041,20150304T000000,529500,3,2.25,1410,905,1410,0
7237450550,20140603T000000,363990,4,2.5,2240,3712,2240,0
2862500060,20150115T000000,834950,5,2.75,3230,6500,3230,0
4046500270,20140819T000000,399000,3,2,2100,31550,2100,0
2161400060,20141114T000000,338900,3,2.25,1936,9495,1936,0
2781230070,20150311T000000,419950,3,2.5,3120,6000,3120,0
4019500160,20150413T000000,493000,4,2.5,2070,4270,2070,0
6980500030,20141211T000000,650000,4,2.5,3700,4500,3700,0
1442880260,20140909T000000,456000,3,2.5,2130,5205,2130,0
9268851860,20140918T000000,425000,3,2.25,1620,997,1540,80
832700320,20150209T000000,348000,3,2.5,1490,2478,1490,0
2937300550,20141029T000000,1.04E+06,5,4,4180,7232,4180,0
2114700368,20141118T000000,299000,2,2.5,1400,1262,1160,240
2213000030,20140512T000000,1.26E+06,4,3.75,3490,9170,3490,0
2626119062,20141112T000000,155000,3,1,1300,6098,1300,0
7338220160,20150225T000000,319500,4,2.5,2730,4962,2730,0
2781280310,20141222T000000,274000,3,2.5,1830,2517,1830,0
3448740070,20140616T000000,429000,5,2.5,2340,4500,2340,0
2895800710,20141202T000000,267800,3,1.75,1410,1899,1410,0
723049434,20150408T000000,369950,3,2.5,1930,8254,1930,0
2922059212,20150109T000000,480000,6,5,3028,18055,3028,0
1441000350,20140915T000000,440000,4,3.5,3180,4869,2390,790
8562790310,20150324T000000,839704,4,3.25,2950,4161,2210,740
2767604425,20150129T000000,535000,3,3.25,1430,1276,1430,0
306000565,20140825T000000,290000,2,1.5,1020,1275,1020,0
6130500060,20140721T000000,370000,3,2.5,1650,1793,1650,0
3362400125,20150303T000000,405000,3,2,1060,651,1060,0
1442880510,20140530T000000,499431,4,2.75,2620,6019,2620,0
9188200505,20140710T000000,275000,4,2.5,1830,3868,1830,0
1865400075,20140522T000000,320000,3,2.25,998,844,798,200
7853320550,20140805T000000,425000,4,2.5,2070,4427,2070,0
9831200172,20150227T000000,1.45E+06,4,3.5,2860,2199,2860,0
8141300030,20150210T000000,340000,3,2,1920,5688,1920,0
7899800863,20141001T000000,299900,3,2.5,1210,2046,920,290
745530240,20141226T000000,865950,5,3.5,4890,12039,3590,1300
4055700784,20140815T000000,720000,4,2.5,3420,17038,3420,0
1180000830,20141002T000000,460000,4,3.5,2870,3225,2070,800
291310270,20141119T000000,375000,3,2.5,1600,2042,1600,0
1934800162,20150511T000000,386180,2,1.5,960,1829,960,0
2309710070,20150114T000000,280000,3,2.75,1740,5639,1740,0
6181500340,20140808T000000,359000,4,2.5,2575,4725,2575,0
7853220390,20140502T000000,785000,5,3.25,3660,11995,3660,0
9834201375,20150206T000000,425000,3,2.25,1420,1230,940,480
5214510060,20150504T000000,575000,5,2.5,3070,7200,3070,0
3221079050,20150303T000000,465000,3,2.5,1920,144619,1920,0
1266200140,20150506T000000,1.85E+06,4,3.25,4160,10335,4160,0
2523039346,20150218T000000,720000,4,3.25,3276,10801,3276,0
1624049293,20140506T000000,390000,5,3.75,2890,5000,1310,1580
1973700030,20150429T000000,2.21E+06,3,2.5,3430,10177,3430,0
1070000390,20140702T000000,1.05E+06,4,3.5,3390,3979,2610,780
2524059269,20140610T000000,915000,6,3.75,2930,14980,2930,0
1972200326,20150422T000000,562000,2,2.25,1300,1314,1300,0
3796000400,20141120T000000,349000,2,1.75,1250,1208,1040,210
321030070,20140814T000000,375000,4,2.5,2310,7800,2310,0
476000118,20141212T000000,479950,2,2.25,1360,1336,1360,0
2909310060,20150109T000000,319000,4,2.5,2020,5100,2020,0
832700240,20141003T000000,325000,3,1.5,1270,1067,1270,0
1442880570,20140821T000000,505657,4,2.75,2790,8092,2790,0
9542840060,20150305T000000,340000,4,2.5,2320,4142,2320,0
629650370,20150123T000000,250000,3,2.5,1750,6351,1750,0
7967000060,20140926T000000,349500,4,2.5,2030,4596,2030,0
3904100041,20150424T000000,290750,3,2.5,1270,865,1080,190
9268850860,20150505T000000,715000,5,3.25,2710,2356,2230,480
1454100127,20140811T000000,689950,4,2.75,2520,8433,2520,0
2856101290,20140924T000000,425000,2,2.5,1340,1263,1340,0
2767601872,20150119T000000,657000,2,3,1570,1281,1570,0
255370570,20141120T000000,359950,4,3.5,2690,5564,2690,0
301401370,20140731T000000,319900,4,2.75,2475,4276,2475,0
1604601804,20150416T000000,532000,3,3.75,2260,2050,1170,1090
6749700004,20150330T000000,291000,2,1,840,863,840,0
1806900499,20140721T000000,675000,3,3.25,1720,1330,1030,690
7625703435,20150121T000000,885000,3,2.25,2940,6500,2940,0
7324900016,20141021T000000,1.45E+06,5,3.5,4170,9090,4170,0
3575303430,20141016T000000,780000,6,4.25,4310,10000,2950,1360
9492500140,20140712T000000,839950,4,2.75,3010,7200,3010,0
9268851670,20150424T000000,645000,3,2.5,2170,1984,2170,0
301400830,20141223T000000,263000,3,2.5,1584,3200,1584,0
4310702918,20141030T000000,345000,2,2.25,1110,1290,1110,0
4305600240,20141125T000000,505000,4,2.5,2420,5006,2420,0
7169500200,20140903T000000,522500,2,2.25,1430,1210,1340,90
3943600070,20140811T000000,400000,3,2.5,2393,4788,2393,0
1048000060,20140619T000000,543000,3,2.25,1240,949,1240,0
3449500045,20141013T000000,495000,4,2.5,2980,12075,1910,1070
1438000200,20140911T000000,549995,4,3.5,2970,6587,2260,710
5424100030,20150211T000000,327555,3,2.5,2329,5720,2329,0
7853270710,20150409T000000,690000,5,3.25,3340,9075,2600,740
9161100075,20150318T000000,673000,4,2.25,2580,2875,2580,0
1085622860,20140721T000000,384435,3,2.5,2029,3906,2029,0
9578090240,20140815T000000,780000,4,2.75,3430,6500,3050,380
4083306045,20141029T000000,1.38E+06,5,3.75,3330,5042,2470,860
6666830320,20150324T000000,950968,5,3.5,3220,5081,3220,0
8562780160,20150329T000000,334950,2,2.25,1240,750,1150,90
2767704603,20140609T000000,489000,3,3.5,1500,1249,1240,260
5631500292,20150420T000000,600000,3,3,3530,8345,3530,0
2424039036,20140822T000000,282000,3,2.25,1260,915,1020,240
2867300030,20140801T000000,442000,4,4,4168,8485,3222,946
6661200260,20150512T000000,220000,2,1.5,1030,2850,1030,0
7238000240,20150218T000000,489000,3,2.5,3080,5598,3080,0
4051150070,20141223T000000,250000,3,1.5,1072,4339,1072,0
1442880320,20140724T000000,484259,4,2.75,2790,5000,2790,0
3616600003,20150302T000000,1.68E+06,3,2.5,4090,16972,3590,500
3862710030,20150424T000000,450000,3,2.5,1800,4357,1800,0
9828201361,20141114T000000,299000,2,1.5,830,1276,830,0
4019500030,20141029T000000,450000,3,2.5,2280,4557,2280,0
3630240140,20150123T000000,585000,4,3,2110,1286,1710,400
5695000270,20141103T000000,660000,3,2.25,1570,1680,1570,0
2349300069,20140512T000000,301500,2,1.5,830,1333,830,0
6790830060,20140915T000000,949950,4,3.75,4120,8258,4120,0
3630200640,20141030T000000,759990,4,2.5,2540,5760,2540,0
7967000160,20150316T000000,355000,4,2.75,2050,4000,2050,0
9492500160,20140723T000000,889950,4,2.75,3080,7242,3080,0
9268851740,20140701T000000,629800,3,2.5,2390,1984,2220,170
3342100421,20150424T000000,745000,4,2.5,3170,5100,3170,0
6362900138,20141103T000000,379900,2,1.5,1240,1331,1050,190
9358001422,20141114T000000,335000,3,2.5,1090,1139,960,130
7853280350,20140512T000000,809000,5,4.5,4630,6324,3210,1420
7853361420,20140826T000000,569950,4,2.5,3230,5899,3230,0
7852120030,20140808T000000,723000,4,3.5,3510,9263,3510,0
731500320,20141110T000000,282000,4,2.5,1785,2552,1785,0
6056100102,20141030T000000,569900,5,3.25,2360,3873,1990,370
1823049179,20150121T000000,385000,4,2,2340,9716,2340,0
9268850030,20140707T000000,420000,3,2.25,1620,1075,1540,80
9831200159,20140806T000000,2.25E+06,3,3.25,3890,3452,2890,1000
8924100370,20140915T000000,1.21E+06,4,3.5,3590,5335,3140,450
8669150700,20141208T000000,292000,4,3,1984,4460,1984,0
889000024,20150316T000000,645000,3,2.25,1640,1023,1640,0
9268850350,20150319T000000,304500,4,2,1350,942,1350,0
2619950310,20150507T000000,489500,4,3.5,2730,5707,2000,730
7430200060,20150424T000000,1.58E+06,4,4,5610,11063,4750,860
5100400251,20150106T000000,390000,2,1,962,1992,962,0
2597490030,20141002T000000,815000,4,3.5,3040,4006,2350,690
3655500030,20150403T000000,719000,3,3.5,2540,10578,2010,530
3751600784,20150403T000000,331210,4,2.5,2240,4800,2240,0
6781200013,20140507T000000,245000,3,1.5,1260,1270,1040,220
2619950060,20140909T000000,465000,5,4,3210,7200,2410,800
9523100731,20140930T000000,580000,3,2.5,1620,1171,1470,150
9272201318,20150414T000000,540000,3,2,1580,1972,1180,400
5676000004,20141118T000000,399000,3,2.5,1430,1250,1430,0
8091670070,20140804T000000,328000,4,2.5,1850,5388,1850,0
7853380570,20150511T000000,701000,4,2.5,3340,5314,3340,0
8091670200,20141022T000000,408000,3,2.75,2670,4800,2670,0
8084900160,20150212T000000,2.64E+06,5,4.25,4660,16200,4660,0
1498300875,20140814T000000,445000,3,2.5,1550,930,1060,490
7853270200,20141021T000000,672500,4,2.5,3470,6651,3470,0
9211010320,20140709T000000,538000,3,2.5,3010,7014,3010,0
2867300160,20140904T000000,450000,5,3.5,3931,9497,2650,1281
3278605570,20140619T000000,362500,3,2.5,1800,2700,1800,0
4310702858,20141015T000000,414950,3,2.5,1570,1551,1570,0
2838000030,20150127T000000,679950,3,2.5,2230,3939,2230,0
1673000240,20141112T000000,290000,4,2.5,2423,7292,2423,0
7899800791,20141023T000000,230000,3,2,1160,1174,790,370
8682320160,20150220T000000,439950,2,2,1440,4666,1440,0
8155870200,20140522T000000,349900,4,2.5,2052,3723,2052,0
2858600083,20141222T000000,550000,5,2.5,2780,9272,2780,0
2391601195,20150430T000000,1.05E+06,4,4.25,3720,5750,2960,760
976000903,20150319T000000,655000,2,2.25,1460,1851,1180,280
7904700128,20141110T000000,385000,3,3.5,1370,1540,1100,270
5609000311,20150410T000000,729999,6,4.5,3600,6110,2510,1090
1972201963,20140616T000000,523950,3,2.25,1420,1282,1420,0
9272201704,20140512T000000,369000,2,2.5,980,895,670,310
8648900060,20140505T000000,509900,3,2.5,1790,2700,1790,0
3832050890,20140715T000000,282000,3,2.5,2010,5399,2010,0
255450340,20140827T000000,387865,3,2.5,2370,4200,2370,0
2172000890,20141120T000000,385000,4,2.5,2560,6238,2560,0
6127010320,20140609T000000,536000,3,2.5,1900,6224,1900,0
2810100023,20140625T000000,395000,2,2.25,1350,1493,1050,300
8011100125,20141117T000000,545000,4,2.75,2650,6717,2650,0
7852090390,20150413T000000,715000,4,2.5,3020,7035,3020,0
3630080070,20140710T000000,348000,3,2.5,1500,2255,1500,0
9126100765,20140801T000000,455000,3,1.75,1320,1014,1320,0
7853380510,20140603T000000,575000,4,2.75,3120,7644,3120,0
993000136,20141007T000000,449950,3,2.25,1540,1270,1540,0
3278604510,20140625T000000,364000,3,2.5,1800,2790,1800,0
2937300060,20141201T000000,932990,4,2.5,3640,6389,3640,0
9510860060,20140627T000000,710000,3,2.5,2440,4153,2440,0
293070310,20150213T000000,949990,4,4,3970,7314,3970,0
255450400,20140731T000000,326989,3,2.5,2060,4200,2060,0
3845100140,20140708T000000,335606,3,2.5,2538,4600,2538,0
3758900075,20140507T000000,1.53E+06,5,4.5,4270,8076,3400,870
3395071610,20141126T000000,299950,3,2.5,1320,3150,1320,0
9477580030,20141014T000000,962000,4,2.75,3340,5700,3340,0
8138870060,20140813T000000,395825,2,2.5,1590,1679,1590,0
7237450030,20141014T000000,419354,5,2.75,2710,4500,2710,0
3767300041,20140826T000000,920000,4,2.75,3140,7258,3140,0
291310370,20140829T000000,366000,3,2.25,1445,1028,1300,145
7853361230,20140516T000000,480000,4,2.5,2430,5000,2430,0
7904700126,20141120T000000,388000,3,3.25,1370,915,1100,270
8085400376,20150421T000000,2.32E+06,4,3.5,5050,9520,3610,1440
9828702851,20150121T000000,730000,3,2.5,1860,1290,1240,620
8562710550,20140521T000000,950000,5,3.75,5330,6000,3570,1760
3278613210,20140728T000000,358990,3,3.25,1710,2171,1400,310
7694200340,20141016T000000,398651,4,2.5,2650,4120,2650,0
1839500055,20141114T000000,530000,4,2.5,2590,7891,2590,0
3448900320,20140723T000000,610360,4,2.5,2610,5562,2610,0
9267200226,20140502T000000,436110,3,2.5,1770,1235,1600,170
2895730070,20140620T000000,925000,4,2.75,3730,8014,3730,0
2970800105,20150313T000000,449950,4,2.5,2420,5244,2420,0
325059277,20140527T000000,760000,4,2.5,3330,7399,3330,0
6817750140,20140708T000000,293000,3,2.25,1910,3481,1910,0
8682320640,20150212T000000,695000,2,2.5,2170,7665,2170,0
8669180390,20140604T000000,285000,3,2.5,2437,5136,2437,0
4233600260,20141230T000000,1.26E+06,5,4,4180,12042,4180,0
3278611600,20140714T000000,379900,3,2.5,1800,2791,1800,0
7787920160,20150427T000000,472000,5,2.5,2570,7412,2570,0
2517101200,20140707T000000,300000,4,2.5,2090,5195,2090,0
6181420200,20141120T000000,272000,4,2.5,2789,3960,2789,0
3845100550,20141120T000000,418395,4,2.5,2906,5893,2906,0
7853321180,20141222T000000,465000,5,2.5,2550,6405,2550,0
7502800030,20140716T000000,659950,4,2.75,3550,9400,3550,0
3869900139,20150107T000000,484950,3,2.25,1590,926,1590,0
1332700200,20150426T000000,359000,3,2.25,1950,1968,1160,790
9211010260,20140617T000000,519000,4,2.5,3250,4500,3250,0
4100500070,20140527T000000,1.71E+06,5,4.5,4590,14685,4590,0
7708210070,20140617T000000,535000,4,2.75,3070,7201,3070,0
7853270520,20150409T000000,622950,4,3.25,3030,7644,2830,200
5126300060,20140811T000000,515000,3,2.5,2610,5845,2610,0
2517000260,20140522T000000,330000,4,3.5,3150,6202,3150,0
832700270,20150213T000000,318000,3,1.5,1240,983,1240,0
3022800260,20141007T000000,439000,3,2.5,1680,2801,1680,0
254000241,20150324T000000,540000,3,2.5,2220,5279,2220,0
7237501370,20140717T000000,1.08E+06,4,3.25,4800,12727,4800,0
662440030,20150326T000000,435000,4,2.5,3100,4699,3100,0
2524069078,20150122T000000,2.70E+06,4,4,7850,89651,7850,0
8895800200,20141017T000000,1.10E+06,4,2.75,3590,5625,3590,0
9268850160,20150206T000000,293467,4,2,1590,942,1590,0
7299600700,20150512T000000,328000,3,2.5,2242,4800,2242,0
291310340,20140708T000000,550000,3,3.5,2490,3582,1720,770
2768100510,20150402T000000,649000,3,2,1530,1442,1530,0
1776230060,20140708T000000,435000,4,2.5,2150,3143,2150,0
1772600510,20140620T000000,625000,3,2.5,2440,4800,2440,0
8024200677,20150429T000000,415000,3,1.5,1270,1483,1270,0
982850060,20140603T000000,400000,3,2.25,1450,4706,1450,0
7518506715,20140506T000000,979000,3,2.5,2690,4047,2690,0
7202280390,20150220T000000,625250,4,2.5,2755,4831,2755,0
710600160,20140909T000000,665000,4,3.5,2650,3474,2230,420
952005525,20140627T000000,589500,3,3.25,2310,3075,1730,580
2487700274,20150309T000000,437000,2,3,1460,1452,1140,320
3449000060,20141001T000000,320000,3,1,1400,9000,1400,0
7830800473,20150114T000000,333500,3,2.5,2196,7475,2196,0
6056100370,20141124T000000,430000,3,2.25,2020,2750,1680,340
2126059295,20140805T000000,995500,5,4.5,4280,8465,4280,0
1442880340,20140603T000000,427874,3,3,2340,5002,2340,0
7694200070,20140521T000000,334990,4,2.5,2220,4228,2220,0
8562710640,20150211T000000,909500,4,4,4420,5940,3410,1010
3832050860,20150319T000000,210000,3,2,1580,4961,1580,0
2526059225,20150123T000000,952990,4,2.75,3550,6558,3550,0
1972200139,20150218T000000,622500,2,1.75,1510,851,1420,90
2768100186,20140618T000000,515000,3,3.5,1360,1419,1040,320
6791400070,20150126T000000,350000,3,2.5,2040,13590,2040,0
424049284,20141016T000000,310000,1,1.5,1120,912,1120,0
7853280550,20140528T000000,700000,4,3.5,4490,5099,3390,1100
7768800270,20140715T000000,907687,4,2.5,3560,6786,2930,630
8682320350,20140709T000000,741500,2,2.5,2150,5760,2150,0
1776460140,20140724T000000,395000,3,2.5,2130,5088,1840,290
5045700400,20150223T000000,559950,5,2.75,2990,6370,2990,0
3356402702,20140725T000000,215000,4,2.5,1847,8000,1847,0
2140950160,20150222T000000,390000,4,2.5,2610,7227,2610,0
2621069017,20150303T000000,425000,3,2.25,1670,107157,1670,0
1422069070,20150507T000000,472000,3,2.5,1860,415126,1860,0
2579500181,20150407T000000,1.33E+06,4,3.5,3440,9776,3440,0
7852120140,20140610T000000,695000,4,3.5,3510,9364,3510,0
9274200324,20150120T000000,545000,3,2.5,1740,1279,1740,0
422000075,20140711T000000,389950,4,2.5,2240,5500,2240,0
263000253,20150330T000000,380000,3,2.25,1550,1485,1550,0
9268850140,20141117T000000,288790,4,2,1390,745,1390,0
9306500200,20150401T000000,432500,3,3,2500,6000,2500,0
8562770350,20141206T000000,615000,3,3.5,2710,3326,1650,1060
2026049326,20140707T000000,500000,3,2.5,1720,3012,1720,0
9126101090,20140531T000000,615000,3,2.25,1760,1146,1760,0
2888000030,20140926T000000,500000,4,2.25,2270,8196,1150,1120
8032700075,20141015T000000,622000,3,3.5,1690,1765,1370,320
7853440140,20150409T000000,802945,5,3.5,4000,9234,4000,0
1245003330,20140731T000000,1.26E+06,4,2.5,2880,9003,2880,0
1176001124,20150224T000000,598950,3,2.5,1480,1531,1480,0
7853360990,20150102T000000,430000,3,2.5,1950,4949,1950,0
7853320030,20141124T000000,515000,4,2.75,2700,5150,2700,0
7576200012,20140717T000000,1.26E+06,2,3,2210,3917,1500,710
7207900030,20140609T000000,400000,4,3.5,2370,3692,2370,0
952006827,20150422T000000,390000,3,2.5,1310,1254,850,460
7853321090,20141001T000000,450000,3,2.5,2410,4293,2410,0
1042700060,20140516T000000,804995,5,1.5,3360,5402,3360,0
2597490140,20150326T000000,825000,4,3.25,3040,4155,2350,690
7852130800,20140513T000000,435000,4,2.25,2140,6355,2140,0
7625702967,20140609T000000,398000,3,2.5,1720,1715,1240,480
3845100640,20140605T000000,411605,4,2.5,2658,3960,2658,0
1773100922,20141208T000000,315000,3,3.25,1480,983,1180,300
2770602493,20141120T000000,455000,2,2,1350,1209,1350,0
475000187,20150501T000000,452950,3,2.5,1150,1194,1020,130
6056100383,20140520T000000,380000,3,1.75,1690,1468,1380,310
6056111370,20141124T000000,340000,2,1.75,1270,1916,1270,0
9578500510,20141103T000000,409950,3,2.5,2655,5080,2655,0
9828701488,20150504T000000,360000,2,1,880,1165,880,0
6600000217,20150403T000000,1.60E+06,4,4.25,4645,7757,3855,790
8024200685,20140520T000000,440000,3,1.5,1270,1443,1270,0
2923039264,20140910T000000,730000,2,1.75,1728,95950,1728,0
8073900070,20140522T000000,408000,3,2.25,1950,7221,1950,0
2419700030,20140825T000000,820000,4,2.5,3170,3862,3170,0
9396700024,20140731T000000,360000,2,2.5,1233,1244,963,270
3845100160,20140620T000000,339990,3,2.5,2570,4600,2570,0
9126100814,20141008T000000,515000,3,2,1560,1020,1560,0
1982201595,20150121T000000,541000,3,1.75,1630,1166,1020,610
8151600973,20150406T000000,375000,4,2.5,2510,7245,2510,0
2722059322,20141020T000000,320000,4,2.5,2223,5780,2223,0
8562780090,20150227T000000,325000,2,2.25,1230,1058,1160,70
3346300356,20150318T000000,740000,5,2.75,3050,7520,3050,0
7237450600,20141030T000000,450000,5,2.75,2710,6220,2710,0
8944550100,20140723T000000,455000,4,2.5,2090,4400,2090,0
3438502437,20150203T000000,292500,3,2.5,1440,1068,1160,280
2423069039,20140806T000000,650000,3,2.5,2500,51836,1510,990
8011100047,20150306T000000,530000,4,2.75,2740,7872,2740,0
1042700300,20140804T000000,829995,5,3.25,3360,6120,3360,0
1776460110,20141223T000000,395000,4,2.75,2280,5013,2280,0
293070090,20140711T000000,859990,4,2.75,3520,5500,3520,0
7548301044,20140710T000000,342500,2,1.5,1320,826,1100,220
7203160090,20141205T000000,743000,4,2.75,3410,5838,3410,0
8096800110,20141215T000000,345000,3,2.25,2730,9388,1390,1340
3278600900,20141231T000000,443000,3,2.5,1780,2778,1530,250
4051150100,20140929T000000,260000,3,2.5,1427,4337,1427,0
925059311,20140722T000000,810000,4,2.5,2910,6555,2910,0
4305600100,20141222T000000,570000,4,2.75,3250,5600,3250,0
2311400195,20150303T000000,1.56E+06,5,3.5,3630,8100,3630,0
1732800194,20141113T000000,840000,2,2.5,1680,975,1680,0
5015001452,20150414T000000,950000,3,2.5,2280,2296,1890,390
7853430690,20150127T000000,572800,3,2.5,3310,4682,2380,930
3821700038,20141001T000000,305000,3,3,1290,1112,1290,0
5078400215,20140730T000000,1.70E+06,5,4.75,3940,7067,3230,710
1773100315,20140827T000000,445000,4,2.5,2170,6000,1630,540
2224069165,20140902T000000,801000,4,3.5,3290,8059,3290,0
9510861140,20140714T000000,711000,3,2.5,2550,5376,2550,0
3277801431,20140827T000000,268500,3,2.25,1140,977,850,290
1760650750,20141006T000000,320000,4,2.5,2300,3825,2300,0
1607100038,20140921T000000,500000,4,3.25,2670,5001,1640,1030
1862400176,20140505T000000,631625,4,2.5,2440,6651,2440,0
5457801833,20150127T000000,850000,2,2.5,1611,2210,1611,0
8562770110,20141027T000000,600000,3,3.5,2710,3290,1650,1060
2623039019,20140508T000000,988500,3,2.75,2015,16807,2015,0
9578500690,20150327T000000,430236,4,3.25,3444,5166,2714,730
711000110,20140915T000000,1.27E+06,3,2.5,3060,9576,3060,0
2597490750,20150428T000000,689500,4,2.5,2050,2772,2050,0
6056100165,20141201T000000,175003,3,1.5,1390,1882,1390,0
2767603824,20140915T000000,459000,2,2.5,1240,1249,1240,0
7237550110,20150424T000000,1.18E+06,4,3.25,3750,74052,3750,0
2325300037,20140902T000000,358000,3,3.25,1410,1442,1360,50
1085623710,20140714T000000,447055,4,2.5,2448,4949,2448,0
774100475,20140627T000000,415000,3,2.75,2600,64626,2600,0
1489300215,20141013T000000,1.21E+06,4,3.25,3330,9000,2870,460
9828702902,20141021T000000,495000,2,2.25,1160,1010,1000,160
6371000100,20141120T000000,479000,2,2.25,1330,1380,1060,270
2025069140,20150317T000000,1.90E+06,3,2.5,2830,4334,2830,0
2781280300,20141016T000000,249900,3,2.5,1610,3517,1610,0
9551201240,20141030T000000,1.47E+06,4,2.5,2800,4000,2800,0
2726059144,20150410T000000,1.04E+06,5,3.75,4570,10194,4570,0
5363200100,20141020T000000,897000,4,2.5,2820,6120,2820,0
1725059330,20150327T000000,1.10E+06,4,2.5,2570,9470,2570,0
7234601140,20141113T000000,685000,3,2.25,1710,1193,1140,570
3057000300,20140930T000000,295000,3,1.5,1220,3286,1220,0
1972200553,20140804T000000,619000,3,2.25,1650,946,1650,0
6371000148,20141125T000000,439108,2,1.5,1130,1340,910,220
301400850,20150220T000000,260000,3,2.25,1489,2800,1489,0
1123049232,20140606T000000,279000,5,2.5,2690,5557,2690,0
3654200037,20150330T000000,380000,3,2.25,1530,1305,1116,414
7299601790,20141107T000000,287000,3,2.5,1600,6315,1600,0
2771101921,20141211T000000,377000,2,1.5,1000,1251,930,70
3566800485,20150223T000000,649950,4,3.5,2440,3012,2440,0
2767601311,20141024T000000,445000,3,2.5,1260,1102,1260,0
9137101696,20150504T000000,605000,3,2.5,1660,1692,1610,50
9528104345,20140923T000000,475000,3,2.25,1190,1137,960,230
3753000100,20140828T000000,399000,3,3,1520,1884,1520,0
6798100690,20150420T000000,718000,5,2.75,3250,8100,3250,0
148000475,20140528T000000,1.40E+06,4,3.25,4700,9160,2520,2180
3277801417,20140516T000000,341000,3,2.5,1480,1663,1180,300
8682320090,20140519T000000,818000,2,2.5,2380,9374,2380,0
9828701507,20141202T000000,759000,3,2.25,1640,1873,1640,0
3362400432,20140611T000000,547500,3,3.5,1650,2262,1650,0
856000195,20140521T000000,2.70E+06,5,4.75,5305,8401,3745,1560
9396700028,20140722T000000,358000,2,2.5,1278,987,1002,276
8850000018,20141001T000000,412000,3,2.5,1200,813,1200,0
9524100207,20150130T000000,245000,2,1.5,690,1058,690,0
1085623350,20141007T000000,460940,4,2.5,3202,4964,3202,0
7663700973,20140522T000000,321000,3,2.25,1347,1292,1347,0
7853420100,20140623T000000,633634,4,3.5,2960,6000,2960,0
1025039168,20140923T000000,290000,1,0.75,740,1284,740,0
476000110,20150401T000000,445000,2,2.25,1200,1137,1200,0
2254100090,20150407T000000,887250,5,3.5,4320,7502,3500,820
8682320600,20140911T000000,739000,3,2.5,2310,7348,2310,0
9834201366,20141216T000000,429900,3,2,1490,1286,1490,0
7625702451,20150106T000000,459000,3,2,1480,800,1000,480
301402120,20140625T000000,240000,3,2.25,1481,2820,1481,0
6382500076,20140910T000000,566950,3,3,1730,1902,1730,0
3758900259,20140507T000000,1.04E+06,4,3.5,3900,8391,3900,0
3126049446,20150310T000000,343000,3,3.5,1130,1449,1130,0
3744000100,20141111T000000,572115,4,3.25,3230,4838,3230,0
9510860750,20150108T000000,918000,5,3.5,3920,5150,2820,1100
7228500037,20150505T000000,555000,2,1.5,1190,1361,1190,0
3814900750,20140716T000000,399440,4,2.5,2311,4396,2311,0
1294300038,20140711T000000,450000,3,2.5,1810,914,1380,430
7853350090,20140604T000000,648000,4,2.5,3290,6203,3290,0
9211010900,20140618T000000,580000,4,2.5,3250,5000,3250,0
1085623250,20150331T000000,415000,4,2.5,2544,4071,2544,0
2025049192,20141021T000000,527500,3,2.5,1380,1389,1380,0
7625703354,20140730T000000,384000,3,2.25,1430,800,1140,290
2051200436,20140820T000000,692000,3,2.5,3490,28213,2242,1248
3880900236,20140822T000000,455000,2,1.5,910,966,820,90
1646502355,20150403T000000,1.28E+06,4,3.25,3080,4120,2380,700
2619950110,20140624T000000,415000,3,2.5,2280,6031,2280,0
1964700054,20141222T000000,975000,3,2.5,1660,1344,1660,0
1926059039,20141006T000000,799950,4,2.5,3320,7429,3320,0
3438500037,20150405T000000,545000,5,4,1680,7268,1370,310
9578501110,20141003T000000,429900,4,3.5,2584,5005,2584,0
8856004786,20140729T000000,275000,3,2.5,2217,8019,2217,0
7708200600,20140718T000000,498000,3,2.5,2480,4136,2480,0
9492500090,20140527T000000,754950,3,2.5,2610,7256,2610,0
8691440100,20140606T000000,895000,4,3,3240,5562,3240,0
7222000090,20140506T000000,580000,4,3.25,3569,8327,3569,0
3321049112,20150222T000000,379900,4,2.5,3181,5831,3181,0
2911000100,20150310T000000,245000,4,2.5,1921,4888,1921,0
3862710090,20140826T000000,417000,3,2.5,1570,4926,1570,0
8648900110,20140505T000000,555000,3,2.5,1940,3211,1940,0
8648900110,20140826T000000,555000,3,2.5,1940,3211,1940,0
6791400100,20140910T000000,353000,4,2.5,2210,13721,2210,0
2768301477,20150425T000000,539000,3,2.25,1280,1187,1080,200
126039256,20140904T000000,434900,3,2,1520,5040,1520,0
8562780110,20141202T000000,325000,2,2.25,1230,1078,1160,70
8032700110,20150409T000000,650000,3,2.5,1480,2159,1480,0
5635100090,20150225T000000,379950,4,2.5,2612,5850,2612,0
2597490300,20141119T000000,700000,3,2.5,2350,4975,2350,0
9301300805,20141215T000000,675000,3,2.5,1300,1590,1100,200
3449000300,20140609T000000,379000,4,1.5,2020,7560,2020,0
8562770490,20150330T000000,571000,3,2.5,2140,2867,1960,180
3052700464,20141024T000000,475000,3,2.25,1380,1621,1140,240
9276200569,20140509T000000,769900,4,3.5,2730,3047,2400,330
7853280490,20141222T000000,633000,4,3.5,4220,5817,2910,1310
2883200524,20140512T000000,635000,3,2.5,1570,1433,1570,0
3630200300,20140725T000000,1.24E+06,4,3.5,4670,6000,3820,850
1383800015,20150108T000000,524000,3,2.25,1370,1007,1330,40
1441000090,20141126T000000,485000,4,3.5,3273,5115,2671,602
3760500407,20140521T000000,1.03E+06,3,4,3880,13095,3700,180
9528101214,20141024T000000,650000,3,3.5,1494,1262,1494,0
2801910100,20141001T000000,754842,3,2.5,2930,5641,2930,0
1085623640,20140924T000000,428900,4,2.5,2598,5553,2598,0
7299601460,20140623T000000,329900,3,2.5,2242,4995,2242,0
1070000110,20141218T000000,1.04E+06,4,2.5,2830,5932,2830,0
7853360820,20140909T000000,544999,4,2.5,2710,6937,2710,0
7436700090,20140529T000000,449950,4,2.75,2320,4344,2320,0
3034200399,20150113T000000,635000,4,2.5,2720,7991,2720,0
889000015,20141103T000000,599000,3,1.75,1650,1180,1650,0
2767704252,20141103T000000,478000,3,3.25,1430,1348,1160,270
2143700756,20140929T000000,388000,4,2.5,2090,5040,2090,0
8946780110,20140804T000000,809950,4,3.5,3660,4903,2760,900
6790830090,20150415T000000,1.06E+06,4,3.5,4220,8417,4220,0
2768100512,20150422T000000,659000,2,2.5,1450,1213,1110,340
9477580110,20140626T000000,971971,4,3.75,3460,6738,3460,0
7625702437,20150115T000000,389000,3,2.5,1350,874,1270,80
5416510490,20140708T000000,355000,4,2.75,3000,5470,3000,0
1123059125,20141208T000000,551500,4,2.5,2950,10003,2950,0
7237450110,20140701T000000,417838,4,2.5,2530,5048,2530,0
250000090,20140714T000000,1.75E+06,4,4.5,4650,7660,3640,1010
2025049206,20140611T000000,399950,2,1,710,1131,710,0
5631500941,20140715T000000,740000,4,2.5,3050,8000,3050,0
8562780490,20150223T000000,335000,3,2.5,1150,683,1150,0
3262300485,20150421T000000,2.25E+06,5,5.25,3410,8118,3410,0
5693500846,20150420T000000,667000,3,1.75,1370,1921,1370,0
925059313,20150312T000000,920000,4,2.5,3540,7009,3540,0
2461900492,20140511T000000,368000,3,2.5,1370,1350,1010,360
6817750110,20140710T000000,307000,4,2.5,1714,3080,1714,0
3574770100,20150116T000000,550000,4,2.75,3650,4534,2940,710
8564860110,20150113T000000,594491,4,2.5,2990,6037,2990,0
1085622460,20140929T000000,460458,4,2.5,3284,6516,3284,0
1777600850,20140624T000000,859000,4,2.25,3550,13900,1830,1720
9284801500,20141211T000000,399950,3,3,1860,2875,1710,150
7217400389,20150401T000000,547500,3,3.25,1720,1977,1360,360
3832051140,20140623T000000,310000,3,2.5,2540,4775,2540,0
925059137,20140602T000000,939000,4,2.75,3270,12880,3270,0
6021503706,20141014T000000,329900,2,2.5,980,1021,980,0
475000176,20141222T000000,436000,3,2.5,1150,1193,1020,130
1220000367,20140716T000000,320000,3,2.5,1820,1855,1570,250
3278605590,20140926T000000,375000,3,2.5,1580,3825,1580,0
7203140110,20150324T000000,392137,3,2,1460,3696,1460,0
3818400110,20140826T000000,520000,4,2.5,2900,4950,2900,0
7702080110,20141016T000000,535000,5,2.75,2620,6389,2620,0
952002250,20150324T000000,407000,2,2.5,1340,999,940,400
9578500820,20141125T000000,424950,4,3.25,3266,5398,3266,0
3448000542,20140811T000000,290000,2,1.5,1076,1060,1076,0
9358000552,20141029T000000,399000,3,3.25,1680,1478,1360,320
2770601696,20140703T000000,439990,3,2.5,1930,1348,1300,630
9834201145,20150222T000000,635000,4,2.5,2880,3091,1940,940
3575305452,20140717T000000,635000,4,2.25,2240,5000,2240,0
6181500100,20150429T000000,351000,3,2.5,2594,4455,2594,0
2767604074,20140822T000000,437500,2,1.5,1210,1232,1210,0
2872100345,20140530T000000,919204,4,3.5,3760,5000,2860,900
2937300440,20140908T000000,923990,4,2.5,3600,6055,3600,0
2597490660,20140624T000000,639888,4,2.5,2050,2772,2050,0
3528900768,20150114T000000,675000,3,3.25,1510,2064,1220,290
3885802135,20140610T000000,899900,4,2.5,2580,3909,2580,0
3336500190,20150130T000000,252000,3,2.5,1670,4020,1670,0
2425059174,20150317T000000,925000,4,2.5,3190,10034,3190,0
1890000170,20141029T000000,552000,3,2.5,1280,1920,1280,0
5137800130,20150407T000000,388500,4,2.5,2718,6197,2718,0
2767603753,20140829T000000,548000,2,2,1370,1878,1370,0
6181410950,20140922T000000,254950,3,2.5,1794,4769,1794,0
3226069049,20141208T000000,1.24E+06,4,4.5,5120,41327,3290,1830
6056110430,20140930T000000,629000,3,2.5,2160,1912,1970,190
2916200091,20150303T000000,734000,4,2.5,2180,7204,2180,0
1773100980,20140618T000000,309000,3,2.25,1490,1294,1220,270
1123059126,20140703T000000,554950,3,2.5,2950,10254,2950,0
825079024,20150506T000000,785000,3,2.75,2990,207781,2990,0
8029770470,20140605T000000,550000,4,2.5,2700,5150,2700,0
1563102965,20140811T000000,1.01E+06,4,3.5,3130,5000,3130,0
5021900635,20141028T000000,1.58E+06,3,2,3620,14250,3220,400
9264450460,20140603T000000,309000,5,2.75,2481,4045,2481,0
7694200430,20140625T000000,328423,3,2.5,1730,3600,1730,0
7548301041,20140623T000000,345000,3,1.5,1420,1192,1140,280
726059483,20141121T000000,660000,5,3.5,3160,5175,3160,0
2771102144,20140502T000000,385000,3,3.25,1320,1327,1040,280
7011201476,20150318T000000,459000,2,2.25,1010,1107,710,300
53500020,20150114T000000,248000,3,2.5,1870,4046,1870,0
8920100066,20140820T000000,1.48E+06,4,3.5,5220,15411,3550,1670
8091670020,20140801T000000,379000,4,2.5,2260,5824,2260,0
1176001310,20150304T000000,2.95E+06,5,4.5,4340,5722,4340,0
3629960680,20140926T000000,395000,2,2.25,1620,1841,1540,80
8562770250,20140507T000000,535000,3,2.5,2280,2289,1880,400
1102000514,20141022T000000,970000,5,3.5,3400,9804,2550,850
1773100275,20150201T000000,205000,2,1.5,830,1020,830,0
321030010,20141015T000000,310000,4,2.5,2310,7384,2310,0
5393600509,20140702T000000,334500,2,1.5,830,1858,830,0
2895730280,20140828T000000,995000,5,3.25,4130,7197,4130,0
7967000130,20150401T000000,370228,4,3,2050,4000,2050,0
7570060290,20150304T000000,383000,4,2.5,2050,4953,2050,0
291310170,20140804T000000,384500,3,2.5,1600,2610,1600,0
923000425,20140718T000000,865000,5,2.5,3190,8160,3190,0
3630200780,20140522T000000,1.05E+06,4,3.75,3860,5474,3860,0
9578060660,20140513T000000,502000,4,2.5,2040,5616,2040,0
250000010,20140924T000000,1.75E+06,4,3.5,3845,8400,3845,0
1438000010,20140912T000000,569995,4,2.5,2650,6875,2650,0
6626300095,20140519T000000,749950,4,2.5,3430,64441,3430,0
8562901100,20141230T000000,550000,3,2.5,2430,5400,2430,0
6979970080,20140513T000000,525000,3,3.5,2876,5086,2360,516
7853320470,20140611T000000,516000,4,3.5,2550,8698,2550,0
1424069056,20140805T000000,1.35E+06,4,3.75,4100,61419,4100,0
3448740250,20150428T000000,440000,4,2.5,2730,4526,2730,0
8129700728,20150414T000000,660000,3,2.5,1780,1729,1080,700
3832080440,20141209T000000,261950,3,2.5,1880,5000,1880,0
9512200050,20140827T000000,551000,5,3.75,3090,4943,3090,0
4027700014,20150225T000000,665000,3,3.5,2460,14155,1900,560
7853400250,20140604T000000,610000,4,3.5,2910,5260,2910,0
7853400250,20150219T000000,645000,4,3.5,2910,5260,2910,0
7853420480,20140618T000000,536751,3,1.75,1930,6360,1930,0
8943600020,20150426T000000,260000,3,2.25,1413,3403,1413,0
4221900305,20150121T000000,1.31E+06,3,3.25,4030,6300,3630,400
1112630130,20150220T000000,429900,4,3.25,2880,5929,2880,0
123039376,20140820T000000,535000,4,2.75,2360,15100,2360,0
2767603962,20150414T000000,462550,2,1.75,1070,1276,1070,0
4083306552,20150310T000000,602000,3,3.25,1460,1367,1460,0
745500010,20141208T000000,730000,4,2.75,3800,9606,3800,0
7899800851,20150423T000000,300500,2,1.5,1190,801,1190,0
7853350170,20140516T000000,675000,5,2.5,3200,6455,3200,0
6056100380,20140520T000000,415000,3,2.25,1970,2377,1680,290
626059127,20141117T000000,614000,3,2.5,2830,5831,2830,0
1459920190,20141204T000000,385000,4,2.5,2630,5701,2630,0
3574750020,20140625T000000,594000,4,2.75,2720,4613,2720,0
2547200190,20140520T000000,860000,4,2.75,3160,8097,3160,0
9206500250,20140909T000000,1.10E+06,4,4,3770,8899,2940,830
7202300480,20141024T000000,775000,4,2.75,3500,6226,3500,0
7237450190,20140806T000000,430760,5,2.75,2710,4685,2710,0
8682320420,20150427T000000,755000,2,2.5,2170,6361,2170,0
6003500743,20140519T000000,640000,2,2.25,1540,958,1540,0
328000182,20150501T000000,613500,3,3.25,1876,1531,1876,0
821079102,20141017T000000,780000,4,3.5,3720,213073,3720,0
1622049242,20150304T000000,550000,4,2.5,3148,9612,3148,0
7203120050,20141008T000000,789500,4,3.25,3240,4852,3240,0
7853360250,20140710T000000,592000,5,3.5,3340,5000,2580,760
1327600190,20150410T000000,454950,4,2.5,2413,5701,2413,0
4187000250,20150413T000000,475000,4,2.5,2500,4500,2500,0
2902201300,20141229T000000,659000,2,1.75,1180,904,780,400
1635500250,20141124T000000,570000,4,2.5,2890,5801,2890,0
6031400094,20150226T000000,347500,5,3,2230,6551,1330,900
6601200250,20150402T000000,205000,4,2.5,1767,4500,1767,0
9358001403,20140903T000000,380000,3,3.25,1450,1468,1100,350
4216500020,20141003T000000,718000,5,2.75,2930,7663,2930,0
1438000440,20140724T000000,515805,5,2.75,2710,4136,2710,0
6061500130,20140714T000000,1.03E+06,4,3.25,3600,18645,3000,600
3862710050,20141113T000000,437718,3,2.5,1800,3265,1800,0
7604400114,20140814T000000,450000,4,2.5,2290,5515,2290,0
9828702649,20141028T000000,515000,3,2.5,1510,1178,1060,450
2946003947,20150302T000000,204000,2,2.5,1090,13444,1090,0
993000307,20140523T000000,360000,3,2,1270,1323,1270,0
3362400094,20141203T000000,550000,3,2.25,1540,1005,1540,0
7853380480,20140529T000000,650880,3,2.5,2930,6050,2930,0
3893100462,20150225T000000,1.79E+06,5,3.75,4360,8504,3530,830
2326600130,20150225T000000,895900,4,3.5,3640,4983,2790,850
3424069008,20140606T000000,585000,4,2.5,2430,4747,2430,0
3277801586,20150508T000000,380000,3,2.25,1520,1464,1240,280
5045700250,20141118T000000,565997,5,2.75,2730,5820,2730,0
3278603000,20150504T000000,459000,3,3,2440,2076,1930,510
7548800050,20150421T000000,550000,3,3.75,1580,1303,1340,240
1972201964,20140725T000000,500000,3,2.25,1420,983,1420,0
3395070980,20150327T000000,461500,5,3.25,2820,3275,2230,590
5710000005,20140522T000000,2.15E+06,4,5.5,5060,10320,5060,0
9319800050,20150421T000000,790000,4,2.5,2650,5000,2650,0
3303700221,20140627T000000,735000,3,2.25,1490,1212,1040,450
3304300080,20150330T000000,588000,4,2.5,3060,7710,3060,0
642800130,20150513T000000,724500,3,3.25,3240,4185,2770,470
6192410480,20140709T000000,749000,3,2.75,2820,5348,2820,0
6127000480,20140918T000000,720000,5,3.5,4140,7642,4140,0
6145601599,20140611T000000,250000,2,1.5,982,846,806,176
3630200460,20150327T000000,790000,3,2.75,2460,3600,2460,0
3845101100,20150121T000000,392440,4,2.5,2547,4800,2547,0
6792200066,20140725T000000,280000,4,2.25,1834,7460,1834,0
5317100294,20141113T000000,1.33E+06,4,4.5,3130,5126,2450,680
8150600250,20141217T000000,649000,4,2.5,2730,4847,2730,0
9376301112,20141031T000000,457000,2,2.5,1380,1329,1050,330
856000635,20150323T000000,2.23E+06,4,4.25,4700,10800,3910,790
9320350130,20140823T000000,453000,3,3,2330,4284,1920,410
7694200380,20140922T000000,329780,3,2.5,1730,3600,1730,0
635000009,20141112T000000,1.05E+06,2,2.5,2350,2390,2000,350
7853440050,20150505T000000,771005,5,4.5,4000,6713,4000,0
8563010130,20140725T000000,1.30E+06,3,2.5,3350,7752,2180,1170
2767604592,20140619T000000,607500,3,3.25,1530,1612,1530,0
1332700020,20150116T000000,278000,2,2.25,1610,1968,1610,0
1442870440,20140702T000000,475000,4,2.75,2620,6178,2620,0
5347200179,20140814T000000,270000,3,2,1300,1920,850,450
8924100372,20150423T000000,1.30E+06,4,3.5,3590,5334,3140,450
6666830170,20140811T000000,778983,4,2.5,2490,5647,2490,0
3336000052,20141022T000000,221000,3,2.5,1320,1780,880,440
2895800380,20140821T000000,338800,4,2.25,1800,2752,1800,0
1042700250,20140804T000000,834995,5,1.5,3360,5225,3360,0
7787920250,20150501T000000,550000,4,2.5,3220,9328,3220,0
3026059363,20141031T000000,575000,3,3.5,2514,1559,2024,490
3590000050,20140923T000000,649000,4,2.75,3130,9711,3130,0
7853361410,20140530T000000,545000,4,2.5,2720,4738,2720,0
1355300009,20141120T000000,625000,2,2.25,1390,916,1165,225
8835800010,20141223T000000,1.04E+06,4,4.5,4920,270236,3820,1100
9268851680,20140516T000000,611000,3,2.5,2134,1984,2134,0
8096800500,20150317T000000,300000,3,2.5,1741,5701,1741,0
7202261060,20141229T000000,577000,3,2.5,2560,5238,2560,0
7237450130,20141020T000000,349990,4,2.5,2220,3561,2220,0
3630130010,20140714T000000,650000,3,2.5,1910,4363,1910,0
567000381,20150328T000000,378000,2,1.5,980,853,820,160
1760650290,20150205T000000,313200,3,2.5,1950,4197,1950,0
1024069215,20140912T000000,1.21E+06,5,4.25,4150,12015,4150,0
1105000373,20150506T000000,252500,2,1.5,1110,986,950,160
1773100561,20150305T000000,308000,3,2.5,1250,1150,1080,170
9510860840,20140515T000000,803100,4,2.5,3310,5404,3310,0
4187000660,20140618T000000,415000,4,2.5,2020,5501,2020,0
7203120020,20140814T000000,785000,4,3.5,3310,4850,3310,0
8559300020,20140528T000000,499950,4,2.5,2798,4473,2798,0
3356402705,20150317T000000,216000,4,2.5,1847,8000,1847,0
662440020,20150226T000000,380000,4,2.5,2420,4981,2420,0
255370020,20141106T000000,345000,4,2.5,2020,3600,2020,0
293810190,20141104T000000,456500,4,2.5,2400,6811,2400,0
8091670190,20141104T000000,382495,3,2.5,1760,5390,1760,0
1760650280,20150306T000000,324950,4,2.5,2110,4178,2110,0
6306800010,20140811T000000,436472,4,2.5,2692,8392,2692,0
982850010,20140530T000000,365250,3,2.25,1490,4522,1490,0
6705600020,20150324T000000,919990,5,3.25,3960,6352,3960,0
9478550430,20150429T000000,316475,4,2.5,1740,4642,1740,0
5498100010,20150324T000000,425000,4,2.5,1940,4517,1190,750
7625702901,20150311T000000,302860,2,1,970,3279,790,180
301401410,20140722T000000,298000,3,2.5,1852,4000,1852,0
251500080,20140826T000000,3.20E+06,4,4,4810,18851,4810,0
521049227,20141201T000000,950000,4,4,5635,9695,4360,1275
100300500,20141121T000000,333000,3,2.5,1520,3041,1520,0
8669160460,20150305T000000,289950,3,2.5,2099,4275,2099,0
2810100007,20150506T000000,419950,3,2.25,1250,811,1250,0
6749700006,20140715T000000,306000,2,1.5,1090,1183,1090,0
1085623730,20141129T000000,498445,4,2.5,3216,5902,3216,0
6666830430,20140620T000000,775950,4,2.5,2970,4400,2970,0
7852110380,20140703T000000,605000,3,2.5,2610,6405,2610,0
8080400177,20140909T000000,520000,2,1.75,1340,1368,1060,280
293070010,20141028T000000,849990,4,2.75,3300,4987,3300,0
9144100007,20140604T000000,767450,3,2,1630,7599,1630,0
7234601142,20140808T000000,665000,3,2.25,1590,929,1060,530
1972200426,20140918T000000,525000,2,2.75,1310,1268,1310,0
7768800280,20140722T000000,870515,4,3.5,3600,5697,2940,660
9512200420,20140721T000000,390000,4,2.5,2154,4153,2154,0
7132300525,20150411T000000,500000,3,1.75,1530,825,1530,0
7515000143,20140805T000000,399950,3,2.25,1360,1041,1094,266
3395070440,20150209T000000,305000,3,2.5,1320,2480,1320,0
629650380,20150123T000000,255000,4,2.5,1660,6724,1660,0
1115600130,20140930T000000,415000,4,2.5,2891,6499,2891,0
8562790950,20150327T000000,716500,3,2.5,2340,2155,2120,220
3413700130,20140625T000000,425000,3,2.5,2320,2267,2320,0
9532000170,20150217T000000,540000,4,2.5,2190,3855,2190,0
255450380,20140804T000000,324747,3,2.5,2060,4742,2060,0
7203140420,20150128T000000,385000,3,2.5,1740,4145,1740,0
1760650670,20140812T000000,270000,3,2.25,1400,3825,1400,0
5556300098,20140612T000000,1.24E+06,5,4,4410,14380,4410,0
8129700743,20150416T000000,672000,3,2.5,1780,1647,1080,700
3023000050,20150129T000000,310000,3,2.5,1760,10137,1760,0
518500480,20140811T000000,3.00E+06,3,3.5,4410,10756,3430,980
1725059127,20150225T000000,2.35E+06,6,4.25,5550,11547,4270,1280
9511120050,20140627T000000,427000,3,2.5,2432,9391,2432,0
8943600430,20150423T000000,389950,3,2.5,2283,3996,2283,0
9429400170,20140625T000000,309620,3,2.5,1860,3730,1860,0
3845101150,20140701T000000,399895,4,2.5,2701,4500,2701,0
1085623560,20150202T000000,442515,4,2.5,2930,4875,2930,0
263000255,20141202T000000,375000,3,2.25,1540,1561,1540,0
7299600130,20140702T000000,309780,3,2.5,2242,4500,2242,0
7853320280,20150312T000000,425000,3,2.5,1950,4345,1950,0
4253400098,20150501T000000,405000,2,3,1160,1073,880,280
3814900380,20140719T000000,356250,3,2.5,2060,5115,2060,0
6821101732,20150219T000000,550000,3,2.25,1230,875,1230,0
3644100086,20140505T000000,340000,2,1.5,1160,1438,1160,0
7237450080,20140823T000000,362865,4,2.5,2245,4301,2245,0
6389970010,20150323T000000,1.36E+06,4,3.5,4120,12626,3970,150
9578090050,20140505T000000,830000,4,2.5,3400,9692,3400,0
1489300005,20140801T000000,1.60E+06,5,3.75,4270,7500,3210,1060
7768800290,20150304T000000,855000,4,3.5,2890,5911,2370,520
1245003220,20140819T000000,1.21E+06,5,3.5,3220,8000,2900,320
5608000010,20140811T000000,1.39E+06,4,3.5,4010,15365,4010,0
5379805260,20150326T000000,400200,4,3.5,2260,30250,2260,0
3278600670,20140523T000000,235000,2,1,1140,1730,1010,130
2781240050,20150507T000000,349950,3,2,1640,4714,1640,0
7502800050,20140709T000000,659950,4,2.75,3510,9400,3510,0
9544700500,20140508T000000,785000,3,2.75,3010,1842,3010,0
2771603314,20150416T000000,475000,2,2.25,1060,925,980,80
4181200680,20140527T000000,263900,3,2.5,1658,2700,1658,0
9347300010,20150501T000000,342000,3,2.5,1960,3540,1960,0
255450020,20140918T000000,367899,3,2.5,2420,4725,2420,0
7230200585,20150204T000000,657044,3,3.5,3420,23786,3420,0
9828702771,20141113T000000,359950,2,1.5,893,965,893,0
9492500170,20140723T000000,879950,4,2.75,3020,7203,3020,0
9265880170,20140826T000000,550000,4,2.5,2470,5954,2470,0
7299600920,20141209T000000,279000,4,2.5,2009,4800,2009,0
8690600050,20140718T000000,255000,3,2.5,1530,1116,1530,0
1176001119,20150224T000000,609500,3,1.75,1590,1113,1590,0
3449850050,20140620T000000,420000,5,3,2630,3149,1670,960
9211000170,20141008T000000,570000,4,2.5,3230,7187,3230,0
6056111350,20150512T000000,439000,3,2.25,1430,2343,1430,0
7299601630,20141108T000000,310000,3,2.5,2242,5744,2242,0
7133300380,20150209T000000,635000,4,2.5,2500,4000,2500,0
2770601775,20141128T000000,399950,3,2.5,1230,922,1080,150
3630200630,20140805T000000,805000,4,2.5,3020,3600,3020,0
4385700250,20150407T000000,1.80E+06,4,3.5,3480,4000,2460,1020
6430500182,20150403T000000,1.21E+06,4,3,3330,7650,1830,1500
8029770190,20141015T000000,745000,4,2.5,3400,4840,3190,210
5393600507,20140624T000000,329445,2,1.5,830,1119,830,0
207700050,20141015T000000,588000,5,3,3110,4464,3110,0
8138870470,20140707T000000,494815,3,2.5,1910,2091,1910,0
7853370020,20141014T000000,591975,3,2.75,3230,5250,2680,550
3304300380,20150108T000000,600000,5,2.75,3380,8179,3380,0
3528960020,20140708T000000,673000,3,2.75,2830,3496,2830,0
1853080840,20150211T000000,889950,5,3.5,3700,7055,3700,0
7852130460,20150325T000000,500000,4,3,2520,4104,2520,0
2768301357,20141001T000000,500000,3,2.25,1530,1396,1240,290
8562710250,20140505T000000,890000,4,4.25,4420,5750,3410,1010
6824100014,20150429T000000,437000,3,3,1460,1180,1460,0
7905200061,20140905T000000,419700,3,2.25,1450,1486,1160,290
3524039228,20140723T000000,394000,3,2,1160,3441,580,580
2781240040,20140806T000000,342000,3,2,1640,4802,1640,0
1222029064,20140626T000000,420000,3,1.75,1444,249126,1444,0
9523100730,20140523T000000,580000,3,2.5,1620,1173,1470,150
5649600464,20150327T000000,343000,2,1.5,1100,1228,900,200
7548301050,20150402T000000,390000,2,1.5,1340,1402,1120,220
9542840450,20140811T000000,274000,3,1.5,1450,4694,1450,0
126039467,20150114T000000,700000,4,2.5,3040,7200,3040,0
7936000463,20150416T000000,838000,4,2.5,2560,7210,2560,0
3021059304,20140917T000000,300000,6,3,2744,9926,2744,0
3362401758,20140903T000000,467000,3,2.25,1420,990,1420,0
886000090,20150302T000000,395000,2,1,700,7457,700,0
1196003740,20140924T000000,734000,5,4.25,4110,42755,2970,1140
5045700090,20150106T000000,480000,5,2.75,2670,4780,2670,0
1604601801,20150217T000000,539000,3,2.75,2130,1400,1080,1050
5057100090,20150505T000000,459950,5,2.75,3078,6371,3078,0
3869900146,20141030T000000,306500,2,1,840,892,840,0
3862710180,20150326T000000,408474,3,2.5,1800,2731,1800,0
1023059246,20140514T000000,437000,3,2.75,2580,5200,2580,0
6056100150,20140623T000000,160797,3,1.5,1270,2356,1270,0
3342700464,20150107T000000,729000,4,3.5,3065,5440,3065,0
3026059362,20141031T000000,499000,3,2.5,1861,1587,1578,283
1327600150,20141016T000000,359950,4,2.75,2260,5705,2260,0
2895730540,20141210T000000,929000,5,3.25,4150,7100,4150,0
2768200209,20141006T000000,529950,2,2.5,1500,1174,1140,360
9268851380,20150403T000000,461000,3,2.25,1620,998,1540,80
7625703007,20141014T000000,271115,2,1.5,830,1325,830,0
7202280580,20150106T000000,653000,4,2.5,3120,5137,3120,0
1972202187,20141024T000000,565000,3,2.5,1870,1058,1380,490
2767600985,20141204T000000,529950,3,2.25,1240,1250,1240,0
5631501202,20150326T000000,585000,4,2.5,2820,5612,2820,0
1972200556,20140703T000000,609000,3,1.75,1630,1526,1630,0
301400930,20140618T000000,267000,3,2.25,1584,2800,1584,0
9265880040,20140509T000000,557000,4,2.5,2840,4500,2840,0
7853280610,20141117T000000,709950,4,3.25,3910,6293,3130,780
1972200847,20140718T000000,625000,3,2.5,1730,1301,1730,0
8562790940,20141223T000000,599000,3,2.75,1840,2060,1700,140
1623089165,20150506T000000,920000,4,3.75,4030,503989,4030,0
6788200596,20141016T000000,1.29E+06,4,3.5,3440,3800,3440,0
1760650610,20150330T000000,324500,4,2.5,2110,3825,2110,0
7853360850,20150116T000000,471500,3,2.5,2430,5866,2430,0
2526069092,20140808T000000,1.02E+06,4,3.75,4690,207141,4030,660
2424059061,20141111T000000,998000,4,3.5,3500,43560,2850,650
7661600206,20150129T000000,262000,4,2.5,2070,8685,2070,0
8149600065,20150401T000000,844000,4,3.5,3350,6350,2610,740
6666830120,20140624T000000,745641,4,2.5,2440,4850,2440,0
3034200087,20141212T000000,659950,5,3,3010,7357,3010,0
255450410,20140804T000000,339989,3,2.5,2060,4200,2060,0
3438501327,20150504T000000,352500,2,2.5,1570,2399,1180,390
9828702389,20140513T000000,525000,3,2.5,1580,1161,1010,570
8691440330,20140929T000000,1.14E+06,5,3.5,4280,6530,4280,0
1085623740,20140812T000000,491000,5,3.5,2815,4900,2815,0
1424069110,20140718T000000,675000,4,2.5,2620,6114,2620,0
993001914,20150106T000000,344000,3,2.25,1250,1033,1250,0
9211010220,20141104T000000,530000,4,2.5,3250,4500,3250,0
2143701015,20141210T000000,290500,4,3.25,2510,7686,2510,0
6056111430,20150113T000000,335000,2,1.75,1270,1685,1270,0
1925059254,20150507T000000,3.00E+06,5,4,6670,16481,4960,1710
3278606200,20140919T000000,379000,3,2.5,1580,3075,1580,0
3126049501,20140717T000000,385000,3,1.5,1360,2030,1360,0
4305600360,20150225T000000,500012,4,2.5,2400,9612,1230,1170
6632300212,20140505T000000,366750,3,3,1571,2017,1571,0
1189000492,20140606T000000,405000,2,2,1405,1073,1140,265
3319500628,20150212T000000,356999,3,1.5,1010,1546,1010,0
2436700625,20150417T000000,590000,2,2.5,1450,1281,1220,230
3679400474,20141104T000000,294000,3,1.75,1420,1361,960,460
7203190110,20150426T000000,731500,4,2.5,2650,4644,2650,0
1853080850,20140606T000000,837219,5,2.75,3030,7679,3030,0
1125079111,20150415T000000,1.60E+06,4,5.5,6530,871200,6530,0
518500610,20140616T000000,798800,3,2.75,2670,3738,1720,950
293670040,20141008T000000,482500,2,2.5,1170,809,1170,0
3303970100,20150306T000000,820000,4,2.5,3260,26772,3260,0
3834000594,20140711T000000,319000,3,1.5,1480,1722,1480,0
3342100569,20140813T000000,950000,3,2.5,2700,6947,2700,0
7237501380,20150507T000000,1.27E+06,4,3.5,4640,13404,4640,0
2325300093,20140707T000000,378000,3,2.5,1601,2491,1536,65
9808100150,20150402T000000,3.35E+06,5,3.75,5350,15360,3040,2310
3332500085,20141027T000000,489950,3,2.5,2540,5237,2540,0
3869900150,20150427T000000,345000,2,1.75,1030,1106,765,265
2011400401,20150226T000000,510000,3,2.5,2730,7136,2730,0
9578501030,20140729T000000,432500,4,2.5,3172,5033,3172,0
8029770410,20150420T000000,650000,4,2.5,3160,8530,3160,0
6639900242,20141003T000000,750000,4,2.5,2850,12429,2850,0
2919700735,20150427T000000,870000,4,3.5,2780,3100,2120,660
8691440410,20141215T000000,900000,4,3.5,3860,6543,3860,0
2902201301,20141216T000000,664950,2,1.75,1180,900,780,400
291310150,20140602T000000,391000,3,2.25,1410,1290,1290,120
323079101,20150123T000000,1.80E+06,4,3.5,6370,205603,6370,0
5057100110,20150514T000000,479349,5,3,3223,6371,3223,0
9268850940,20141223T000000,661000,4,3.25,2600,2074,2150,450
993000315,20141002T000000,379000,3,3.25,1380,1234,1380,0
9268851800,20140505T000000,415000,3,2.25,1620,998,1540,80
4310702837,20141201T000000,375000,3,3.25,1370,1227,1370,0
4310703083,20140523T000000,355000,3,2,1220,1186,1220,0
1890000166,20140905T000000,540000,3,2.5,1280,1889,1280,0
7904700146,20140724T000000,290000,2,1.5,770,850,770,0
1931300308,20140520T000000,500000,3,2.5,1210,1200,1210,0
8091670730,20140902T000000,416000,4,2.5,2890,6322,2890,0
3278612370,20140811T000000,349900,3,2.5,1580,2765,1580,0
7600065,20140605T000000,465000,3,2.25,1530,1245,1050,480
3630200900,20140630T000000,950000,4,2.5,3670,7680,3670,0
3278611450,20150326T000000,496800,4,2.25,1850,2340,1850,0
2026049184,20150320T000000,680000,4,2.5,2440,6581,2440,0
9103000455,20150424T000000,920000,4,3.25,2190,4265,1540,650
8691440220,20150202T000000,1.29E+06,5,4,4360,8030,4360,0
7202300540,20140701T000000,825000,4,2.75,3990,6637,3990,0
1453601038,20141002T000000,292000,3,2.5,1270,1283,1270,0
9211010330,20150409T000000,576000,4,2.5,3340,6924,3340,0
1972201773,20150313T000000,670000,2,2,1500,761,1500,0
7974200948,20140520T000000,953007,4,3.5,3120,5086,2480,640
2700200040,20150223T000000,399000,4,2.5,2480,4334,2480,0
7625702264,20150427T000000,399000,2,2,1110,1155,980,130
2428100100,20141117T000000,847093,4,2.75,2760,5670,2760,0
1176001123,20150206T000000,599950,3,2.5,1510,1493,1510,0
3052700472,20140813T000000,499000,3,2.5,1460,1614,1180,280
1623089086,20141015T000000,760000,4,2.75,3980,285318,3980,0
2311400145,20141029T000000,1.70E+06,4,3.75,3320,8234,3320,0
8895800090,20140512T000000,1.03E+06,4,3.25,3270,5187,3110,160
847100021,20140520T000000,515000,4,2.5,2670,8765,2670,0
291310120,20141209T000000,355000,3,2.25,1410,1332,1290,120
301401390,20140805T000000,319900,4,2.75,2475,4000,2475,0
7519001068,20140527T000000,460000,3,3.5,1600,1431,1240,360
7203101590,20150108T000000,305000,2,1,1290,3383,1290,0
7299600530,20150317T000000,280000,3,2.5,1608,4818,1608,0
7625703357,20150227T000000,394950,2,2.25,1300,2104,1010,290
7889601270,20140821T000000,382000,4,3.5,2530,3000,1850,680
4083306553,20150422T000000,560000,3,2.5,1390,1411,1390,0
9828701508,20140520T000000,772000,3,2.25,1640,1204,1640,0
8946390150,20140722T000000,324950,4,2.5,2229,5723,2229,0
8648900040,20140709T000000,530000,3,2.5,1790,3078,1790,0
4092300211,20141024T000000,384000,3,2.25,990,736,880,110
3343902510,20140611T000000,719950,5,2.75,3240,6863,3240,0
2919700107,20140811T000000,319950,2,2.5,1280,819,1060,220
2781280230,20150128T000000,292000,3,2.5,1610,3848,1610,0
3232200085,20150428T000000,1.50E+06,6,3.5,3670,3959,2410,1260
1972200259,20140507T000000,425000,2,2.5,1150,1027,1150,0
1926059236,20141010T000000,799950,5,3.75,3760,4702,2780,980
2768200210,20140825T000000,499000,2,2.5,1320,1157,990,330
3304300210,20150327T000000,572000,4,2.75,2700,7992,2700,0
9826700930,20140722T000000,459000,2,2,1480,804,1480,0
9385200042,20150318T000000,529500,3,2.25,1410,905,1410,0
3876590090,20140909T000000,374500,4,2.5,3135,5811,3135,0
2902200142,20140605T000000,584000,3,2.5,1480,1485,1280,200
8085400401,20150115T000000,1.90E+06,4,4.5,4020,9656,4020,0
2902200237,20140707T000000,505000,2,2.25,1060,1209,940,120
7658600082,20141114T000000,565000,2,2.5,1950,2457,1950,0
6891100330,20150325T000000,799000,4,2.75,3340,5677,3340,0
6821102367,20150429T000000,547000,3,2.5,1570,1452,1240,330
1900600015,20150227T000000,550000,3,2.5,1930,6604,1930,0
1545808120,20140918T000000,250000,3,2,1590,8100,1060,530
2126059294,20150105T000000,960000,4,4.5,3720,7746,3720,0
1370800515,20141030T000000,2.95E+06,4,4.25,4470,5884,3230,1240
3319500334,20150327T000000,441000,2,1,1290,1289,1030,260
301400940,20150407T000000,265000,3,2.25,1489,2800,1489,0
2722069077,20150409T000000,430000,3,2.5,2075,39553,2075,0
8943600720,20140617T000000,286800,3,2.5,1413,3600,1413,0
7660100236,20150416T000000,375000,3,2.5,1300,1362,880,420
1773100921,20141215T000000,312500,3,3.25,1480,983,1180,300
8679200100,20150107T000000,850000,4,2.75,3320,5559,3320,0
3654200039,20150325T000000,390500,3,2.25,1530,1279,1116,414
2771602428,20141029T000000,455000,3,2.5,1180,932,1180,0
1225039067,20150406T000000,455000,2,2,1190,1303,800,390
625049359,20141203T000000,515000,3,2.25,1300,1180,1300,0
3278606050,20150401T000000,362500,3,3.5,1710,2212,1400,310
5112800291,20140924T000000,460000,3,2.5,2390,47480,2390,0
7853360300,20140904T000000,540000,4,3.5,3510,6005,2750,760
6056111063,20140731T000000,230000,3,1.75,1140,1165,1140,0
2767704649,20140929T000000,425000,2,2.5,1320,1329,1180,140
7683800205,20140519T000000,298450,5,3,2100,9752,1200,900
9406530150,20141222T000000,344000,4,2.5,2400,4848,2400,0
2979800409,20140505T000000,416286,3,2.5,1408,989,1408,0
1085622540,20150223T000000,379500,4,2.5,2560,5102,2560,0
4310701421,20140617T000000,350000,2,2.5,1260,1347,1260,0
2895800770,20150408T000000,258800,2,1.75,1290,1624,1290,0
3034200067,20141218T000000,620000,4,2.5,2730,9260,2730,0
3438501320,20140502T000000,295000,2,2.5,1630,1368,1280,350
8691450120,20150227T000000,908990,4,2.75,3530,6844,3530,0
6306810110,20141117T000000,485230,4,2.5,2714,12558,2714,0
3629990110,20140611T000000,475000,3,2.25,1630,2520,1630,0
715010110,20140804T000000,1.24E+06,5,3.25,5790,13726,4430,1360
3629700090,20140819T000000,635000,3,3,2230,1407,1850,380
3277801411,20141105T000000,350000,3,2.5,1380,1590,1160,220
8822901175,20141229T000000,345000,3,3.5,1320,1161,1320,0
6926700654,20140921T000000,700000,2,2,1490,713,1490,0
2768301482,20140821T000000,490000,3,2.25,1280,1520,1080,200
8895800110,20140805T000000,1.30E+06,5,4,3870,5929,3870,0
3879900750,20140910T000000,579000,2,2.5,1280,1051,1080,200
7234600820,20150327T000000,552500,3,1.5,1300,1435,1120,180
1946000100,20150204T000000,467000,4,2.75,2170,5024,2170,0
8943600870,20141113T000000,305000,4,2.25,1763,3717,1763,0
6145600557,20140509T000000,212000,2,1.5,1020,1525,1020,0
7203140180,20140821T000000,429000,4,2.5,1840,4593,1840,0
3277801592,20140925T000000,479950,3,2,1820,1358,1820,0
461003835,20141218T000000,825000,3,3.5,2670,3000,1870,800
424069279,20150328T000000,1.18E+06,6,6.5,6260,10955,4840,1420
1760651000,20140613T000000,250000,3,2.25,1400,3814,1400,0
3057000070,20141027T000000,289000,2,1.5,1160,2158,1160,0
2895810200,20141002T000000,265000,3,2.5,1400,3368,1400,0
2325300060,20140515T000000,344000,3,2.5,1232,1130,1232,0
9151600055,20140709T000000,749000,4,2.75,2700,6000,2100,600
7853321260,20140908T000000,492000,4,2.5,2550,6382,2550,0
4219610320,20150119T000000,552500,4,2.5,3260,6902,3260,0
2902200016,20141112T000000,653500,2,2.5,1680,1240,1120,560
7518507055,20150402T000000,855000,4,3.25,2630,2550,2030,600
7502700060,20141119T000000,333000,3,1.5,1260,5758,1260,0
3448740160,20140611T000000,415000,4,2.5,2550,4500,2550,0
179001455,20141107T000000,445000,4,3.25,3450,5000,3450,0
8669160270,20140710T000000,273500,3,2.5,1550,3402,1550,0
4215270070,20140606T000000,969990,4,2.5,4150,8436,4150,0
170000060,20141008T000000,1.20E+06,5,3.5,3900,4400,2650,1250
7410200431,20140806T000000,430000,3,3.25,1550,1444,1550,0
6600060140,20150323T000000,392000,4,2.5,2130,4000,2130,0
2324059314,20140702T000000,795000,4,2.5,2890,7798,2890,0
9376301111,20140630T000000,457000,3,2.5,1220,1330,1010,210
8956200560,20150320T000000,453000,4,2.5,2502,8306,2502,0
6749700002,20140509T000000,376000,3,2,1340,1384,1340,0
1438000390,20140804T000000,469995,4,2.5,2350,3800,2350,0
8682301600,20150504T000000,540000,3,2.5,1810,3930,1810,0
7853361370,20140502T000000,555000,4,2.5,3310,6500,3310,0
3333001997,20140725T000000,445000,3,2,1620,5101,590,1030
7899800857,20141215T000000,256950,2,2,1070,635,720,350
7338220370,20141006T000000,297000,4,2.5,2230,4952,2230,0
9406530160,20141017T000000,320000,4,2.5,1970,4558,1970,0
7853280370,20141114T000000,805000,5,4.5,4600,7810,3200,1400
2937300520,20140801T000000,799990,4,2.75,3110,6050,3110,0
2738640310,20150409T000000,680000,4,2.5,3490,3677,2850,640
6056100312,20140624T000000,395000,3,2.5,1600,1936,1600,0
2856100260,20141202T000000,732000,3,2.5,1960,3060,1960,0
2724049222,20140802T000000,163800,2,2.5,1000,1092,990,10
2724049222,20141201T000000,220000,2,2.5,1000,1092,990,10
6149700197,20141106T000000,308625,2,2,1500,1408,1500,0
3166900200,20150331T000000,375000,3,2.5,2424,5931,2424,0
5137800030,20140701T000000,300000,4,2.5,2303,3826,2303,0
3832080070,20140616T000000,284000,3,2.5,1880,6008,1880,0
9828702336,20150220T000000,610000,2,2,1210,740,780,430
7203180370,20150324T000000,955000,4,3.25,3720,6765,3720,0
3901100030,20140627T000000,982000,4,2.75,3610,8580,3610,0
3126049500,20140522T000000,359000,3,1.5,1360,885,1360,0
6666830390,20140718T000000,779380,5,2.5,2590,7084,2590,0
1832100055,20140630T000000,1.51E+06,5,3.25,4390,11250,4390,0
3629700030,20150223T000000,635000,3,3,2290,1407,1890,400
3630200960,20140826T000000,1.06E+06,4,3.75,3880,9979,3880,0
7625702431,20140716T000000,389500,3,2.5,1350,874,1270,80
2895800390,20140807T000000,359800,5,2.5,2170,2752,2170,0
3753000030,20140527T000000,399950,3,3,1296,1051,1296,0
1773100926,20140603T000000,320000,3,3.25,1530,1602,1140,390
301400320,20140725T000000,255900,3,2.5,1489,3266,1489,0
6600060160,20150209T000000,380000,4,2.5,2130,4467,2130,0
1861100267,20140918T000000,580000,3,2.75,1430,1521,1130,300
3438500036,20150429T000000,545000,5,3.75,2380,7268,1430,950
3869900036,20140725T000000,451300,3,2.5,1420,814,1140,280
1042700270,20140616T000000,852880,4,3.25,3450,6184,3450,0
6817750340,20140919T000000,305000,4,2.5,1914,3150,1914,0
3448001412,20150430T000000,295000,2,1.5,988,1080,988,0
301400800,20141016T000000,261000,3,2.25,1584,2800,1584,0
7852090570,20150317T000000,560000,4,2.5,2630,5710,2630,0
7203180070,20140919T000000,795000,4,3.25,3520,5250,3520,0
5416510200,20140929T000000,384950,4,2.5,2380,4913,2380,0
1931300977,20140508T000000,500000,3,1.75,1410,1197,1410,0
7853390260,20150205T000000,640000,4,3.5,3220,5741,3220,0
9578500810,20141121T000000,418000,4,3.25,3266,5969,3266,0
6844700575,20141010T000000,799000,3,2,2550,4794,2550,0
3751601877,20150320T000000,552900,4,3.5,3828,18900,3828,0
3869900136,20141219T000000,539950,3,2.25,1670,1596,1670,0
8956200960,20150120T000000,524225,4,2.5,3056,11385,3056,0
2883200083,20150202T000000,424950,2,1.5,1000,1188,1000,0
2028700570,20141125T000000,560000,3,3.25,1530,1786,1200,330
4188300030,20150429T000000,715000,5,3,3490,6091,3490,0
7883603648,20140522T000000,300000,5,2.5,2760,6000,2760,0
3630080030,20150224T000000,405000,3,2.5,1440,2163,1440,0
173000036,20141007T000000,327000,3,3,1370,1001,1370,0
2862500070,20141209T000000,859950,6,4,3180,6551,3180,0
7017200055,20150113T000000,560000,4,3,2720,7570,2720,0
3278611610,20140907T000000,379900,3,2.5,1800,2792,1800,0
4305500030,20150501T000000,625000,3,2.5,3220,6409,3220,0
255460240,20150423T000000,398096,3,2.5,2370,5321,2370,0
1773100416,20141120T000000,315000,3,2.5,1410,1325,1180,230
2937300560,20141212T000000,939000,4,3.5,3640,6049,3640,0
9510860560,20140725T000000,674000,3,2.5,1920,3624,1920,0
1085621740,20140814T000000,306000,4,2.5,2267,3577,2267,0
4139300135,20140709T000000,2.32E+06,5,4.75,5780,17004,4260,1520
5100400241,20150202T000000,394950,2,1,1131,1304,1131,0
2428100070,20140918T000000,914154,3,3.5,2940,6431,2940,0
726059485,20141117T000000,496000,3,2.5,2180,4533,2180,0
9834201370,20150417T000000,430100,3,2.25,1400,1078,940,460
8564860270,20140708T000000,449990,4,2.5,2680,5539,2680,0
8564860270,20150330T000000,502000,4,2.5,2680,5539,2680,0
3395071580,20150311T000000,310000,3,2.5,1300,3612,1300,0
3682000060,20150323T000000,349950,4,3.5,2796,3520,2796,0
1646500810,20140919T000000,625000,2,1.75,1460,1500,1000,460
7768800160,20140827T000000,1.05E+06,4,3.5,4210,6481,3260,950
3629980860,20140707T000000,680000,4,2.75,2330,3920,2330,0
629890070,20140515T000000,828950,4,3.5,3930,5680,2820,1110
7299600140,20150403T000000,274950,3,2.5,1608,4000,1608,0
1332700030,20150312T000000,293000,2,2.25,1610,1968,1610,0
3630220140,20140613T000000,795000,4,3.5,3200,3250,2670,530
301400240,20140922T000000,282900,4,2.5,1710,3500,1710,0
1233100710,20150416T000000,909950,5,3.75,3050,8972,3050,0
293070270,20141104T000000,922755,4,3.5,3560,4951,3560,0
3304030140,20150416T000000,424000,4,2.5,2650,8685,2650,0
5095401070,20150423T000000,630000,3,2.5,3490,12410,2590,900
6358900070,20141222T000000,810000,4,3.25,4140,46173,4140,0
8141310030,20140730T000000,256703,3,2,1670,4441,1670,0
7203140270,20140515T000000,386380,3,2.5,1720,3600,1720,0
8682320320,20140916T000000,485000,2,2,1510,3961,1510,0
9542840340,20150211T000000,275000,3,2.25,1450,4040,1450,0
3943600140,20150302T000000,370000,4,2.5,1812,5026,1812,0
2902200240,20140610T000000,499950,2,2.25,1060,1208,940,120
3274800505,20150424T000000,502000,3,2.5,1600,3073,1600,0
8080400136,20140620T000000,654000,3,3.25,1530,1565,1280,250
6371000079,20140714T000000,575000,4,2.25,2070,1230,1500,570
5379801920,20150415T000000,500000,4,2.5,3630,7482,3630,0
8562770320,20150114T000000,554000,3,2.5,2140,4126,1960,180
3449000200,20150508T000000,360000,4,1.75,2010,12188,1150,860
255470030,20150429T000000,619990,4,2.75,2630,4501,2630,0
629650030,20150312T000000,317500,4,2.5,2233,6025,2233,0
3574770030,20140828T000000,564950,4,2.75,2990,4521,2990,0
7589700055,20140611T000000,545000,2,1.25,1240,2150,1240,0
3832050570,20150501T000000,333700,3,2.5,2230,5050,2230,0
5167000140,20140711T000000,1.48E+06,3,3.25,3700,2264,2280,1420
9578060370,20150408T000000,530000,4,3,2290,5105,2290,0
2767604253,20150413T000000,396000,2,1.5,950,865,950,0
8562780800,20141016T000000,305000,2,1.75,1120,758,1120,0
603000926,20140522T000000,380000,5,3.5,2420,4670,2420,0
6817750510,20150303T000000,305000,4,2.5,1714,3250,1714,0
423059409,20140928T000000,440000,4,2.5,2230,5650,2230,0
522049074,20140627T000000,459000,4,3,2530,10000,2530,0
1934800193,20150306T000000,530000,3,3.5,1550,1233,1160,390
847100046,20150416T000000,600000,4,2.75,3110,11225,3110,0
1250200693,20140718T000000,515000,3,3,2100,2409,1660,440
7338220200,20150408T000000,275000,4,2.5,2150,3721,2150,0
1982201596,20150112T000000,540000,3,1.75,1630,1404,1020,610
7853270830,20140805T000000,445000,3,2.5,2230,7934,2230,0
9352900200,20150407T000000,285000,3,2.5,1320,955,1320,0
8850000517,20140731T000000,480000,3,2.5,1590,1431,1060,530
3395070560,20150120T000000,440000,5,3.25,2610,3642,2080,530
7211400576,20150211T000000,287450,3,2.5,1440,2500,1440,0
5169700132,20150401T000000,507950,4,2.5,2630,6283,2630,0
3204960200,20140619T000000,750000,3,3.5,3390,10078,3040,350
8024200681,20140703T000000,425000,3,1.5,1400,1022,1400,0
9358000550,20141202T000000,420000,3,3.5,1900,2133,1520,380
7625702444,20140510T000000,394950,3,2.5,1350,1250,1270,80
7853370260,20140711T000000,635000,4,3.25,3420,6752,3030,390
522079068,20150506T000000,513000,3,2.5,2150,161607,1330,820
3023000200,20150505T000000,380000,4,2.5,2110,5306,2110,0
3758900023,20140521T000000,1.13E+06,4,3.25,3810,8519,2680,1130
6204050160,20140608T000000,540000,5,3,2870,4369,2090,780
8562780200,20150427T000000,352499,2,2.25,1240,705,1150,90
7702600949,20150505T000000,603000,4,3.5,3610,6345,2370,1240
3442000127,20140530T000000,685000,4,2.5,2310,5100,2310,0
255550070,20140626T000000,330675,4,3,1930,3031,1200,730
7165700200,20140605T000000,275000,3,3,1390,1080,1140,250
8096800270,20140716T000000,259950,3,2.5,1578,7340,1578,0
4046500160,20140729T000000,441000,3,2,1720,15000,1720,0
7882600326,20141203T000000,1.14E+06,5,3.75,4700,11237,2930,1770
9122001230,20141205T000000,590000,3,3.5,1970,5079,1680,290
6373000187,20140918T000000,497000,3,2.25,1460,1353,1050,410
7967000200,20141121T000000,345500,3,2.5,1930,4000,1930,0
2902200241,20140623T000000,562500,3,2.25,1300,907,1000,300
291310390,20140904T000000,355000,3,2.25,1445,1087,1300,145
1604601572,20140905T000000,345000,2,2.25,860,696,860,0
259500270,20140505T000000,478000,3,2.5,3040,4535,3040,0
3166900270,20150402T000000,391500,3,2.5,2424,6143,2424,0
2926049582,20150412T000000,265000,2,1.5,1084,3427,1084,0
3438503230,20141030T000000,395000,3,2.5,2510,5320,2510,0
2827100075,20140727T000000,286308,2,1.5,1220,1036,1220,0
1702900624,20140527T000000,370000,2,2.25,1280,835,1080,200
2856100935,20140923T000000,1.08E+06,5,3.5,3740,5610,2860,880
301401620,20141015T000000,298900,3,2.5,1852,4000,1852,0
3630200520,20150421T000000,775000,4,2.5,2580,5787,2580,0
323079065,20140624T000000,790000,4,3.5,3190,31450,3190,0
7172200125,20140827T000000,1.05E+06,3,2.5,3400,5119,2300,1100
3057000400,20140708T000000,249000,2,1.5,1090,2686,1090,0
3022900070,20140929T000000,348000,3,2,2360,6145,2360,0
9406710060,20141114T000000,358000,5,2.5,2460,5604,2460,0
3353401070,20140625T000000,260000,5,2.5,2025,7760,2025,0
7853280570,20140604T000000,765000,4,3,4410,5104,3400,1010
6192410550,20140528T000000,739000,3,2.5,2810,5400,2810,0
8562710520,20140505T000000,890000,5,3.5,4490,6000,3200,1290
1543000060,20140607T000000,462000,4,2.5,3070,6432,3070,0
9536600810,20140708T000000,380000,4,2.5,1984,32400,1564,420
5428000070,20150511T000000,770000,5,3.5,4750,8234,3350,1400
2309000060,20140818T000000,641000,4,3.25,2760,4104,1900,860
8043700105,20150417T000000,2.30E+06,4,4,4360,8175,3940,420
7792000140,20150504T000000,369000,4,2.5,3060,27251,3060,0
5244801550,20140916T000000,1.11E+06,4,3,2770,2650,2180,590
9310300160,20140828T000000,357000,5,2.5,2990,9240,2990,0
6762700376,20141126T000000,650000,3,2.75,1540,1251,1230,310
1972200428,20140625T000000,563500,3,2.5,1400,1312,1400,0
7304301231,20140617T000000,345000,3,2.5,1680,2229,1680,0
9512200140,20140725T000000,479950,3,2,2260,7163,2260,0
7853400260,20140513T000000,660000,4,3.5,3400,5196,3400,0
97600140,20140729T000000,800000,4,2.5,2930,5000,2760,170
2822059360,20140724T000000,253101,3,2,1239,6036,1239,0
6056110200,20140929T000000,555000,3,3.5,2100,2479,1450,650
6300000226,20140626T000000,240000,4,1,1200,2171,1200,0
6300000226,20150504T000000,380000,4,1,1200,2171,1200,0
9524100196,20141117T000000,239000,2,1.5,680,772,680,0
3013300685,20150318T000000,760000,4,3.25,2690,3995,2060,630
2619950070,20140826T000000,430000,4,2.5,2750,7200,2750,0
7203110240,20140522T000000,660000,3,2.5,2450,4332,2450,0
7694200350,20140820T000000,399963,4,2.5,2620,4050,2620,0
7600136,20140718T000000,411000,2,2,1130,1148,800,330
1442880160,20140627T000000,483453,4,2.75,2790,5527,2790,0
3277801580,20141110T000000,469950,3,2,1820,1357,1820,0
1442880640,20140715T000000,504058,4,2.75,2910,7467,2910,0
3845101070,20150428T000000,425996,4,2.5,2568,5000,2568,0
6791900260,20140708T000000,760005,4,2.75,3090,5859,3090,0
9828702339,20150420T000000,699999,2,2,1460,1085,950,510
2255500125,20140716T000000,749950,3,2.5,2010,2263,1340,670
5541300135,20140708T000000,674600,4,2.5,2610,5140,2610,0
4083306616,20150224T000000,450000,2,1.5,960,1000,920,40
8096800260,20150407T000000,272000,3,2.5,1528,7616,1528,0
2997800024,20140714T000000,450000,2,1.5,1310,1264,1120,190
952005863,20150505T000000,643950,3,2.25,1760,2122,1760,0
7772850060,20141110T000000,290000,3,2.5,1420,3542,1310,110
6130500070,20141008T000000,378000,3,2.5,1650,2082,1650,0
8682300400,20140619T000000,728050,3,2.5,2320,6775,2320,0
8956200990,20150426T000000,499160,4,2.5,2628,11466,2628,0
9532000070,20141201T000000,536000,4,2.5,2520,4831,2520,0
7570050070,20150205T000000,419900,5,3.5,2880,5000,2260,620
946000295,20141210T000000,469000,3,2.25,1440,1362,1440,0
3831250350,20150408T000000,374000,3,2.5,2185,6042,2185,0
6056100160,20140728T000000,182568,4,1.5,1500,2106,1500,0
1402970070,20140626T000000,334888,3,2.5,1769,7324,1769,0
2524059267,20140917T000000,799900,4,4,3650,18223,3330,320
8091670030,20140512T000000,383000,4,2.5,2160,6223,2160,0
1825079046,20141218T000000,580000,3,2.5,1820,374616,1820,0
255450390,20140707T000000,351999,3,2.5,2370,4200,2370,0
9301300270,20150223T000000,1.33E+06,3,3,3180,2758,2240,940
9347300160,20150125T000000,312000,3,2.5,1780,4077,1780,0
710600070,20140912T000000,674950,4,3.5,2650,3127,2230,420
5556300116,20141229T000000,1.11E+06,5,2.75,3300,7560,3300,0
1324300126,20150313T000000,415000,2,2.5,1160,1219,1160,0
9279700013,20140710T000000,1.25E+06,3,3,3460,5353,2850,610
3336500140,20140919T000000,208800,3,2.5,1390,2450,1390,0
2767604212,20141029T000000,452000,2,2.5,1260,1131,1260,0
6719600030,20150422T000000,837000,5,2.75,2940,5225,2760,180
3204930510,20150224T000000,780000,5,3.5,3190,4247,2430,760
7582700075,20141002T000000,1.49E+06,4,3.5,3930,6120,3310,620
191100435,20140926T000000,1.60E+06,5,3.75,3570,10125,3570,0
255450030,20140918T000000,369946,3,2.5,2420,4725,2420,0
9476200710,20140608T000000,530000,3,2.75,3400,7200,2470,930
1329300070,20150320T000000,386000,4,2.5,2478,6079,2478,0
357000135,20150218T000000,1.90E+06,4,2.5,3070,7830,1970,1100
7203600560,20140911T000000,735000,4,3.5,3200,7605,2500,700
715010140,20141002T000000,1.75E+06,5,3.25,5790,12739,4430,1360
3869900138,20150223T000000,489950,3,2.25,1590,926,1590,0
2114700374,20150413T000000,357500,3,3,1730,1442,1440,290
9264450550,20140520T000000,329995,4,2.5,2303,3680,2303,0
3862710200,20140925T000000,414000,3,2.5,1790,3754,1790,0
291310310,20141210T000000,533500,3,3.5,2490,3517,1720,770
3814900260,20150305T000000,402395,4,2.5,2669,5385,2669,0
8562790710,20150410T000000,725000,4,3.25,2610,2552,2160,450
3425069117,20140828T000000,1.28E+06,6,5.25,6160,27490,4040,2120
2895800640,20140917T000000,239800,2,1.75,1290,1493,1290,0
3438500253,20140904T000000,616950,5,3.5,3560,5008,2810,750
3630200340,20141001T000000,1.26E+06,4,3.25,4360,6000,3400,960
2770601769,20140617T000000,435000,3,2.25,1230,1238,1080,150
2225069036,20140815T000000,925000,4,3.25,3640,60086,3640,0
9525600030,20150428T000000,631500,2,2.5,1780,2493,1780,0
993002108,20150330T000000,399995,3,1.5,1140,1069,1140,0
993000327,20140506T000000,369950,3,2,1270,1320,1270,0
1523059239,20150423T000000,475000,5,3.5,2780,3583,2180,600
7967000270,20141125T000000,353000,4,2.5,1912,5000,1912,0
7137800310,20150225T000000,329950,4,2.5,2300,9690,2300,0
2211300260,20150313T000000,367000,3,2.5,2828,4050,2828,0
8956200070,20140905T000000,447500,4,2.5,2425,9017,2425,0
1257201420,20140709T000000,595000,4,3.25,3730,4560,2760,970
1523300140,20140904T000000,325000,1,1,730,1942,730,0
9831200186,20150203T000000,690000,2,2.5,1990,1756,1780,210
7660100238,20141111T000000,329950,3,2.5,1300,812,880,420
5381000477,20150128T000000,399500,4,2.5,2560,7492,2560,0
207700180,20150121T000000,555000,5,2.5,2450,5047,2450,0
5288200072,20141001T000000,427000,2,1.5,1440,725,1100,340
9524100322,20141020T000000,375000,3,2.25,1140,1557,1140,0
1732800184,20140508T000000,499000,2,1.5,1110,957,930,180
1425069103,20140718T000000,750000,3,2.5,2620,43832,2620,0
8165500790,20141229T000000,336900,3,2.5,1690,1200,1410,280
7658600081,20140919T000000,555000,2,2.75,1950,1610,1950,0
1245003268,20141106T000000,1.28E+06,4,3.5,3530,8126,3530,0
8010100220,20141014T000000,999950,4,3.5,3310,4684,2290,1020
7974200452,20140625T000000,975000,5,3,2620,5477,2620,0
8943600360,20150219T000000,299000,3,2.25,1350,3582,1350,0
3026059361,20150417T000000,479000,2,2.5,1741,1439,1446,295
6130500120,20150417T000000,428000,3,2.5,1650,2201,1650,0
3575305485,20140829T000000,409000,3,2.5,1890,6500,1890,0
666000142,20150326T000000,798500,3,3,1950,1833,1610,340
7853280620,20141212T000000,689000,4,3.5,4490,5805,3390,1100
8946390040,20140508T000000,375000,6,2.25,3206,5793,3206,0
5416300230,20140717T000000,775000,4,3.5,4130,77832,4130,0
1604730150,20141014T000000,639983,5,3,2800,5700,2800,0
8669180150,20150326T000000,300000,4,3,1984,4419,1984,0
1081330180,20141222T000000,627000,4,2.5,2750,11830,2750,0
2309710230,20150415T000000,275000,3,2.75,1740,5757,1740,0
2895800610,20140926T000000,352800,4,2.25,1800,2752,1800,0
3362400092,20150312T000000,565000,3,2.25,1540,1005,1540,0
3052700385,20150414T000000,765000,4,2.25,2030,2222,1610,420
2738640040,20150409T000000,644000,4,2.5,3310,4839,3310,0
8024200674,20150223T000000,461000,3,1.5,1270,1416,1270,0
3353400092,20141223T000000,270500,5,2.5,2406,7093,2406,0
6003500749,20140701T000000,640000,2,2.25,1540,965,1540,0
8956200530,20140805T000000,457000,4,2.5,2820,6983,2820,0
133000271,20141201T000000,355000,5,2.5,2540,5100,2540,0
6749700063,20141215T000000,356000,2,2.25,1230,989,1230,0
3278613060,20140805T000000,425000,4,2.5,1900,2766,1900,0
7708200880,20140923T000000,562500,5,2.75,2920,6327,2920,0
2767600673,20140701T000000,460000,3,2.5,1450,1053,940,510
7299810040,20150406T000000,790000,4,3,5370,69848,3500,1870
993000308,20150318T000000,401000,3,2,1270,1333,1270,0
3364900040,20140828T000000,1.10E+06,3,2.5,2550,5100,2550,0
9578090180,20150403T000000,850000,4,3,3070,7150,3070,0
9542840120,20140702T000000,274500,3,2.25,1450,4050,1450,0
3860900035,20150415T000000,1.94E+06,5,3.5,4230,16526,4230,0
7202300040,20140804T000000,808000,4,2.5,3480,6262,3480,0
1773100972,20140515T000000,312000,3,2.25,1490,974,1220,270
3626039424,20140616T000000,320000,3,2.25,1200,1400,1200,0
3175200220,20150113T000000,410000,3,2.5,2150,4332,2150,0
7852120120,20140620T000000,725000,3,3.5,3690,8837,3690,0
7813500040,20141015T000000,335000,4,2.5,1900,3301,1900,0
7242800040,20150120T000000,519990,4,3.25,1690,1321,1320,370
1442880650,20140610T000000,533112,4,2.75,2790,8853,2790,0
3355400242,20141028T000000,274900,3,2,1936,6612,1936,0
8562780540,20141222T000000,325000,2,2.25,1150,711,1150,0
923049203,20140529T000000,350000,4,2.5,2040,22653,2040,0
3578600141,20140923T000000,550000,4,2.5,2470,7539,2470,0
53500450,20150309T000000,311850,4,2.5,1890,4158,1890,0
1934800180,20150210T000000,526000,3,2.5,1626,1583,1419,207
3023000210,20141001T000000,375000,4,2.5,2250,5306,2250,0
1773100967,20150223T000000,299999,3,2.25,1350,1234,1160,190
2767704777,20140919T000000,436000,3,2.5,1460,1238,1200,260
1085621960,20141212T000000,303000,3,2.5,2056,3564,2056,0
2771602174,20140701T000000,525000,2,2.5,1160,1458,1040,120
6762700452,20140613T000000,575000,3,3,1384,1287,1144,240
5695000142,20141024T000000,420000,2,1.5,1100,1107,1100,0
9578140180,20140611T000000,329950,3,2.5,2456,7566,2456,0
2124069115,20141021T000000,1.83E+06,4,4.25,4500,215186,2630,1870
3864000120,20150408T000000,1.18E+06,4,3.25,3780,10099,2240,1540
2768200212,20140911T000000,499950,2,2.5,1320,1157,990,330
7852070210,20140527T000000,1.15E+06,4,3,5940,11533,4950,990
7853361210,20150218T000000,400000,3,2,1650,5027,1650,0
8141310040,20140627T000000,246950,3,3,1670,4440,1670,0
6852700097,20140806T000000,630000,3,3.25,1610,1275,1220,390
7708210040,20140912T000000,561000,5,2.75,3370,10315,3370,0
53500760,20141208T000000,287000,4,2.5,2660,4082,2660,0
3528900771,20150331T000000,600000,3,3.25,1690,1473,1380,310
9126100813,20140828T000000,490000,3,2.25,1620,1062,1620,0
3679400503,20150330T000000,330000,3,1.75,1300,958,840,460
1760650210,20141201T000000,286950,4,2.5,1610,4052,1610,0
2652501565,20150423T000000,1.55E+06,3,3.25,3530,4920,2660,870
1237500577,20150212T000000,880000,4,2.5,3550,8618,3550,0
6382500084,20141013T000000,577450,3,3,1730,1755,1730,0
3023000410,20150430T000000,405000,5,2.75,2400,4900,2400,0
2767601752,20140707T000000,510000,3,2.5,1420,1237,1420,0
2771604196,20140812T000000,465000,2,1.5,1220,1120,1110,110
1778500620,20140707T000000,1.30E+06,4,2.25,2360,4000,2360,0
1823059241,20150408T000000,609000,4,3.5,3990,11270,2930,1060
9267200062,20140911T000000,336000,3,2.5,1260,1211,1260,0
3278606110,20150108T000000,375000,3,2.5,1580,2407,1580,0
1657530180,20141204T000000,294500,3,2.5,1760,2688,1760,0
2754700035,20141125T000000,925000,5,3.5,3420,4216,2520,900
2568200120,20141215T000000,730000,5,2.75,2870,6593,2870,0
6601200040,20140919T000000,280000,4,2.5,1934,5677,1934,0
2767601750,20140815T000000,500000,3,1.5,1220,962,1220,0
7853350220,20150324T000000,605000,3,2.75,2450,5750,2450,0
6163900628,20140516T000000,379950,3,3.25,1860,1787,1860,0
1689401526,20150323T000000,605000,3,2.5,1500,1119,1110,390
8725950360,20150501T000000,720000,2,1.75,1570,1108,1570,0
9826700697,20141103T000000,549900,3,2,1280,960,1040,240
9578500180,20150121T000000,427000,3,2.5,3192,5653,3192,0
9826700707,20141028T000000,492000,3,2.5,1690,1479,1420,270
8138870530,20140505T000000,419190,2,2.5,1590,1426,1590,0
4188300180,20141112T000000,650000,3,2.5,2870,7288,2870,0
5416510530,20141124T000000,379950,4,2.5,2580,4818,2580,0
4181200540,20140728T000000,269800,4,2.75,1830,3420,1830,0
2222059154,20140813T000000,407000,4,2.5,2927,6000,2927,0
8032700072,20150415T000000,580000,3,1.5,1320,1250,1320,0
7203140220,20150116T000000,389700,3,2.5,1720,3581,1720,0
1278000210,20150311T000000,110000,2,1,828,4524,828,0
6058600220,20140731T000000,230000,3,1.5,1040,1264,900,140
1442880610,20140829T000000,533380,4,2.75,2790,6685,2790,0
3679400484,20140918T000000,295500,3,2.5,1410,1332,960,450
3825310180,20141007T000000,860000,4,4.5,4040,8400,3220,820
3630220180,20140708T000000,812000,4,3.5,3370,3634,2750,620
3336500180,20140605T000000,324500,3,2.5,1660,3990,1660,0
2781270530,20150326T000000,193000,2,1.75,910,2550,910,0
993001563,20140522T000000,355000,3,2.25,1280,959,1280,0
9578060540,20140614T000000,525000,4,2.75,2360,4924,2360,0
2222059052,20150227T000000,370950,3,2.5,2529,9653,2529,0
1239400650,20141107T000000,1.24E+06,4,3.5,4700,10183,2660,2040
8835800450,20150504T000000,950000,3,2.5,2780,275033,2780,0
293070120,20140918T000000,888990,4,2.75,3540,5500,3540,0
1176001117,20150319T000000,705000,3,2.5,1580,1321,1080,500
7889601165,20140826T000000,268000,3,2.5,1700,2250,1700,0
7227801581,20140507T000000,305450,3,2.5,1600,3573,1600,0
9895000040,20140703T000000,399900,2,1.75,1410,1005,900,510
9528102993,20141229T000000,495000,3,1.5,1580,1228,1580,0
3746700120,20141104T000000,857326,3,3.5,3940,11632,3940,0
745530040,20140911T000000,845950,5,2.75,4450,9600,3650,800
7299600180,20140610T000000,303210,4,2.5,2009,5000,2009,0
2149800278,20141015T000000,343000,6,5,2732,7655,2732,0
2517000650,20140716T000000,300000,3,2.5,2090,4590,2090,0
6021503708,20141122T000000,334900,2,2.5,980,1013,980,0
8559300120,20150416T000000,477500,5,3.5,2815,5619,2815,0
3305100230,20140618T000000,820000,4,2.5,3170,8523,3170,0
2135200155,20140805T000000,580000,5,3.25,3030,7410,2150,880
2919700109,20140722T000000,350000,2,2.5,1280,940,1060,220
8725950220,20150226T000000,910000,3,2.5,2030,1160,1970,60
1776230220,20140626T000000,414000,3,2.5,2490,4540,2490,0
9211010230,20150330T000000,525000,3,2.5,3030,4500,3030,0
1972201772,20150409T000000,650000,2,2.5,1470,690,1470,0
9268851320,20141210T000000,450000,3,2.25,1620,997,1540,80
1424059154,20140516T000000,1.27E+06,4,3,5520,8313,3570,1950
626059365,20150412T000000,699000,3,3.5,3200,10344,3200,0
3885802136,20140723T000000,899000,4,2.5,2580,3943,2580,0
7967000150,20140808T000000,353500,4,3,2050,4000,2050,0
7853360720,20140908T000000,485000,3,2.5,2430,5867,2430,0
8562790150,20140626T000000,782900,4,3.25,3060,3898,2300,760
1226039124,20150428T000000,529000,2,2,1540,9714,1540,0
2767704251,20150416T000000,514700,3,3.25,1310,1072,1060,250
3862710210,20140520T000000,409316,3,2.5,1800,3168,1800,0
255460330,20150506T000000,388598,3,2.5,2370,4200,2370,0
291310610,20150227T000000,415000,3,2.25,1445,1512,1300,145
9126101121,20150407T000000,521500,3,2.25,1450,1619,1140,310
9274200322,20140820T000000,580000,3,2.5,1740,1236,1740,0
6666830230,20140630T000000,882566,4,2.5,3560,5265,3560,0
1604601803,20150408T000000,525000,3,2.75,2130,1400,1080,1050
7702080150,20141201T000000,515000,5,2.75,2980,4502,2980,0
7853400220,20140926T000000,589410,3,3,2840,7201,2840,0
3895100039,20150324T000000,757500,4,2.5,3420,6845,3420,0
7697000150,20141002T000000,284000,3,2.5,1660,4083,1660,0
8562780530,20150328T000000,338500,2,2.25,1150,711,1150,0
291310180,20140613T000000,379500,3,2.25,1410,1287,1290,120
1972205633,20140723T000000,550000,3,2,1420,1369,1340,80
3023000120,20140902T000000,294900,3,2.5,1860,5025,1860,0
7548301056,20140609T000000,345000,2,1.5,1340,1210,1120,220
9826701201,20150209T000000,450000,2,1.5,1530,1012,1200,330
6300500476,20150415T000000,420000,3,2.5,1509,1114,1509,0
2597490410,20150402T000000,740000,3,2.5,2350,3798,2350,0
3448001411,20150220T000000,286000,2,1.5,1010,825,1010,0
745530180,20150317T000000,870000,5,3.5,4495,10079,3580,915
3879900753,20141114T000000,727000,3,2.5,1580,991,1580,0
2781230230,20150204T000000,395000,4,3,2750,7965,2750,0
3629990180,20140805T000000,535000,4,2.25,1890,3615,1890,0
9352900222,20141229T000000,255000,3,2.25,1320,963,1040,280
7338220120,20141015T000000,260000,4,2.5,2150,3721,2150,0
325059287,20140910T000000,810000,4,2.5,3340,8384,3340,0
7203140360,20141201T000000,359782,3,2.5,1850,3400,1850,0
6056110150,20150320T000000,500000,2,2.5,1950,2162,1500,450
7203230040,20141027T000000,1.05E+06,5,3.25,4240,9588,4240,0
8121100155,20150225T000000,810000,4,3.5,2700,2868,1920,780
7853370620,20150206T000000,605000,5,4,3040,6000,2280,760
6400700264,20150317T000000,730000,4,2.5,2460,7930,2460,0
1760650880,20150317T000000,327000,4,2.5,2110,3825,2110,0
567000382,20141110T000000,370000,2,1,780,1133,780,0
7852100150,20140625T000000,459000,5,3.5,2640,6895,2640,0
6447300365,20141113T000000,2.90E+06,5,4,5190,14600,5190,0
2622059197,20141210T000000,365000,4,2.5,2420,8404,2420,0
1389600040,20141226T000000,255000,4,2.5,1987,6000,1987,0
9276200220,20140717T000000,375000,1,1,720,3166,720,0
7904700032,20141002T000000,375000,2,1.5,1130,912,1000,130
3744000040,20140722T000000,518380,4,2.5,2810,4500,2810,0
1773100604,20140721T000000,346000,3,3.25,1500,1442,1150,350
9268850360,20150223T000000,302059,4,2,1390,745,1390,0
7853420450,20140519T000000,575000,4,2.5,2500,4945,2500,0
8956200770,20140723T000000,549950,4,3.5,3906,9674,3906,0
2424059170,20150219T000000,900000,5,6,7120,40806,5480,1640
1934800133,20140711T000000,397500,3,2.5,1470,1256,930,540
5556300109,20141121T000000,1.08E+06,5,3.5,3230,7560,3230,0
2326600150,20150422T000000,775900,3,2.5,2700,5764,2700,0
3751600409,20150508T000000,510000,4,2.5,4073,17334,4073,0
3814900210,20140829T000000,471275,4,2.5,3361,5038,3361,0
9542840730,20140911T000000,288000,4,2.25,1610,3560,1610,0
2937300540,20141016T000000,989990,4,3.5,3830,7150,3830,0
7549800543,20140612T000000,300000,3,3.25,1470,1235,1180,290
4058800439,20140623T000000,664950,5,3,3190,7081,1890,1300
7853430180,20140716T000000,699188,4,3.25,3250,5478,3250,0
982850120,20150303T000000,390000,3,2.25,1490,4539,1490,0
9476010120,20150321T000000,670000,5,2.75,2900,5155,2900,0
5200087,20140709T000000,487000,4,2.5,2540,5001,2540,0
7308600040,20140723T000000,769995,5,2.75,3360,12080,3360,0
1498301048,20140508T000000,321950,2,1.25,860,1277,860,0
2738630040,20150427T000000,613500,4,2.5,3020,6068,3020,0
6300500081,20140806T000000,300000,3,2.5,1330,1200,1330,0
3845100620,20141125T000000,400950,4,2.5,2578,4554,2578,0
255450040,20140918T000000,389517,4,2.5,2640,4725,2640,0
880000211,20140821T000000,255000,3,1.75,1260,1133,810,450
2163900081,20150220T000000,1.08E+06,3,2.5,1990,1891,1990,0
7853370440,20141121T000000,637850,5,3.25,3340,4900,2500,840
3448900290,20140828T000000,636230,4,2.5,2840,6284,2840,0
263000006,20141216T000000,375000,3,2.5,1530,1131,1530,0
1972200882,20140604T000000,586500,3,2.5,1780,1487,1600,180
7853270630,20150120T000000,544000,4,2.5,2340,6973,1930,410
7852130430,20140806T000000,425000,4,2.5,2390,5021,2390,0
7383450250,20150311T000000,374950,4,2.5,2090,3777,2090,0
3449000010,20150312T000000,294570,3,1,1140,8400,1140,0
2690100170,20141013T000000,300000,3,2.5,1960,1477,1670,290
9578500920,20140910T000000,395950,5,3.5,2738,6031,2738,0
8562900430,20140718T000000,800000,4,2.5,3691,11088,3691,0
1442880380,20140730T000000,439990,3,2.5,2340,5171,2340,0
3204930170,20141106T000000,680000,4,3.5,2510,3763,1990,520
4449800480,20150318T000000,677790,6,3,2800,4213,2800,0
3862710010,20150501T000000,424950,3,2.5,1650,4777,1650,0
301402280,20150331T000000,223990,2,2.25,1061,2884,1061,0
2867300170,20150513T000000,498000,4,2.5,3402,14355,2846,556
5635100080,20141031T000000,359950,4,2.5,2542,6120,2542,0
1624079024,20140515T000000,720000,3,2.5,3150,151588,3150,0
9211010840,20141112T000000,530000,4,2.5,3010,9000,3010,0
7697000020,20141007T000000,295000,3,2.5,1660,4898,1660,0
3832050130,20141021T000000,255500,3,2.5,1770,5000,1770,0
3630240020,20140521T000000,556000,3,3,1960,1168,1600,360
1389600080,20140710T000000,277950,4,2.5,1889,6000,1889,0
2781230080,20150408T000000,431000,4,2.5,3040,6000,3040,0
7203100660,20141117T000000,780000,4,2.75,3420,6787,3420,0
1806900502,20141014T000000,649000,3,3.25,1720,936,1030,690
3022800010,20140714T000000,447000,3,2.5,1740,3043,1740,0
6666830250,20140505T000000,712198,4,2.5,2450,4247,2450,0
7242800020,20140815T000000,277140,3,1.5,1190,785,920,270
2867300190,20140528T000000,363000,4,2.5,3753,7204,3336,417
8564860130,20150202T000000,598992,5,3.5,3440,6037,3440,0
2770603522,20141211T000000,585000,3,2.5,2160,1250,1830,330
9544200422,20140731T000000,1.27E+06,4,2.75,3820,8850,3820,0
4253400104,20150212T000000,380950,2,2,1120,1039,840,280
1085622890,20140708T000000,333490,4,2.5,2250,3916,2250,0
9268851630,20140604T000000,520000,3,3.25,1540,1487,1540,0
8562780190,20141007T000000,315000,2,2.25,1240,705,1150,90
2767600686,20150331T000000,487000,2,1.5,1160,1118,1020,140
7207900080,20140808T000000,424950,5,3.5,2760,3865,2760,0
2770601457,20150210T000000,542300,3,2.25,1580,1487,1580,0
1773100920,20141211T000000,320000,3,3.25,1480,1192,1180,300
1024069027,20140723T000000,1.14E+06,4,3.25,3740,11467,3740,0
7853361310,20141215T000000,425000,4,2.5,1950,5000,1950,0
6824100029,20141031T000000,474950,3,3,1530,1568,1530,0
255450250,20140804T000000,307635,3,2.5,1820,4200,1820,0
2428100130,20141210T000000,834538,3,2.5,2760,6187,2760,0
1042700050,20140723T000000,769995,5,2.75,3010,5398,3010,0
7853280250,20150424T000000,820875,5,3.25,3860,9387,3860,0
7853410170,20150316T000000,595500,4,2.5,2490,6537,2490,0
2708450020,20140912T000000,450000,4,2.5,3236,9608,3236,0
7852140170,20150421T000000,695000,4,2.5,2830,14538,2830,0
1459920010,20150323T000000,300000,3,2,1451,7159,1451,0
3438500250,20140623T000000,515000,5,3.25,2910,5027,2040,870
1890000169,20140903T000000,545000,3,2.5,1280,1845,1280,0
1250200414,20150218T000000,365000,3,2.25,1110,979,960,150
2564900470,20140714T000000,718500,4,2.75,2840,8800,2840,0
2895800780,20150401T000000,279800,3,1.75,1410,2052,1410,0
6306800050,20140925T000000,486940,4,2.5,3250,13360,3250,0
6928000605,20140626T000000,525000,4,2.75,3030,6625,3030,0
3814900950,20140725T000000,345000,4,2.5,1983,6002,1983,0
8562770080,20141030T000000,613000,3,3.25,2440,2812,1710,730
3831250130,20140825T000000,370000,3,2.5,2313,5700,2313,0
3629990020,20141002T000000,449500,3,2.25,1260,2556,1260,0
9532000010,20150416T000000,515000,3,2.5,2000,3837,2000,0
8562780430,20150504T000000,346100,2,1.75,1150,698,1150,0
2781230020,20141209T000000,398500,4,2.5,2820,6666,2820,0
8658301060,20140820T000000,310000,2,1.75,1160,2500,1160,0
301402140,20150226T000000,250000,3,2.25,1481,2820,1481,0
8923600020,20140806T000000,1.88E+06,5,3.5,4390,6220,3170,1220
8725950020,20140827T000000,695000,2,1.75,1570,1207,1570,0
1121000357,20140827T000000,1.09E+06,4,3,3410,6541,2680,730
1042700290,20140804T000000,864327,5,3.25,3480,6507,3480,0
7308600010,20140616T000000,749995,4,3.25,3430,9870,3430,0
7708210050,20140610T000000,525000,5,2.75,2880,8364,2880,0
5631500285,20141121T000000,659950,3,2.5,2990,9413,2990,0
524059063,20140506T000000,1.80E+06,5,5,4490,10279,3930,560
7203160190,20141029T000000,950000,5,4,4100,8120,4100,0
1692900095,20140618T000000,1.40E+06,4,2.75,3870,10046,3870,0
3438500346,20140702T000000,265050,2,1.5,800,2119,800,0
9268850290,20150306T000000,450000,3,2.25,1620,1057,1540,80
2419700080,20150505T000000,915000,4,2.5,2910,4356,2910,0
1235700052,20140630T000000,963000,4,3.25,3530,8589,3530,0
4233800020,20141008T000000,270000,4,2.5,2701,5821,2701,0
3278612570,20140724T000000,294000,2,2.5,1380,889,1140,240
6638900461,20140605T000000,700000,3,2.5,2050,4185,2050,0
4233600190,20150316T000000,1.07E+06,3,4,3370,8252,3370,0
7987400285,20150429T000000,494900,3,2.5,2040,2500,1470,570
9532000500,20140801T000000,415000,3,2.5,1610,3600,1610,0
8564860280,20140502T000000,459990,3,2.5,2680,5539,2680,0
8691440440,20141003T000000,882990,4,3.5,3560,6562,3560,0
1099950050,20141229T000000,620000,4,3.5,3880,8244,3060,820
3304040130,20150212T000000,375900,3,2,1824,7120,1824,0
8562790480,20141006T000000,654000,3,2.5,2220,2873,2010,210
4457300005,20150325T000000,1.84E+06,4,3.25,4140,11007,4140,0
8856003839,20141210T000000,215000,3,2.5,1322,6006,1322,0
1972200728,20141124T000000,630500,3,2.5,1909,1300,1766,143
8691420050,20141107T000000,855000,4,3.5,3460,7702,3460,0
6601200020,20150127T000000,235245,4,2.5,1954,5075,1954,0
200480020,20140710T000000,770000,5,2.5,3000,7912,1610,1390
7203170190,20140619T000000,734990,4,2.5,2650,6884,2650,0
3885802134,20150109T000000,880000,4,2.5,2580,3436,2580,0
9578060420,20150114T000000,525000,4,3,2650,4924,2650,0
3630200080,20140807T000000,775000,4,3.5,3390,3960,3390,0
3876900089,20150430T000000,687015,3,1.75,1470,873,1470,0
3630130130,20141112T000000,663000,3,2.5,1910,5125,1910,0
3326059253,20150330T000000,815000,4,2.5,3030,7187,3030,0
2224069109,20150427T000000,1.05E+06,4,3.25,2930,25020,2930,0
3862700020,20150423T000000,433190,3,2.5,1650,2787,1650,0
3629980080,20141210T000000,725000,4,2.5,2870,5118,2870,0
7299600950,20150408T000000,279950,3,2.5,1608,4800,1608,0
5528600005,20150327T000000,272167,2,2.5,1620,3795,1620,0
3052700419,20140616T000000,468500,3,2.5,1350,1186,1120,230
9542840630,20140602T000000,298000,3,2.5,1950,3600,1950,0
7896300592,20150114T000000,303500,6,4.5,3390,7200,2440,950
9268850480,20150410T000000,308000,3,1.75,1300,1237,1060,240
3629700020,20150415T000000,646800,3,3,2230,1407,1850,380
8648900010,20150102T000000,530200,4,2.5,1880,3853,1880,0
5422950170,20141112T000000,405000,5,2.5,3370,5092,3370,0
2768200213,20140724T000000,529000,2,2.5,1320,1395,990,330
642150080,20140908T000000,675900,3,2.5,2920,9096,2920,0
2770601912,20150402T000000,570000,3,3.25,1550,1280,1220,330
3304040020,20141226T000000,375500,4,2.5,2301,6452,2301,0
3629960170,20141021T000000,445000,3,3.25,1710,1960,1360,350
1238900130,20150105T000000,1.10E+06,4,3.75,2890,4164,2240,650
6056100114,20140825T000000,477000,3,2.5,2100,5060,2100,0
4140940130,20141121T000000,450000,3,2.75,2240,3360,2100,140
6824100007,20150326T000000,427005,3,3,1460,1200,1460,0
1959700225,20150224T000000,720000,3,1.75,1370,1990,1370,0
518500460,20141008T000000,2.23E+06,3,3.5,3760,5634,2830,930
923059252,20140527T000000,450800,4,3.25,2510,5311,2510,0
3052700213,20140829T000000,461100,2,2.25,1210,1267,1120,90
2428100080,20141001T000000,1.06E+06,4,3,2990,6695,2990,0
9276202130,20150408T000000,590000,3,2.5,1710,2875,1710,0
3845100670,20140716T000000,478830,4,2.5,3274,4950,3274,0
4319200675,20140709T000000,760000,4,2.25,3300,8365,3300,0
323059327,20140703T000000,1.03E+06,4,3.5,4370,10860,4370,0
3448720020,20140613T000000,385000,4,2.5,2050,5276,2050,0
7234600832,20140516T000000,500000,2,2.5,1310,1500,1160,150
4045500950,20150415T000000,425000,3,1.5,1680,8000,1680,0
7234600098,20140905T000000,552100,3,3,1330,1379,1120,210
666000143,20141229T000000,785000,3,3,1950,1983,1610,340
3343903611,20150323T000000,615000,5,3.25,3090,7069,3090,0
1760650950,20150423T000000,309000,3,2.5,1950,3825,1950,0
5100403818,20150220T000000,369500,3,2,1108,1128,1108,0
2325400170,20150211T000000,391000,4,2.25,2190,3850,2190,0
5700000446,20141029T000000,465000,3,1.75,1590,1322,1060,530
9492500010,20140606T000000,879950,4,2.75,3010,7215,3010,0
2461900446,20141023T000000,372000,3,2,1330,1042,1060,270
8669160170,20140522T000000,259000,3,2.5,1550,3569,1550,0
3644100101,20140707T000000,374000,2,1.5,1260,1575,1260,0
7852090680,20150305T000000,561000,4,2.5,2550,5395,2550,0
5693501028,20150403T000000,610000,3,2.5,1300,1331,1300,0
3629700080,20150108T000000,635000,3,3,2230,1407,1850,380
3278600680,20140627T000000,235000,1,1.5,1170,1456,1070,100
2738640470,20140716T000000,623300,4,3.5,4170,4524,3500,670
7853320950,20141023T000000,412500,3,2,1680,5246,1680,0
5635100050,20141121T000000,380000,4,3.25,2864,8035,2864,0
3629990280,20140623T000000,497000,3,2.25,1630,3817,1630,0
6306800020,20141111T000000,452000,4,2.5,2716,7850,2716,0
7697000170,20141025T000000,312000,3,2.5,1750,4076,1750,0
5057100080,20140919T000000,469950,5,3,3223,6371,3223,0
5276200020,20140805T000000,775000,5,2.5,2600,4284,2600,0
5727500006,20150427T000000,679990,4,2.75,3320,8653,3320,0
9268850130,20140627T000000,288790,4,2,1350,942,1350,0
9293000170,20150408T000000,800000,5,2.5,3410,4726,3410,0
7299601870,20150427T000000,299000,3,2.5,1572,4000,1572,0
1760650500,20150129T000000,332000,4,2.5,2300,4482,2300,0
7174800094,20150420T000000,525000,1,1.5,1030,5923,1030,0
6909200007,20140903T000000,620000,3,1.75,1458,858,950,508
7853321150,20141103T000000,452000,4,2.5,2190,6896,2190,0
1105000402,20141028T000000,630000,4,3,3640,5096,2740,900
1442870420,20140724T000000,485000,4,2.75,2790,7803,2790,0
3682000050,20141013T000000,349950,4,2.5,2632,4117,2632,0
1442880080,20140701T000000,499990,4,2.75,2910,6334,2910,0
7169500020,20141205T000000,510000,2,2.25,1470,1101,1340,130
2911700010,20150303T000000,1.08E+06,3,2.5,2240,21477,2240,0
9578060470,20140508T000000,494000,3,2.5,2310,4729,2310,0
1776460190,20140626T000000,429900,3,2.5,2370,5353,2370,0
3449500050,20141015T000000,505000,4,2.75,2980,9825,1910,1070
2309710130,20140715T000000,272000,4,2,1870,6551,1870,0
1972201511,20150210T000000,671500,3,2.5,1770,1714,1770,0
7852120050,20150311T000000,729950,4,3.5,3510,10010,3510,0
3814900660,20140721T000000,471835,4,2.5,3281,5354,3281,0
8141310080,20141103T000000,249950,3,2,1670,4438,1670,0
7207900050,20140808T000000,424950,5,3.5,2760,3846,2760,0
2424059163,20140709T000000,1.24E+06,5,3.5,5430,10327,4010,1420
2140950130,20140911T000000,440000,4,2.5,2990,7928,2990,0
1776230190,20150408T000000,495000,4,3.5,3170,3858,2530,640
3524039224,20140513T000000,870000,4,2.5,3520,6773,2650,870
5694500840,20141125T000000,559000,2,3,1650,960,1350,300
4014400381,20140507T000000,495000,4,2.75,2656,21195,2656,0
2838000130,20150213T000000,722000,3,2.5,2230,4850,2230,0
8562770430,20140702T000000,567500,3,2.5,2280,2502,1880,400
1402970020,20141217T000000,440000,4,2.5,2798,5085,2798,0
3943600020,20140829T000000,400000,4,2.5,2398,5988,2398,0
1438000430,20141006T000000,459995,4,2.5,2350,3760,2350,0
1601600167,20140507T000000,365000,5,2.75,2410,5003,1410,1000
1773100541,20150417T000000,389950,3,2.25,1580,920,1580,0
1773100924,20140708T000000,320000,3,3.25,1450,1387,1180,270
982850080,20140613T000000,415500,4,2.5,1750,4779,1750,0
7628700050,20150309T000000,775000,3,2.5,3020,4120,2360,660
8673400020,20150311T000000,590000,3,3,1740,1100,1740,0
8725950170,20150123T000000,950000,2,2.25,2200,2043,1760,440
6306800080,20140806T000000,378950,4,2.5,1867,15314,1867,0
3362401763,20140508T000000,441750,2,1.5,1020,1060,1020,0
301401630,20141031T000000,335900,4,2.75,2475,4000,2475,0
6056110780,20140627T000000,229800,2,1.75,1110,1773,1110,0
6819100352,20150310T000000,645000,3,2.5,1900,1258,1700,200
9297302031,20150423T000000,448000,3,3.25,1560,1345,1260,300
7203150080,20141216T000000,706000,4,2.5,2510,5436,2510,0
2937300050,20150227T000000,988990,4,4.75,4150,6303,4150,0
9521100029,20140716T000000,716000,3,3,1660,1849,1660,0
832700170,20150421T000000,319000,2,1.5,1090,847,1090,0
6817750440,20141014T000000,300000,4,2.5,1914,3272,1914,0
123059127,20140502T000000,625000,4,3.25,2730,54014,1560,1170
3630200430,20140514T000000,773000,3,2.75,2470,3600,2470,0
3448740430,20140925T000000,392000,5,2.5,2340,5670,2340,0
1438000190,20140911T000000,549995,4,3.5,2660,5690,1920,740
7853320250,20140920T000000,480000,3,2.5,2410,4656,2410,0
100300280,20141020T000000,355000,3,2.25,1430,4777,1430,0
8862500280,20141230T000000,208400,2,2.5,1570,1268,1570,0
1042700080,20140822T000000,831548,5,2.75,3010,4919,3010,0
4051150080,20141117T000000,279500,4,2.5,1613,4338,1613,0
5592200010,20150227T000000,445000,3,2.5,2380,5269,2380,0
7787920080,20140616T000000,492500,5,2.5,2570,9962,2570,0
3448740190,20140709T000000,435000,4,2.5,2550,5200,2550,0
8822900122,20150512T000000,325000,3,2.25,1330,969,1330,0
4083300098,20141117T000000,453000,2,1.5,1160,1269,970,190
1438000170,20140822T000000,612995,5,3.5,3240,6919,2760,480
7853360480,20140904T000000,540000,4,2.5,2710,9248,2710,0
522059130,20150429T000000,465000,3,1,1150,18200,1150,0
4385700185,20140812T000000,799950,3,2.25,1860,1386,1860,0
2768301476,20141124T000000,495000,3,2.25,1280,1517,1080,200
1862400541,20150228T000000,579950,3,2.5,1810,1585,1810,0
8562780280,20150220T000000,331000,2,2.25,1240,720,1150,90
9528101061,20140825T000000,580000,4,3.5,1460,951,1460,0
6056110460,20150414T000000,669000,2,2.5,1640,1953,1640,0
2154970020,20140703T000000,2.35E+06,4,4.25,5010,19412,4000,1010
5694500497,20150116T000000,539900,3,3.25,1300,1325,1080,220
7708200670,20140723T000000,490000,4,2.5,2510,4349,2510,0
8562770050,20140527T000000,627000,3,3.5,2710,3475,1650,1060
1441000470,20140728T000000,458000,4,3.5,3217,4000,2587,630
6056100293,20141110T000000,440000,3,2.5,1650,4929,1520,130
6600000050,20150310T000000,1.70E+06,4,3.5,3950,6240,3950,0
1732800199,20150511T000000,935000,2,2.5,1680,977,1680,0
7853360470,20150417T000000,641000,5,3.5,3420,6403,2700,720
3438501583,20140911T000000,452000,3,2.75,2300,5090,1700,600
7853370250,20141223T000000,625000,4,2.75,3010,6854,2570,440
2387600010,20150303T000000,1.35E+06,4,3.5,4680,12495,3040,1640
8946780080,20140908T000000,834950,5,3.5,3630,4911,2790,840
9402800005,20141028T000000,1.50E+06,3,3.5,3530,3610,2370,1160
5422950080,20140825T000000,305000,4,2.5,2280,3800,2280,0
2826079027,20141112T000000,659000,3,2.5,3090,384634,3090,0
6003000851,20140522T000000,353000,1,1,550,1279,550,0
7394400080,20150304T000000,535000,4,3.25,2840,4000,2330,510
1238501184,20140708T000000,999000,4,2.5,3130,10849,3130,0
263000009,20150129T000000,375000,3,2.5,1440,1102,1440,0
5101408889,20140616T000000,685000,4,3.5,2840,4637,2840,0
7299601410,20140808T000000,333000,4,2.5,2623,7184,2623,0
9266700190,20150511T000000,245000,1,1,390,2000,390,0
2424059174,20150508T000000,2.00E+06,4,3.25,5640,35006,4900,740
8562780290,20141015T000000,329950,2,2.25,1260,1032,1170,90
5100400244,20150420T000000,403000,2,1,894,1552,894,0
3744000130,20141111T000000,559630,4,2.5,3370,4934,3370,0
993001976,20140818T000000,344000,3,2.25,1250,871,1250,0
525049174,20150402T000000,435000,3,1.5,1180,1231,1180,0
5393600562,20140522T000000,430000,2,2.5,1520,1588,1240,280
4187000190,20141117T000000,417000,3,2.5,2000,4500,2000,0
2862500190,20150409T000000,895950,5,2.75,3180,9255,3180,0
5045700470,20150319T000000,563950,4,2.75,3050,4750,3050,0
2924079034,20140925T000000,332220,3,1.5,2580,47480,1360,1220
8835770170,20140822T000000,1.49E+06,5,6,6880,279968,4070,2810
3630200480,20140612T000000,680000,3,2.5,2570,3600,2570,0
8562790080,20150209T000000,825750,4,3.5,2950,3737,2270,680
8165500780,20141209T000000,338000,3,2.5,1690,1760,1410,280
1442870050,20140718T000000,535365,4,2.75,2790,6969,2790,0
1704900303,20141211T000000,608000,3,2.25,1720,5234,1240,480
6132600655,20141016T000000,930000,3,2.25,2890,5000,2890,0
3421069049,20141021T000000,565000,2,1.75,1130,276170,1130,0
7169500130,20141219T000000,495000,2,2.25,1460,1623,1260,200
8732900840,20140722T000000,667000,3,2.5,2510,3819,2510,0
5379803372,20141112T000000,495000,4,2.5,3390,7870,3390,0
2937300430,20140929T000000,928990,4,2.5,3570,6054,3570,0
5422950020,20140630T000000,345000,4,2.5,2280,5000,2280,0
3797001702,20141216T000000,1.07E+06,5,3.5,2920,3000,2260,660
1438000130,20140703T000000,519995,4,3,2590,6160,2590,0
1853080130,20141105T000000,924000,5,2.75,3210,8001,3210,0
741500010,20150424T000000,295000,3,2,1230,3405,1230,0
3123089027,20140721T000000,472000,3,2.5,3800,104979,3210,590
3630080190,20140801T000000,405000,3,2.5,1500,2314,1500,0
3782760080,20140718T000000,410000,4,2.25,2510,4090,1840,670
8024200684,20141125T000000,419500,3,1.5,1400,1091,1400,0
982850020,20140903T000000,382000,3,2.25,1450,4667,1450,0
5649600462,20150224T000000,370000,2,2.5,1390,1821,1180,210
3449820430,20141006T000000,553000,3,2.75,3160,9072,3160,0
9533100285,20140630T000000,2.07E+06,4,3.75,4350,7965,4350,0
923059259,20150401T000000,455950,4,2.5,2720,5771,2720,0
6431000748,20141027T000000,331000,3,3.25,1290,1153,1290,0
3753000010,20140507T000000,417250,3,2.25,1606,1452,1606,0
6169901185,20140520T000000,490000,5,3.5,4460,2975,3280,1180
2309710150,20140804T000000,325000,4,3.25,2800,5291,2800,0
1773600264,20150223T000000,705000,5,3.5,3250,4800,2410,840
6061500100,20140717T000000,1.17E+06,6,3.5,4310,7760,3260,1050
1282300995,20150222T000000,365000,3,2.25,1310,915,1060,250
597000593,20141117T000000,403000,2,1.5,1240,1101,1080,160
7853321110,20140813T000000,409000,3,2.5,1950,7263,1950,0
3278612450,20150407T000000,391000,3,2.5,1800,1120,1800,0
1438000120,20140616T000000,542525,4,2.5,2650,5600,2650,0
9521100301,20140507T000000,339950,2,1,820,681,820,0
1442870040,20140819T000000,499990,4,2.75,2620,7001,2620,0
644000115,20140923T000000,1.77E+06,4,3.25,3980,10249,3980,0
6372000297,20150323T000000,608000,3,3.5,1660,2298,1260,400
6600060150,20150312T000000,392000,4,2.5,2130,4028,2130,0
774101755,20150417T000000,320000,3,1.75,1790,66250,1790,0
2895800750,20150417T000000,274800,3,1.75,1410,1988,1410,0
2424039029,20150427T000000,325000,3,2.25,1330,1198,1080,250
3448740360,20150429T000000,418500,4,2.5,2190,4866,2190,0
3832050580,20140502T000000,300000,3,2.5,2540,5050,2540,0
3094000210,20150105T000000,269950,3,2.5,2244,4079,2244,0
321030150,20150506T000000,358000,3,2.5,2026,7611,2026,0
7694200090,20150504T000000,350000,3,2.5,1730,4086,1730,0
3299710110,20140528T000000,782000,4,3.5,3910,8095,3130,780
3879900754,20140915T000000,779000,3,2.5,1580,1487,1580,0
8732900300,20141217T000000,685000,4,2.5,2510,3479,2510,0
6021503698,20140529T000000,305000,2,2.25,1000,905,1000,0
3333000745,20150417T000000,350000,4,2.5,1660,2500,1660,0
3630220220,20140923T000000,775000,4,3.5,3060,4573,2410,650
9478500180,20140828T000000,317750,3,2.5,1980,4500,1980,0
2771602427,20140508T000000,438000,2,1,980,1179,980,0
1498301168,20140528T000000,325000,2,2.5,1050,1609,1050,0
8562790580,20150428T000000,830000,4,3.25,3080,4287,2230,850
2325400040,20140922T000000,353000,3,2.25,1900,3800,1900,0
5045700330,20140725T000000,460000,4,2.5,2200,6400,2200,0
3126049498,20150316T000000,370000,3,1.5,1360,1167,1360,0
9578140360,20140619T000000,330000,3,2.5,2238,7209,2238,0
3343901408,20150128T000000,569888,4,2.5,2590,6474,2590,0
7859910110,20140918T000000,353900,3,2.5,2517,3900,2517,0
7852120180,20150304T000000,695000,4,3.5,3510,9084,3510,0
9268850180,20140718T000000,288790,3,1.75,1290,1237,1060,230
6031400092,20150213T000000,334950,5,3,2230,8642,1330,900
1853080790,20141215T000000,869950,4,2.75,3140,7928,3140,0
1624049291,20141008T000000,557500,3,3.5,3350,5025,2670,680
7237450100,20140919T000000,389990,4,2.5,2245,4330,2245,0
9521100214,20140604T000000,455000,3,1.75,1420,1189,1420,0
5693501102,20141030T000000,598500,3,3,1560,2091,1560,0
6891100590,20150302T000000,750000,4,2.75,2810,5497,2810,0
2254501095,20141113T000000,729999,2,2.25,1630,1686,1330,300
9478550110,20150303T000000,299950,3,2.5,1740,4497,1740,0
993001961,20140709T000000,374950,3,2.25,1390,1484,1390,0
9274200028,20150219T000000,386950,3,2.5,1070,1089,900,170
7708200180,20140710T000000,535000,5,3.25,2850,4551,2370,480
8691430330,20140831T000000,890000,5,3.25,4100,7578,4100,0
8924100308,20150203T000000,1.05E+06,4,2.5,3260,5974,2820,440
1070000180,20141015T000000,1.11E+06,4,3.5,3660,4760,2840,820
1085623630,20141003T000000,436952,4,2.5,2708,4772,2708,0
3278605550,20140609T000000,365000,3,2.5,1800,2700,1800,0
1139000062,20140625T000000,288000,3,2.5,1150,887,1150,0
2838000180,20150220T000000,700000,3,2.5,2230,4006,2230,0
2725079018,20140509T000000,800000,4,3.25,3540,159430,3540,0
7104100110,20150511T000000,899000,4,3.5,2490,5500,1780,710
259500230,20141218T000000,465750,3,2.5,2670,4534,2670,0
9523100712,20140618T000000,485000,2,2.5,1430,923,1410,20
1438000360,20140603T000000,494995,5,2.75,2670,3800,2670,0
1608000120,20150202T000000,255000,3,2.5,2555,5720,2555,0
7853361120,20140729T000000,530000,3,2.5,1970,6295,1970,0
2461900448,20140616T000000,435000,3,2,1980,2674,1980,0
1703400910,20140811T000000,639000,3,2.5,2010,3300,1610,400
8024200683,20140709T000000,440000,3,1.5,1270,1413,1270,0
9544700730,20140515T000000,914500,4,2.5,3950,10856,3950,0
8682320900,20141105T000000,580000,3,2,1870,5300,1870,0
3278600750,20150407T000000,250000,1,1.5,1180,1688,1070,110
5676000008,20150316T000000,410000,3,2.5,1420,1269,1420,0
3744000150,20140928T000000,531155,4,2.75,2810,5046,2810,0
3630080120,20140919T000000,358000,3,2.5,1400,1529,1400,0
7853360620,20140701T000000,425000,3,2.5,1950,5689,1950,0
255550100,20140711T000000,326000,3,2.25,1930,3462,1930,0
9268200484,20140513T000000,650000,4,2.5,2210,4861,2210,0
8562790720,20150514T000000,749950,4,3.5,2630,3757,2200,430
7140700690,20150312T000000,239950,3,1.75,1600,4888,1600,0
3624039183,20140609T000000,315000,3,2.5,1480,1590,1150,330
2254502071,20140523T000000,375000,2,2.5,750,1430,750,0
4310702838,20150427T000000,375000,3,1.5,1290,1213,1290,0
6431000749,20140922T000000,349000,3,3.25,1340,1151,1340,0
3362401761,20150225T000000,450000,2,1.5,1020,1049,1020,0
3629700120,20141014T000000,669950,3,3,2330,1944,1950,380
3226049565,20140711T000000,504600,5,3,2360,5000,1390,970
567000408,20140602T000000,400000,3,2.5,1495,936,1405,90
825059349,20140701T000000,1.02E+06,4,3.5,3770,8501,3770,0
7787920230,20150408T000000,518000,5,2.5,2890,13104,2890,0
5694000706,20140813T000000,535000,3,2.75,1320,1125,1320,0
1760650900,20140721T000000,337500,4,2.5,2330,4907,2330,0
2021000180,20150310T000000,380000,4,2.5,3120,5001,3120,0
6400700389,20140710T000000,875000,5,3,2960,15152,2960,0
6431000987,20140902T000000,385000,3,2.25,1630,1598,1630,0
2311400056,20141201T000000,1.99E+06,5,3.5,5230,8960,4450,780
3224059107,20150508T000000,649500,4,3,3150,6599,3150,0
1245002281,20140512T000000,1.05E+06,4,3.75,3280,11000,2320,960
121039156,20150109T000000,249000,3,1,1030,24750,1030,0
9211000110,20141003T000000,525000,4,2.5,3130,5795,3130,0
7625702263,20140612T000000,402000,3,3.5,1240,1666,1000,240
8085400586,20141101T000000,1.75E+06,4,2.75,3560,8975,3560,0
2895800590,20141020T000000,359800,5,2.5,2170,2752,2170,0
100300530,20140925T000000,330000,3,2.5,1520,3003,1520,0
4092302096,20150325T000000,433000,3,2.5,1270,1062,1060,210
7010700308,20141112T000000,1.01E+06,4,3.25,3610,4000,2640,970
7853370100,20150406T000000,599832,3,2.75,3230,5200,2680,550
6181500120,20140623T000000,312891,5,3,2300,8214,2300,0
567000775,20140912T000000,449000,2,2.5,1460,1296,1160,300
3331000035,20140527T000000,495000,3,2.5,1750,1548,1750,0
4216500110,20140515T000000,819995,5,2.75,3030,10335,3030,0
2776600082,20141113T000000,407500,3,3.5,1522,1465,1248,274
323079058,20150105T000000,850000,4,3.75,3890,22000,3890,0
1088100450,20140725T000000,1.72E+06,5,4,4590,35046,4590,0
98300230,20150428T000000,1.46E+06,4,4,4620,130208,4620,0
847100047,20140917T000000,579000,4,2.75,3220,9825,3220,0
1853080150,20140811T000000,890776,5,2.75,3170,8093,3170,0
6021503707,20150120T000000,352500,2,2.5,980,1010,980,0
9512200090,20150501T000000,529000,3,1.75,2340,7724,2340,0
9268850040,20150327T000000,484000,3,2.25,1620,1425,1540,80
7283900306,20150417T000000,400000,3,2.5,1910,4408,1910,0
1980200236,20150417T000000,649950,3,2.5,2420,6847,2420,0
2413910120,20140702T000000,915000,3,4.5,3850,62726,3120,730
7787920180,20150504T000000,534950,5,2.5,3220,10572,3220,0
1283800110,20140506T000000,776000,4,2.5,3040,6425,3040,0
6140100028,20150501T000000,370000,3,1.75,1496,1423,1248,248
1972200555,20140714T000000,610000,3,1.75,1630,1500,1630,0
6891100090,20141014T000000,850000,5,3.5,4200,5400,3140,1060
3438503021,20141105T000000,443000,3,2.5,2430,7049,2430,0
4233600150,20150203T000000,1.15E+06,5,4.25,4010,8252,4010,0
2770601782,20140801T000000,453000,3,2.5,1510,1618,1330,180
9268851020,20150410T000000,735000,4,3.5,2340,2810,1730,610
8682291050,20140708T000000,810000,2,2.75,2700,8572,2700,0
9468200109,20140617T000000,1.56E+06,3,3.5,4360,6240,2960,1400
2524069097,20140509T000000,2.24E+06,5,6.5,7270,130017,6420,850
7625702441,20140808T000000,377500,3,2.5,1350,886,1270,80
9521100866,20140618T000000,482000,3,3.25,1380,1120,1380,0
148000072,20140818T000000,600000,2,2.5,1830,1988,1530,300
1493300057,20140807T000000,420000,3,2.5,1470,1571,1180,290
3304030220,20150421T000000,480000,4,2.5,2940,9172,2940,0
7625702277,20150331T000000,406000,2,2,1110,1095,980,130
1023059465,20140513T000000,505000,4,2.5,2790,5602,2790,0
3262300818,20150227T000000,1.87E+06,4,3.75,3790,8797,3290,500
2937300040,20141215T000000,942990,4,2.5,3570,6218,3570,0
2768100206,20141001T000000,440000,3,2.25,1230,1097,1230,0
7904700134,20140626T000000,390000,3,3.25,1370,913,1100,270
9521100867,20140711T000000,475000,3,3.25,1380,1121,1380,0
1702901618,20150407T000000,420000,1,2,1070,675,880,190
7237550100,20140825T000000,1.41E+06,4,4,4920,50621,4280,640
7430500110,20141209T000000,1.38E+06,5,3.5,5150,12230,3700,1450
603000555,20150302T000000,462500,6,3,2390,4000,2390,0
3304300300,20150507T000000,579950,4,2.75,2460,8643,2460,0
6453550090,20150505T000000,861111,4,2.5,3650,7090,3650,0
2625069038,20141124T000000,1.45E+06,4,3.5,4300,108865,4300,0
1760650820,20150428T000000,290000,3,2.25,1610,3764,1610,0
9578060230,20140618T000000,535000,4,2.5,2610,4595,2610,0
3416600750,20150217T000000,585000,3,2.5,1750,1381,1750,0
2487200490,20140623T000000,670000,3,2.5,3310,5300,2440,870
8964800330,20150407T000000,3.00E+06,4,3.75,5090,14823,4180,910
5637500082,20141203T000000,346000,3,2,1060,1184,730,330
324069112,20140617T000000,1.33E+06,4,4,4420,16526,4420,0
524059322,20150226T000000,999999,3,2.5,2100,4097,2100,0
889000025,20140811T000000,599000,3,1.75,1650,1180,1650,0
2909310100,20141015T000000,332000,4,2.5,2380,5737,2380,0
8562780180,20140612T000000,336750,2,2.25,1170,1011,1170,0
1043000100,20141211T000000,370000,4,2.5,2531,6843,2531,0
1865400076,20140509T000000,324000,3,2.25,998,904,798,200
8902000201,20150219T000000,338500,3,2.25,1333,1470,1333,0
715010530,20150113T000000,1.88E+06,5,3.5,4410,13000,2920,1490
4253400100,20150410T000000,402723,3,2.75,1160,1073,880,280
3874900085,20150227T000000,715000,4,3.25,2630,7770,2630,0
1972200227,20141007T000000,459000,3,1.5,1160,1031,1160,0
8562770720,20150423T000000,589999,3,2.5,2140,3628,1960,180
6669080120,20141215T000000,405000,4,2.5,1980,5020,1980,0
9211010300,20140707T000000,509900,3,2.5,3030,9053,3030,0
3277800823,20140820T000000,327000,2,2,1490,1627,1190,300
8835770330,20140819T000000,1.06E+06,2,1.5,2370,184231,2370,0
1220000371,20141231T000000,327500,3,2.5,1820,1866,1570,250
880000205,20140729T000000,249000,3,2,1260,1125,810,450
1561750040,20141224T000000,1.38E+06,5,4.5,4350,13405,4350,0
688000017,20140627T000000,516500,1,1.25,1100,638,1100,0
2522059251,20150409T000000,465000,3,2.5,2050,15035,2050,0
2855000110,20140808T000000,388000,3,2.5,2198,6222,2198,0
6821101731,20140930T000000,549000,3,2.25,1230,1380,1230,0
476000017,20141003T000000,553000,2,2,1400,1512,940,460
2770603523,20150422T000000,530000,3,2.5,1410,1250,1140,270
2255500123,20140820T000000,747450,3,2.5,2110,1339,1410,700
3438501329,20140520T000000,305000,2,2.5,1590,2656,1220,370
423059387,20141118T000000,540000,5,2.5,3370,4850,3370,0
6664500090,20150115T000000,750000,5,4,4500,8130,4500,0
2122059216,20150414T000000,422000,4,2.5,2930,5973,2930,0
9406530090,20141020T000000,337000,4,2.5,2470,5100,2470,0
7168100015,20141009T000000,579950,5,2.75,3080,5752,3080,0
5007500120,20150226T000000,341780,4,2.75,2260,4440,2260,0
3528900770,20150423T000000,710200,4,3,1670,2642,1350,320
9521100031,20140618T000000,690000,3,3.25,1540,1428,1540,0
524059330,20150130T000000,1.70E+06,4,3.5,3830,8963,3120,710
6021503705,20141015T000000,329000,2,2.5,980,1020,980,0
3438501862,20140513T000000,330000,3,2.5,1450,5008,840,610
3345700207,20150502T000000,608500,4,3.5,2850,5577,1950,900
6056111067,20140707T000000,230000,3,1.75,1140,1201,1140,0
8562790760,20140520T000000,785000,4,3.5,3070,4684,2190,880
1931300090,20140507T000000,610950,3,3,1680,1570,1680,0
9578500790,20141111T000000,399950,3,2.5,3087,5002,3087,0
9253900271,20150107T000000,3.57E+06,5,4.5,4850,10584,3540,1310
3881900317,20150123T000000,579000,4,3.25,1900,2631,1250,650
567000385,20140623T000000,362500,2,1.5,940,1768,940,0
7011201004,20140529T000000,645000,3,3.25,1730,1229,1320,410
7853420110,20141003T000000,594866,3,3,2780,6000,2780,0
7853420110,20150504T000000,625000,3,3,2780,6000,2780,0
3052700432,20141112T000000,490000,3,2.25,1500,1290,1220,280
2025049203,20140610T000000,399950,2,1,710,1157,710,0
952006823,20141202T000000,380000,3,2.5,1260,900,940,320
3832050760,20140828T000000,270000,3,2.5,1870,5000,1870,0
2767604724,20141015T000000,505000,2,2.5,1430,1201,1430,0
6632300207,20150305T000000,385000,3,2.5,1520,1488,1520,0
2767600688,20141113T000000,414500,2,1.5,1210,1278,1020,190
7570050450,20140910T000000,347500,3,2.5,2540,4760,2540,0
7430200100,20140514T000000,1.22E+06,4,3.5,4910,9444,3110,1800
4140940150,20141002T000000,572000,4,2.75,2770,3852,2770,0
1931300412,20150416T000000,475000,3,2.25,1190,1200,1190,0
8672200110,20150317T000000,1.09E+06,5,3.75,4170,8142,4170,0
5087900040,20141017T000000,350000,4,2.75,2500,5995,2500,0
1972201967,20141031T000000,520000,2,2.25,1530,981,1480,50
7502800100,20140813T000000,679950,5,2.75,3600,9437,3600,0
191100405,20150421T000000,1.58E+06,4,3.25,3410,10125,3410,0
8956200760,20141013T000000,541800,4,2.5,3118,7866,3118,0
7202300110,20140915T000000,810000,4,3,3990,7838,3990,0
249000205,20141015T000000,1.54E+06,5,3.75,4470,8088,4470,0
5100403806,20150407T000000,467000,3,2.5,1425,1179,1425,0
844000965,20140626T000000,224000,3,1.75,1500,11968,1500,0
7852140040,20140825T000000,507250,3,2.5,2270,5536,2270,0
9834201367,20150126T000000,429000,3,2,1490,1126,1490,0
3448900210,20141014T000000,610685,4,2.5,2520,6023,2520,0
7936000429,20150326T000000,1.01E+06,4,3.5,3510,7200,2600,910
2997800021,20150219T000000,475000,3,2.5,1310,1294,1180,130
263000018,20140521T000000,360000,3,2.5,1530,1131,1530,0
6600060120,20150223T000000,400000,4,2.5,2310,5813,2310,0
1523300141,20140623T000000,402101,2,0.75,1020,1350,1020,0
291310100,20150116T000000,400000,3,2.5,1600,2388,1600,0
1523300157,20141015T000000,325000,2,0.75,1020,1076,1020,0
